Roll Call,Majority,Congress Num,Legislation Number,Date,Time,Question,Description,Result,Republican Yes,Republican No,Republican Present,Republican Not Voting,Democrat Yes,Democrat No,Democrat Present,Democrat Not Voting,Independent Yes,Independent No,Independent Present,Independent Not Voting,Total Yes,Total No,Total Present,Total Not Voting
1,D,111,QUORUM,12-Jan-2010,7:07 PM,Call of the House,None,Passed,0,0,146,32,0,0,227,29,0,0,0,0,0,0,373,61
2,D,111,H J RES 64,13-Jan-2010,3:35 PM,"On Passage, Objections of the President Notwithstanding",Making further continuing appropriations for FY 2010,Failed,140,22,1,15,3,223,0,29,0,0,0,0,143,245,1,44
3,D,111,H RES 1002,13-Jan-2010,3:59 PM,On Motion to Suspend the Rules and Agree,"Honoring the life and work of Dr. Martin Luther King, Jr. and encouraging the continued commitment to the Martin Luther King, Jr. Day as a national day of service",Passed,156,0,0,22,223,0,0,32,0,0,0,0,379,0,0,54
4,D,111,H RES 860,13-Jan-2010,4:09 PM,"On Motion to Suspend the Rules and Agree, as Amended",Supporting the initiatives of Chicago Wilderness and the Children’s Outdoor Bill of Rights,Passed,151,1,0,26,218,0,0,37,0,0,0,0,369,1,0,63
5,D,111,H R 3892,13-Jan-2010,4:15 PM,On Motion to Suspend the Rules and Pass,"To designate the facility of the United States Postal Service located at 101 West Highway 64 Bypass in Roper, North Carolina, as the “E.V. Wilkins Post Office”.",Passed,151,1,0,26,205,0,0,50,0,0,0,0,356,1,0,76
6,D,111,H RES 1004,19-Jan-2010,6:58 PM,On Motion to Suspend the Rules and Agree,Congratulating the Northwestern University Feinberg School of Medicine for its 150 years of commitment to advancing science and improving health,Passed,164,0,0,14,233,0,0,22,0,0,0,0,397,0,0,36
7,D,111,H RES 1015,19-Jan-2010,7:07 PM,On Motion to Suspend the Rules and Agree,Congratulating the Penn State women’s volleyball team on winning the 2009 NCAA Division I national championship,Passed,163,0,0,15,233,0,1,21,0,0,0,0,396,0,1,36
8,D,111,H RES 991,19-Jan-2010,7:14 PM,On Motion to Suspend the Rules and Agree,Commending the University of Virginia men’s soccer team for winning the 2009 Division I NCAA National Championship,Passed,164,0,0,14,234,0,2,19,0,0,0,0,398,0,2,33
9,D,111,H RES 1017,20-Jan-2010,2:29 PM,On Ordering the Previous Question,"Rule providing for consideration of H.R. 3254, H.R. 3342, and H.R. 1065",Passed,0,167,0,11,239,8,0,8,0,0,0,0,239,175,0,19
10,D,111,H R 3726,20-Jan-2010,2:44 PM,"On Motion to Suspend the Rules and Pass, as Amended",Castle Nugent National Historic Site Establishment Act of 2010,Failed,0,169,0,9,241,4,0,10,0,0,0,0,241,173,0,19
11,D,111,H R 3538,20-Jan-2010,2:56 PM,"On Motion to Suspend the Rules and Pass, as Amended",Idaho Wilderness Water Resources Protection Act,Failed,164,4,0,10,61,187,0,7,0,0,0,0,225,191,0,17
12,D,111,H R 3254,21-Jan-2010,12:28 PM,On Passage,Taos Pueblo Indian Water Rights Settlement Act,Passed,14,153,0,11,240,5,0,10,0,0,0,0,254,158,0,21
13,D,111,H R 3342,21-Jan-2010,12:35 PM,On Passage,Aamodt Litigation Settlement Act,Passed,15,149,0,14,234,4,0,17,0,0,0,0,249,153,0,31
14,D,111,H R 1065,21-Jan-2010,12:43 PM,On Passage,White Mountain Apache Tribe Water Rights Quantification Act of 2009,Passed,19,143,0,16,243,4,0,8,0,0,0,0,262,147,0,24
15,D,111,H RES 1021,21-Jan-2010,12:52 PM,On Motion to Suspend the Rules and Agree,"Expressing condolences to and solidarity with the people of Haiti in the aftermath of the devastating earthquake of January 12, 2010",Passed,165,1,0,12,246,0,0,9,0,0,0,0,411,1,0,21
16,D,111,H R 730,21-Jan-2010,1:06 PM,Suspend the Rules and Concur in the Senate Amendment,Nuclear Forensics and Attribution Act,Passed,155,9,0,14,242,1,0,12,0,0,0,0,397,10,0,26
17,D,111,H RES 990,26-Jan-2010,6:59 PM,On Motion to Suspend the Rules and Agree,Expressing support for designation of January 2010 as “National Mentoring Month”,Passed,162,0,0,16,236,0,0,19,0,0,0,0,398,0,0,35
18,D,111,H RES 1011,26-Jan-2010,7:07 PM,On Motion to Suspend the Rules and Agree,Recognizing the importance of cervical health and of detecting cervical cancer during its earliest stages and supporting the goals and ideals of Cervical Health Awareness Month,Passed,161,0,0,17,239,0,0,16,0,0,0,0,400,0,0,33
19,D,111,H RES 1003,26-Jan-2010,7:15 PM,"On Motion to Suspend the Rules and Agree, as Amended","Expressing support for the designation of January 10, 2010, through January 16, 2010, as National Influenza Vaccination Week",Passed,161,1,0,16,237,1,0,17,0,0,0,0,398,2,0,33
20,D,111,H RES 1038,27-Jan-2010,12:00 PM,On Agreeing to the Resolution,"Providing for consideration of H.R. 3726, Castle Nugent National Historic Site Establishment Act of 2010; and H.R. 4474, Idaho Wilderness Water Facilities Act",Passed,2,166,0,10,232,8,0,15,0,0,0,0,234,174,0,25
21,D,111,H RES 1024,27-Jan-2010,12:08 PM,On Motion to Suspend the Rules and Agree,Expressing support for designation of January as Poverty in America Awareness Month,Passed,145,18,0,15,242,0,0,13,0,0,0,0,387,18,0,28
22,D,111,H R 4474,27-Jan-2010,1:53 PM,On Passage,Idaho Wilderness Water Facilities Act,Passed,170,0,0,8,245,0,0,10,0,0,0,0,415,0,0,18
23,D,111,H R 3726,27-Jan-2010,2:02 PM,On Passage,Castle Nugent National Historic Site Establishment Act of 2010,Passed,0,171,0,7,240,4,0,11,0,0,0,0,240,175,0,18
24,D,111,H R 4508,27-Jan-2010,2:09 PM,On Motion to Suspend the Rules and Pass,"To provide for an additional temporary extension of programs under the Small Business Act and the Small Business Investment Act of 1958, and for other purposes",Passed,165,4,0,9,245,0,0,10,0,0,0,0,410,4,0,19
25,D,111,H RES 1020,27-Jan-2010,2:17 PM,On Motion to Suspend the Rules and Agree,Honoring the 95th anniversary of the signing of the Rocky Mountain National Park Act,Passed,167,0,0,11,241,0,0,14,0,0,0,0,408,0,0,25
26,D,111,H R 4495,2-Feb-2010,6:58 PM,On Motion to Suspend the Rules and Pass,"To designate the facility of the United States Postal Service located at 100 North Taylor Lane in Patagonia, Arizona, as the “Jim Kolbe Post Office.”",Passed,161,0,0,17,229,0,0,26,0,0,0,0,390,0,0,43
27,D,111,H RES 957,2-Feb-2010,7:07 PM,On Motion to Suspend the Rules and Agree,"Honoring Jimmie Johnson, 2009 NASCAR Sprint Cup Champion",Passed,161,0,0,17,230,1,0,24,0,0,0,0,391,1,0,41
28,D,111,H RES 1014,2-Feb-2010,7:14 PM,On Motion to Suspend the Rules and Agree,Recognizing and supporting the goals and ideals of North American Inclusion Month,Passed,160,0,0,18,229,0,0,26,0,0,0,0,389,0,0,44
29,D,111,H RES 1051,3-Feb-2010,12:18 PM,On Ordering the Previous Question,"Providing for consideration of H.R. 4061, the Cybersecurity Enhancement Act",Passed,0,170,0,8,238,5,0,12,0,0,0,0,238,175,0,20
30,D,111,H RES 1051,3-Feb-2010,12:27 PM,On Agreeing to the Resolution,"Providing for consideration of H.R. 4061, the Cybersecurity Enhancement Act",Passed,0,169,0,9,237,7,0,11,0,0,0,0,237,176,0,20
31,D,111,H RES 1043,3-Feb-2010,12:36 PM,"On Motion to Suspend the Rules and Agree, as Amended",Recognizing Brescia University for 60 years of leadership in higher education,Passed,171,0,0,7,247,0,0,8,0,0,0,0,418,0,0,15
32,D,111,H RES 901,3-Feb-2010,12:43 PM,"On Motion to Suspend the Rules and Agree, as Amended","Recognizing November 14, 2009, as the 49th anniversary of the first day of integrated schools in New Orleans, Louisiana",Passed,171,0,0,7,245,0,0,10,0,0,0,0,416,0,0,17
33,D,111,H RES 1044,3-Feb-2010,12:50 PM,"On Motion to Suspend the Rules and Agree, as Amended","Commemorating the 65th anniversary of the liberation of Auschwitz, a Nazi concentration and extermination camp, honoring the victims of the Holocaust, and expressing commitment to strengthen the fight against bigotry and intolerance",Passed,171,0,0,7,243,0,0,12,0,0,0,0,414,0,0,19
34,D,111,H R 4061,3-Feb-2010,4:11 PM,On Agreeing to the Amendment,None,Agreed to,168,5,0,5,249,0,0,12,0,0,0,0,417,5,0,17
35,D,111,H R 4061,3-Feb-2010,4:22 PM,On Agreeing to the Amendment,None,Agreed to,171,3,0,4,225,28,0,8,0,0,0,0,396,31,0,12
36,D,111,H R 4061,3-Feb-2010,4:30 PM,On Agreeing to the Amendment,None,Agreed to,170,3,0,5,249,0,0,12,0,0,0,0,419,3,0,17
37,D,111,H R 4061,3-Feb-2010,4:38 PM,On Agreeing to the Amendment,None,Agreed to,169,4,0,5,247,0,0,14,0,0,0,0,416,4,0,19
38,D,111,H R 4061,3-Feb-2010,4:45 PM,On Agreeing to the Amendment,None,Agreed to,168,4,0,6,249,0,0,12,0,0,0,0,417,4,0,18
39,D,111,H R 4061,4-Feb-2010,10:49 AM,On Agreeing to the Amendment,None,Agreed to,171,0,0,7,253,0,0,8,0,0,0,0,424,0,0,15
40,D,111,H R 4061,4-Feb-2010,10:58 AM,On Agreeing to the Amendment,None,Agreed to,165,4,0,9,254,0,0,7,0,0,0,0,419,4,0,16
41,D,111,H R 4061,4-Feb-2010,11:06 AM,On Agreeing to the Amendment,None,Agreed to,168,6,0,4,255,0,0,6,0,0,0,0,423,6,0,10
42,D,111,H R 4061,4-Feb-2010,11:15 AM,On Agreeing to the Amendment,None,Agreed to,173,0,0,5,257,0,0,4,0,0,0,0,430,0,0,9
43,D,111,H R 4061,4-Feb-2010,11:35 AM,On Passage,"To advance cybersecurity research, development, and technical standards, and for other purposes",Passed,169,5,0,4,253,0,0,2,0,0,0,0,422,5,0,6
44,D,111,H RES 1022,4-Feb-2010,1:20 PM,On Motion to Suspend the Rules and Agree,Honoring the life and sacrifice of Medgar Evers and congratulating the United States Navy for naming a supply ship after Medgar Evers,Passed,173,0,0,5,253,0,0,2,0,0,0,0,426,0,0,7
45,D,111,H RES 1065,4-Feb-2010,1:32 PM,On Ordering the Previous Question,Providing for consideration of the Senate amendment to the joint resolution (H.J. Res. 45) increasing the statutory limit on the public debt,Passed,0,175,0,3,233,20,0,2,0,0,0,0,233,195,0,5
46,D,111,H RES 1065,4-Feb-2010,1:51 PM,On Agreeing to the Resolution,Providing for consideration of the Senate amendment to the joint resolution (H.J. Res. 45) increasing the statutory limit on the public debt,Passed,0,175,0,3,217,37,0,2,0,0,0,0,217,212,0,5
47,D,111,H R 4532,4-Feb-2010,2:01 PM,On Motion to Suspend the Rules and Pass,Social Security Disability Applicants’ Access to Professional Representation Act,Passed,165,6,0,7,247,0,0,8,0,0,0,0,412,6,0,15
48,D,111,H J RES 45,4-Feb-2010,3:49 PM,On Adoption of the second portion of the divided question,Statutory Pay-As-You-Go Act,Passed,0,172,0,6,233,15,0,8,0,0,0,0,233,187,0,14
49,D,111,H R 4425,22-Feb-2010,7:05 PM,On Motion to Suspend the Rules and Pass,"To designate the facility of the United States Postal Service located at 2-116th Street in North Troy, New York, as the “Martin G. ’Marty’ Mahar Post Office”",Passed,137,0,0,41,193,0,0,61,0,0,0,0,330,0,0,102
50,D,111,H R 4238,22-Feb-2010,7:19 PM,On Motion to Suspend the Rules and Pass,"To designate the facility of the United States Postal Service located at 930 39th Avenue in Greeley, Colorado, as the “W.D. Farr Post Office Builiding”",Passed,137,0,0,41,194,0,0,60,0,0,0,0,331,0,0,101
51,D,111,H RES 1083,23-Feb-2010,4:57 PM,On Agreeing to the Resolution,Providing for consideration of the bill (H.R. 2314) to express the policy of the United States regarding the United States relationship with Native Hawaiians and to provide a process for the recognition by the United States of the Native Hawaiian governing entity,Passed,3,162,0,13,235,3,0,16,0,0,0,0,238,165,0,29
52,D,111,H RES 1066,23-Feb-2010,5:06 PM,On Motion to Suspend the Rules and Agree,"Recognizing the bravery and efforts of the United States Armed Forces, local first responders, and other members of Operation Unified Response for their swift and coordinated action in light of the Haiti earthquake",Passed,166,0,0,12,240,0,0,14,0,0,0,0,406,0,0,26
53,D,111,H RES 1059,23-Feb-2010,5:14 PM,"On Motion to Suspend the Rules and Agree, as Amended",Honoring the heroism of the seven U.S. Agency for International Development and Office of U.S. Foreign Disaster Assistance supported urban search and rescue teams deployed to Haiti,Passed,165,0,0,13,241,0,0,13,0,0,0,0,406,0,0,26
54,D,111,H RES 1039,23-Feb-2010,5:23 PM,On Motion to Suspend the Rules and Agree,Supporting the goals and ideals of American Heart Month and National Wear Red Day,Passed,166,0,0,12,242,0,0,12,0,0,0,0,408,0,0,24
55,D,111,H RES 1046,23-Feb-2010,5:40 PM,On Motion to Suspend the Rules and Agree,Recognizing the significance of Black History Month,Passed,165,0,0,13,237,0,0,17,0,0,0,0,402,0,0,30
56,D,111,H R 2314,23-Feb-2010,8:17 PM,On Agreeing to the Amendment,None,Failed,162,5,0,11,1,236,0,17,0,0,0,0,163,241,0,28
57,D,111,H R 2314,23-Feb-2010,8:27 PM,On Agreeing to the Amendment,None,Failed,159,8,0,11,18,225,0,11,0,0,0,0,177,233,0,22
58,D,111,H R 2314,23-Feb-2010,8:34 PM,On Agreeing to the Amendment,None,Agreed to,6,160,0,12,239,4,0,11,0,0,0,0,245,164,0,23
59,D,111,H R 2314,23-Feb-2010,8:51 PM,On Passage,To express the policy of the United States regarding the United States relationship with Native Hawaiians and to provide a process for the recognition by the United States of the Native Hawaiian governing entity,Passed,6,160,0,12,239,4,0,11,0,0,0,0,245,164,0,23
60,D,111,H RES 1098,24-Feb-2010,12:15 PM,On Agreeing to the Resolution,Providing for consideration of the bill (H.R. 4626) to restore the application of the Federal antitrust laws to the business of health insurance to protect competition and consumers,Passed,0,171,0,7,238,10,0,6,0,0,0,0,238,181,0,13
61,D,111,H RES 1074,24-Feb-2010,12:24 PM,On Motion to Suspend the Rules and Agree,"Honoring the life of Miep Gies, who aided Anne Frank’s family while they were in hiding and preserved her diary for future generations",Passed,172,0,0,6,249,0,0,5,0,0,0,0,421,0,0,11
62,D,111,H RES 944,24-Feb-2010,12:32 PM,"On Motion to Suspend the Rules and Agree, as Amended",Expressing the sense of the House of Representatives on religious minorities in Iraq,Passed,167,3,0,8,248,0,0,6,0,0,0,0,415,3,0,14
63,D,111,H R 4626,24-Feb-2010,3:45 PM,On Motion to Recommit with Instructions,Health Insurance Industry Fair Competition Act,Failed,165,3,0,10,5,246,0,3,0,0,0,0,170,249,0,13
64,D,111,H R 4626,24-Feb-2010,3:55 PM,On Passage,Health Insurance Industry Fair Competition Act,Passed,153,19,0,6,253,0,0,2,0,0,0,0,406,19,0,8
65,D,111,H RES 1085,24-Feb-2010,4:05 PM,On Motion to Suspend the Rules and Agree,Honoring and celebrating the contributions of African-Americans to the transportation and infrastructure of the United States,Passed,170,0,0,8,249,0,0,5,0,0,0,0,419,0,0,13
66,D,111,H RES 1105,25-Feb-2010,1:17 PM,On Agreeing to the Resolution,"Providing for consideration of the bill (H.R. 2701) to authorize appropriations for FY 2010 for intelligence and intelligence-related activities of the U.S. Government, the Community Management Account, and the CIA Retirement and Disability System, waiving a requirement of clause 6(a) of rule XIII",Passed,0,166,0,12,237,10,0,7,0,0,0,0,237,176,0,19
67,D,111,H R 3961,25-Feb-2010,7:26 PM,On Motion to Concur in Senate Amendments,Medicare Physician Payment Reform Act,Passed,153,10,0,15,162,87,0,5,0,0,0,0,315,97,0,20
68,D,111,H CON RES 227,25-Feb-2010,7:48 PM,"On Motion to Suspend the Rules and Agree, as Amended",Supporting the goals and ideals of National Urban Crimes Awareness Week,Passed,163,0,0,15,248,0,0,6,0,0,0,0,411,0,0,21
69,D,111,H R 2701,26-Feb-2010,10:47 AM,On Agreeing to the Amendment,None,Agreed to,1,162,0,15,245,4,0,11,0,0,0,0,246,166,0,26
70,D,111,H R 2701,26-Feb-2010,10:55 AM,On Agreeing to the Amendment,None,Agreed to,152,11,0,15,249,0,0,11,0,0,0,0,401,11,0,26
71,D,111,H R 2701,26-Feb-2010,11:02 AM,On Agreeing to the Amendment,None,Agreed to,162,0,0,16,248,1,0,11,0,0,0,0,410,1,0,27
72,D,111,H R 2701,26-Feb-2010,11:40 AM,On Motion to Recommit with Instructions,Intelligence Authorization Act for Fiscal Year 2010,Failed,158,0,0,20,28,217,0,9,0,0,0,0,186,217,0,29
73,D,111,H R 2701,26-Feb-2010,11:49 AM,On Passage,Intelligence Authorization Act for Fiscal Year 2010,Passed,1,159,0,18,234,9,0,11,0,0,0,0,235,168,0,29
74,D,111,H CON RES 238,26-Feb-2010,11:59 AM,On Motion to Suspend the Rules and Agree,"Recognizing the difficult challenges Black veterans faced when returning home after serving in the Armed Forces, their heroic military sacrifices, and their patriotism in fighting for equal rights and for the dignity of a people and a Nation",Passed,147,0,0,31,236,0,0,18,0,0,0,0,383,0,0,49
75,D,111,H RES 1072,2-Mar-2010,6:59 PM,"On Motion to Suspend the Rules and Agree, as Amended",Recognizing Louisiana State University for 150 years of service and excellence in higher education,Passed,156,0,0,22,227,0,0,26,0,0,0,0,383,0,0,48
76,D,111,H R 3820,2-Mar-2010,7:08 PM,"On Motion to Suspend the Rules and Pass, as Amended",Natural Hazards Risk Reduction Act of 2009,Passed,108,48,0,22,227,2,0,24,0,0,0,0,335,50,0,46
77,D,111,H RES 1097,2-Mar-2010,7:17 PM,On Motion to Suspend the Rules and Agree,"Supporting the goals and ideals of National Engineers Week, and for other purposes",Passed,154,0,0,24,228,0,0,25,0,0,0,0,382,0,0,49
78,D,111,H RES 1126,3-Mar-2010,2:16 PM,On Agreeing to the Resolution,"Providing for the consideration of H.R. 4247, the Preventing Harmful Restraint and Seclusion in Schools Act",Passed,0,170,0,8,228,14,0,11,0,0,0,0,228,184,0,19
79,D,111,H RES 747,3-Mar-2010,2:25 PM,On Motion to Suspend the Rules and Agree,Congratulating the United States Military Academy at West Point on being named by Forbes magazine as America’s Best College for 2009,Passed,170,0,0,8,246,0,0,7,0,0,0,0,416,0,0,15
80,D,111,H RES 1096,3-Mar-2010,2:35 PM,"On Motion to Suspend the Rules and Agree, as Amended","Encouraging individuals across the United States to participate in the 2010 Census to ensure an accurate and complete count beginning April 1, 2010, and expressing support for designation of March 2010 as Census Awareness Month",Passed,163,1,1,13,246,0,0,7,0,0,0,0,409,1,1,20
81,D,111,H R 4247,3-Mar-2010,4:15 PM,On Agreeing to the Amendment,None,Agreed to,168,1,0,9,223,23,0,7,0,0,0,0,391,24,0,16
82,D,111,H R 4247,3-Mar-2010,4:32 PM,On Passage,Preventing Harmful Restraint and Seclusion in Schools Act,Passed,24,145,0,9,238,8,0,7,0,0,0,0,262,153,0,16
83,D,111,H RES 1127,3-Mar-2010,4:40 PM,On Motion to Suspend the Rules and Agree,"Expressing concern regarding the suicide plane attack on Internal Revenue Service employees in Austin, Texas",Passed,166,2,0,10,242,0,0,11,0,0,0,0,408,2,0,21
84,D,111,H RES 699,4-Mar-2010,11:18 AM,"On Motion to Suspend the Rules and Agree, as Amended","Expressing the appreciation of Congress for the service and sacrifice of the members of the 139th Airlift Wing, Air National Guard",Passed,175,0,0,3,246,0,0,7,0,0,0,0,421,0,0,10
85,D,111,H RES 1086,4-Mar-2010,11:38 AM,On Motion to Suspend the Rules and Agree,Recognizing the importance and significance of the 2010 Census and encouraging each community within the Indian Country to name an elder to be the first member of that community to answer the 2010 Census,Passed,172,1,1,4,243,0,0,10,0,0,0,0,415,1,1,14
86,D,111,H RES 1111,4-Mar-2010,11:49 AM,On Motion to Suspend the Rules and Agree,"Designating March 2, 2010 as “Read Across America Day”",Passed,173,0,0,5,241,0,0,12,0,0,0,0,414,0,0,17
87,D,111,H RES 1137,4-Mar-2010,1:24 PM,On Ordering the Previous Question,"Providing for consideration of the Senate amendment to H.R. 2847, making appropriations for the Departments of Commerce and Justice, and Science, and Related Agencies for the fiscal year ending September 30, 2010, and for other purposes",Passed,0,171,0,7,236,13,0,4,0,0,0,0,236,184,0,11
88,D,111,H RES 1137,4-Mar-2010,1:34 PM,On Agreeing to the Resolution,"Providing for consideration of the Senate amendment to H.R. 2847, making appropriations for the Departments of Commerce and Justice, and Science, and Related Agencies for the fiscal year ending September 30, 2010, and for other purposes",Passed,0,171,0,7,212,38,0,4,0,0,0,0,212,209,0,11
89,D,111,H RES 362,4-Mar-2010,1:44 PM,"On Motion to Suspend the Rules and Agree, as Amended",Expressing the support of the House of Representatives for the goals and ideals of the National School Lunch Program,Passed,155,13,0,10,248,0,0,5,0,0,0,0,403,13,0,15
90,D,111,H R 2847,4-Mar-2010,3:30 PM,Concurring with an Amdt to the Senate Amdt to the House Amdt to the Senate Amdt,Hiring Incentives to Restore Employment Act,Passed,6,166,0,6,211,35,0,8,0,0,0,0,217,201,0,14
91,D,111,H RES 1079,4-Mar-2010,3:39 PM,"On Motion to Suspend the Rules and Agree, as Amended",Congratulating the National Football League Champion New Orleans Saints for winning Super Bowl XLIV and for bringing New Orleans its first Lombardi Trophy in franchise history,Passed,158,1,0,19,217,0,3,34,0,0,0,0,375,1,3,53
92,D,111,H R 3650,9-Mar-2010,7:02 PM,"On Motion to Suspend the Rules and Pass, as Amended",Harmful Algal Blooms and Hypoxia Research and Control Amendments Act,Failed,32,135,0,11,231,7,0,14,0,0,0,0,263,142,0,25
93,D,111,H RES 1069,9-Mar-2010,7:09 PM,On Motion to Suspend the Rules and Agree,Congratulating Willard S. Boyle and George E. Smith for being awarded the Nobel Prize in physics,Passed,166,0,0,12,236,0,0,16,0,0,0,0,402,0,0,28
94,D,111,H RES 935,9-Mar-2010,7:17 PM,On Motion to Suspend the Rules and Agree,"Honoring John E. Warnock, Charles M. Geschke, Forrest M. Bird, Esther Sans Takeuchi, and IBM Corporation for receiving the 2008 National Medal of Technology and Innovation",Passed,164,0,0,14,238,0,0,14,0,0,0,0,402,0,0,28
95,D,111,H RES 1146,10-Mar-2010,1:54 PM,On Agreeing to the Resolution,"Providing for consideration of the concurrent resolution (H.Con.Res. 248) directing the President, pursuant to section 5(c) of the War Powers Resolution, to remove the United States Armed Forces from Afghanistan",Passed,5,167,0,6,220,28,0,4,0,0,0,0,225,195,0,10
96,D,111,H RES 1088,10-Mar-2010,2:02 PM,"On Motion to Suspend the Rules and Agree, as Amended",Recognizing the plight of people with albinism in East Africa and condemning their murder and mutilation,Passed,171,1,0,6,247,0,0,5,0,0,0,0,418,1,0,11
97,D,111,H R 4621,10-Mar-2010,2:09 PM,"On Motion to Suspend the Rules and Pass, as Amended",Prevent Deceptive Census Look Alike Mailings Act,Passed,170,0,0,8,246,0,0,6,0,0,0,0,416,0,0,14
98,D,111,H CON RES 248,10-Mar-2010,6:22 PM,On Agreeing to the Resolution,"Directing the President, pursuant to section 5(c) of the War Powers Resolution, to remove the United States Armed Forces from Afghanistan",Failed,5,167,0,6,60,189,0,3,0,0,0,0,65,356,0,9
99,D,111,H CON RES 249,10-Mar-2010,6:30 PM,On Motion to Suspend the Rules and Agree,Commemorating the 45th anniversary of Bloody Sunday and the role that it played in ensuring the passage of the Voting Rights Act of 1965,Passed,167,0,0,11,242,0,0,10,0,0,0,0,409,0,0,21
100,D,111,H RES 1144,10-Mar-2010,6:37 PM,On Motion to Suspend the Rules and Agree,"Expressing condolences to the families of the victims of the February 27, 2010, earthquake in Chile, as well as solidarity with and support for the people of Chile as they plan for recovery and reconstruction",Passed,165,1,0,12,239,0,0,13,0,0,0,0,404,1,0,25
101,D,111,QUORUM,11-Mar-2010,10:46 AM,Call of the House,None,Passed,0,0,168,10,0,0,237,15,0,0,0,0,0,0,405,25
102,D,111,H RES 1031,11-Mar-2010,11:57 AM,On Agreeing to Article I of the Resolution,"Impeaching G. Thomas Porteous, Jr., judge of the United States District Court for the Eastern District of Louisiana, for high crimes and misdemeanors",Passed,170,0,0,8,242,0,0,10,0,0,0,0,412,0,0,18
103,D,111,H RES 1031,11-Mar-2010,12:04 PM,On Agreeing to Article II of the Resolution,"Impeaching G. Thomas Porteous, Jr., judge of the United States District Court for the Eastern District of Louisiana, for high crimes and misdemeanors",Passed,165,0,0,13,245,0,0,7,0,0,0,0,410,0,0,20
104,D,111,H RES 1031,11-Mar-2010,12:11 PM,On Agreeing to Article III of the Resolution,"Impeaching G. Thomas Porteous, Jr., judge of the United States District Court for the Eastern District of Louisiana, for high crimes and misdemeanors",Passed,170,0,0,8,246,0,0,6,0,0,0,0,416,0,0,14
105,D,111,H RES 1031,11-Mar-2010,12:44 PM,On Agreeing to Article IV of the Resolution,"Impeaching G. Thomas Porteous, Jr., judge of the United States District Court for the Eastern District of Louisiana, for high crimes and misdemeanors",Passed,172,0,0,6,251,0,0,1,0,0,0,0,423,0,0,7
106,D,111,H RES 1164,11-Mar-2010,1:14 PM,On Ordering the Previous Question,Raising a question of the privileges of the House,Passed,160,2,9,7,244,0,6,2,0,0,0,0,404,2,15,9
107,D,111,H RES 1164,11-Mar-2010,1:31 PM,On Motion to Refer the Resolution,Raising a question of the privileges of the House,Passed,162,0,9,7,240,1,6,5,0,0,0,0,402,1,15,12
108,D,111,H RES 1107,11-Mar-2010,1:41 PM,On Motion to Suspend the Rules and Agree,Recognizing the 189th anniversary of the independence of Greece and celebrating Greek and American democracy,Passed,167,0,1,10,247,0,0,5,0,0,0,0,414,0,1,15
109,D,111,H R 3650,12-Mar-2010,11:06 AM,On Passage,Harmful Algal Blooms and Hypoxia Research and Control Amendments Act,Passed,38,98,0,42,213,5,0,34,0,0,0,0,251,103,0,76
110,D,111,JOURNAL,12-Mar-2010,11:14 AM,On Approving the Journal,None,Passed,17,115,1,45,186,29,0,37,0,0,0,0,203,144,1,82
111,D,111,H R 4506,12-Mar-2010,11:26 AM,"On Motion to Suspend the Rules and Pass, as Amended",Bankruptcy Judgeship Act of 2010,Passed,129,4,0,45,216,1,0,35,0,0,0,0,345,5,0,80
112,D,111,H RES 1145,15-Mar-2010,7:04 PM,"On Motion to Suspend the Rules and Agree, as Amended",Recognizing the University of Arizona’s 125 years of dedication to excellence in higher education,Passed,157,0,0,21,235,0,0,17,0,0,0,0,392,0,0,38
113,D,111,H RES 1170,15-Mar-2010,7:12 PM,On Motion to Suspend the Rules and Agree,Congratulating the winners of the Voice of Democracy national scholarship program,Passed,154,0,0,24,230,0,0,22,0,0,0,0,384,0,0,46
114,D,111,H RES 1163,15-Mar-2010,7:20 PM,On Motion to Suspend the Rules and Agree,Recognizing Washington State University Honors College for 50 years of excellence,Passed,155,0,0,23,234,0,0,18,0,0,0,0,389,0,0,41
115,D,111,H RES 267,15-Mar-2010,7:27 PM,On Motion to Suspend the Rules and Agree,"Recognizing the cultural and historical significance of Nowruz, expressing appreciation to Iranian-American for their contributions to society, and wishing Iranian-Americans and the people of Iran a prosperous new year",Passed,152,2,0,24,232,0,0,20,0,0,0,0,384,2,0,44
116,D,111,H R 4628,16-Mar-2010,5:13 PM,On Motion to Suspend the Rules and Pass,"To designate the facility of the United States Postal Service located at 216 Westwood Avenue in Westwood, New Jersey, as the “Sergeant Christopher R. Hrbek Post Office Building”",Passed,170,0,0,8,246,0,0,6,0,0,0,0,416,0,0,14
117,D,111,H RES 311,16-Mar-2010,5:22 PM,On Motion to Suspend the Rules and Agree,Expressing the support of the House of Representatives for the goals and ideals of Red Cross Month,Passed,172,0,0,6,245,0,0,7,0,0,0,0,417,0,0,13
118,D,111,H RES 605,16-Mar-2010,5:30 PM,"On motion to suspend the rules and agree, as amended","Recognizing the continued persecution of Falun Gong practitioners in China on the 10th anniversary of the Chinese Communist Party campaign to suppress the Falun Gong spriritual movement and calling for an immediate end to the campaign to persecute, intimidate, imprison, and torture Falun Gong practitioners",Passed,167,1,0,10,245,0,0,7,0,0,0,0,412,1,0,17
119,D,111,H RES 1128,16-Mar-2010,5:37 PM,"On motion to suspend the rules and agree, as amended",Thanking Vancouver for hosting the world during the 2010 Winter Olympics and honoring the athletes from TEAM USA.,Passed,171,0,0,7,249,0,0,3,0,0,0,0,420,0,0,10
120,D,111,H RES 1089,17-Mar-2010,11:27 AM,"On Motion to Suspend the Rules and Agree, As Amended",Recognizing the 150th anniversary of Augustana College,Passed,174,0,0,4,247,0,0,5,0,0,0,0,421,0,0,9
121,D,111,H RES 1167,17-Mar-2010,11:35 AM,On Motion to Suspend the Rules and Agree,Expressing the support of the House of Representatives for the goals and ideals of Professional Social Work Month and World Social Work Day,Passed,173,0,0,5,246,0,0,6,0,0,0,0,419,0,0,11
122,D,111,H RES 1184,17-Mar-2010,11:43 AM,On Motion to Suspend the Rules and Agree,"Congratulating the 2009-2010 University of Maryland Men’s Basketball Team, Greivis Vasquez, and Coach Gary Williams on an outstanding season",Passed,42,130,0,6,237,2,6,7,0,0,0,0,279,132,6,13
123,D,111,H RES 1141,17-Mar-2010,4:28 PM,On Motion to Suspend the Rules and Agree,"Honoring the accomplishments of Supreme Court Justice Sandra Day O’Connor, the first woman to serve on the United States Supreme Court",Passed,171,0,0,7,245,0,0,7,0,0,0,0,416,0,0,14
124,D,111,S 1147,17-Mar-2010,4:37 PM,On Motion to Suspend the Rules and Pass,Prevent All Cigarette Trafficking Act,Passed,150,20,0,8,237,5,0,10,0,0,0,0,387,25,0,18
125,D,111,H R 3954,17-Mar-2010,4:46 PM,"On Motion to Suspend the Rules and Pass, as Amended",Florida National Forest Land Adjustment Act of 2009,Passed,171,1,0,6,247,0,0,5,0,0,0,0,418,1,0,11
126,D,111,H R 946,17-Mar-2010,4:54 PM,"On Motion to Suspend the Rules and Pass, as Amended",Plain Writing Act of 2010,Passed,139,33,0,6,247,0,0,5,0,0,0,0,386,33,0,11
127,D,111,H R 4825,17-Mar-2010,5:02 PM,On Motion to Suspend the Rules and Pass,To require any amounts remaining in a Member’s Representational Allowance at the end of a fiscal year to be deposited in the Treasury and used for deficit reduction or to reduce the Federal debt,Passed,171,0,0,7,242,1,0,9,0,0,0,0,413,1,0,16
128,D,111,H R 4214,18-Mar-2010,2:04 PM,On Motion to Suspend the Rules and Pass,"To designate the facility of the United States Postal Service located at 45300 Portola Avenue in Palm Desert, California, as the “Roy Wilson Post Office”",Passed,173,0,0,5,246,0,0,6,0,0,0,0,419,0,0,11
129,D,111,H RES 1190,18-Mar-2010,2:22 PM,On Ordering the Previous Question,Providing for consideration of motions to suspend the rules.,Passed,0,175,0,3,222,28,0,3,0,0,0,0,222,203,0,6
130,D,111,H RES 1190,18-Mar-2010,2:33 PM,On Agreeing to the Resolution,Providing for consideration of motions to suspend the rules.,Passed,1,171,0,6,231,16,0,5,0,0,0,0,232,187,0,11
131,D,111,H RES 1193,18-Mar-2010,5:17 PM,On Motion to Refer the Resolution,Raising a question of the privileges of the House,Passed,159,0,9,10,238,0,3,11,0,0,0,0,397,0,12,21
132,D,111,H RES 1194,18-Mar-2010,5:48 PM,On Motion to Table,Raising a question of the privileges of the House,Passed,0,171,0,7,232,10,0,10,0,0,0,0,232,181,0,17
133,D,111,H R 3542,18-Mar-2010,5:55 PM,"On Motion to Suspend the Rules and Pass, as Amended",State Admission Day Recognition Act of 2009,Passed,169,0,0,9,239,0,0,13,0,0,0,0,408,0,0,22
134,D,111,H R 3509,18-Mar-2010,6:02 PM,On Motion to Suspend the Rules and Pass,Agricultural Credit Act of 2009,Passed,147,23,0,8,235,3,0,14,0,0,0,0,382,26,0,22
135,D,111,H RES 1173,18-Mar-2010,6:11 PM,On Motion to Suspend the Rules and Agree,"Recognizing the 100th anniversary of the Vermont Long Trail, the oldest long-distance hiking trail in the United States, and congratulating the Green Mountain Club for its century of dedication in developing and maintaining the trail",Passed,168,1,0,9,241,0,0,11,0,0,0,0,409,1,0,20
136,D,111,H RES 1192,19-Mar-2010,10:38 AM,On Agreeing to the Resolution,"Providing for consideration of (H.R. 3644), the Ocean, Coastal, and Watershed Education Act and (H.R. 1612), Public Land Service Corps Act of 2009",Passed,1,165,0,12,235,6,0,11,0,0,0,0,236,171,0,23
137,D,111,H R 3671,19-Mar-2010,10:49 AM,On Motion to Suspend the Rules and Pass,Upper Mississippi River Basin Protection Act,Passed,49,117,0,12,240,4,0,8,0,0,0,0,289,121,0,20
138,D,111,H R 2788,19-Mar-2010,10:58 AM,On Motion to Suspend the Rules and Pass,Distinguished Flying Cross National Memorial Act,Passed,166,0,0,12,244,0,0,8,0,0,0,0,410,0,0,20
139,D,111,H R 3644,19-Mar-2010,1:02 PM,On Agreeing to the Amendment,None,Agreed to,169,1,1,7,207,36,0,9,0,0,0,0,376,37,1,16
140,D,111,H R 3644,19-Mar-2010,1:10 PM,On Agreeing to the Amendment,None,Agreed to,4,167,0,7,229,11,0,12,0,0,0,0,233,178,0,19
141,D,111,H R 3644,19-Mar-2010,1:39 PM,On Motion to Recommit with Instructions,"Ocean, Coastal, and Watershed Education Act",Failed,169,0,0,9,31,215,0,6,0,0,0,0,200,215,0,15
142,D,111,H R 3644,19-Mar-2010,1:48 PM,On Passage,"Ocean, Coastal, and Watershed Education Act",Passed,8,161,0,9,236,9,0,7,0,0,0,0,244,170,0,16
143,D,111,H R 4003,19-Mar-2010,1:57 PM,"On Motion to Suspend the Rules and Pass, as Amended",Hudson River Valley Special Resource Study Act,Passed,50,114,0,14,243,1,0,8,0,0,0,0,293,115,0,22
144,D,111,H R 4395,19-Mar-2010,5:56 PM,"On Motion to Suspend the Rules and Pass, as Amended","To revise the boundaries of the Gettysburg National Military Park to include the Gettysburg Train Station, and for other purposes",Passed,138,27,0,13,234,4,0,14,0,0,0,0,372,31,0,27
145,D,111,H RES 1133,19-Mar-2010,6:03 PM,On Motion to Suspend the Rules and Agree,Recognizing the extraordinary number of African-Americans who have overcome significant obstacles to enhance innovation and competitiveness in the field of science in the United States,Passed,164,0,0,14,235,0,0,17,0,0,0,0,399,0,0,31
146,D,111,H RES 1027,19-Mar-2010,6:10 PM,On Motion to Suspend the Rules and Agree,"Recognizing the 50th anniversary of the historic dive to the Challenger Deep in the Mariana Trench, the deepest point in the world’s oceans, on January 23, 1960, and its importance to marine research, ocean science, a better understanding of the planet, and the future of human exploration",Passed,163,2,0,13,235,0,0,17,0,0,0,0,398,2,0,30
147,D,111,H CON RES 244,19-Mar-2010,6:18 PM,"On Motion to Suspend the Rules and Agree, as Amended",Expressing support for the designation of March 20 as a National Day of Recognition for Long-Term Care Physicians,Passed,163,0,0,15,232,0,0,20,0,0,0,0,395,0,0,35
148,D,111,H R 1612,20-Mar-2010,12:01 PM,On Agreeing to the Amendment,None,Agreed to,171,1,0,6,56,179,0,17,0,0,0,0,227,180,0,23
149,D,111,H R 1612,20-Mar-2010,12:08 PM,On Agreeing to the Amendment,None,Agreed to,170,0,0,8,232,0,0,20,0,0,0,0,402,0,0,28
150,D,111,H R 1612,20-Mar-2010,12:59 PM,On Motion to Recommit with Instructions,Public Lands Service Corps Act of 2009,Passed,172,0,0,6,215,21,0,16,0,0,0,0,387,21,0,22
151,D,111,H R 1612,20-Mar-2010,1:13 PM,On Passage,Public Lands Service Corps Act of 2009,Passed,58,114,0,6,230,2,0,20,0,0,0,0,288,116,0,26
152,D,111,H R 4887,20-Mar-2010,2:52 PM,"On Motion to Suspend the Rules and Pass, as Amended",TRICARE Affirmation Act,Passed,171,0,0,7,232,0,0,20,0,0,0,0,403,0,0,27
153,D,111,JOURNAL,20-Mar-2010,3:05 PM,On Approving the Journal,None,Passed,13,156,0,9,198,30,0,24,0,0,0,0,211,186,0,33
154,D,111,H RES 1040,20-Mar-2010,3:12 PM,On Motion to Suspend the Rules and Agree,Honoring the life and accomplishments of Donald Harington for his contributions to literature in the United States,Passed,167,0,0,11,232,0,0,20,0,0,0,0,399,0,0,31
155,D,111,H R 4840,21-Mar-2010,1:47 PM,On Motion to Suspend the Rules and Pass,Clarence D. Lumpkin Post Office Designation,Passed,177,0,0,1,243,0,0,9,0,0,0,0,420,0,0,10
156,D,111,H RES 1174,21-Mar-2010,1:55 PM,On Motion to Suspend the Rules and Agree,Supporting the goals and ideals of National Women’s History Month,Passed,175,0,0,3,245,0,0,7,0,0,0,0,420,0,0,10
157,D,111,JOURNAL,21-Mar-2010,2:02 PM,On Approving the Journal,None,Passed,14,162,0,2,215,27,0,10,0,0,0,0,229,189,0,12
158,D,111,H RES 1075,21-Mar-2010,2:09 PM,"On Motion to Suspend the Rules and Agree, as Amended","Commending the members of the Agri-business Development Teams of the National Guard for their efforts, together with personnel of the Department of Agriculture and the United Sates Agency for International Development, to modernize agriculture practices and increase food production in war-torn countries.",Passed,173,3,0,2,245,0,0,7,0,0,0,0,418,3,0,9
159,D,111,H RES 1203,21-Mar-2010,3:03 PM,Will the House Now Consider the Resolution,"Providing for consideration of the Senate Amendments to H.R. 3590 , Patient Protection and Affordable Care Act , and providing for the consideration of the bill H.R. 4872 , Reconciliation Act of 2010",Passed,0,176,0,2,228,19,0,5,0,0,0,0,228,195,0,7
160,D,111,H RES 1203,21-Mar-2010,4:06 PM,Will the House Now Consider the Resolution,"Providing for consideration of the Senate Amendments to H.R. 3590 , Patient Protection and Affordable Care Act, and providing for the consideration of the bill H.R. 4872, Reconciliation Act of 2010.",Passed,0,178,0,0,230,22,0,0,0,0,0,0,230,200,0,0
161,D,111,H RES 900,21-Mar-2010,6:03 PM,"On Motion to Suspend the Rules and Agree, as Amended",Supporting the goals and ideals of a Cold War Veterans Recognition Day to honor the sacrifices and contributions made by members of the Armed Forces during the Cold War and encouraging the people of the U.S. to participate in local and national activities honoring the sacrifices and contributions of those individuals,Passed,177,0,0,1,252,0,0,0,0,0,0,0,429,0,0,1
162,D,111,H RES 1203,21-Mar-2010,6:13 PM,On Ordering the Previous Question,"Providing for consideration of the Senate Amendments to H.R. 3590 , Patient Protection and Affordable Care Act, and providing for the consideration of the bill H.R. 4872, Reconciliation Act of 2010.",Passed,0,178,0,0,228,24,0,0,0,0,0,0,228,202,0,0
163,D,111,H RES 1203,21-Mar-2010,6:29 PM,On Agreeing to the Resolution,"Providing for consideration of the Senate Amendments to H.R. 3590 , Patient Protection and Affordable Care Act, and providing for the consideration of the bill H.R. 4872, Reconciliation Act of 2010.",Passed,0,178,0,0,224,28,0,0,0,0,0,0,224,206,0,0
164,D,111,H RES 925,21-Mar-2010,6:41 PM,"On Motion to Suspend the Rules and Agree, as Amended","Expressing the sense of the House of Representatives regarding the meritorious service performed by aviators in the United States Armed Forces who were shot down over, or otherwise forced to land in, hostile territory yet evaded enemy capture or were captured buy subsequently escaped",Passed,175,0,0,3,251,0,0,1,0,0,0,0,426,0,0,4
165,D,111,H R 3590,21-Mar-2010,10:49 PM,On Motion to Concur in Senate Amendments,Patient Protection and Affordable Care Act,Passed,0,178,0,0,219,34,0,0,0,0,0,0,219,212,0,0
166,D,111,H R 4872,21-Mar-2010,11:19 PM,On Motion to Recommit with Instructions,Reconciliation Act of 2010,Failed,178,0,0,0,21,232,0,0,0,0,0,0,199,232,0,0
167,D,111,H R 4872,21-Mar-2010,11:37 PM,On Passage,Reconciliation Act of 2010,Passed,0,178,0,0,220,33,0,0,0,0,0,0,220,211,0,0
168,D,111,H RES 1099,21-Mar-2010,11:45 PM,"On Motion to Suspend the Rules and Agree, as Amended",Recognizing the 65th anniversary of the Battle of Iwo Jima,Passed,173,0,0,5,248,0,0,4,0,0,0,0,421,0,0,9
169,D,111,H RES 1119,21-Mar-2010,11:59 PM,"On Motion to Suspend the Rules and Agree, as Amended",Expressing the sense of the House of Representatives that all people in the United States should participate in a moment of silence to reflect upon the service and sacrifice of members of the United States Armed Forces both at home and abroad,Passed,169,0,0,8,231,0,0,21,0,0,0,0,400,0,0,29
170,D,111,H R 4810,22-Mar-2010,7:04 PM,On Motion to Suspend the Rules and Pass,End Veteran Homelessness Act of 2010,Passed,171,0,0,6,242,0,0,10,0,0,0,0,413,0,0,16
171,D,111,H R 4667,22-Mar-2010,7:19 PM,On Motion to Suspend the Rules and Pass,Veterans’ Compensation Cost-of-Living Adjustment Act of 2010,Passed,167,0,0,10,240,0,0,12,0,0,0,0,407,0,0,22
172,D,111,H RES 1205,23-Mar-2010,2:35 PM,On Ordering the Previous Question,"Providing for consideration of the bill (H.R. 4849) to amend the Internal Revenue Code of 1986 to provide tax incentives for small business job creation, extend the Build America Bonds program, provide other infrastructure job creation tax incentives, and for other purposes",Passed,0,174,0,3,240,5,0,7,0,0,0,0,240,179,0,10
173,D,111,H RES 1205,23-Mar-2010,2:43 PM,On Agreeing to the Resolution,"Providing for consideration of the bill (H.R. 4849) to amend the Internal Revenue Code of 1986 to provide tax incentives for small business job creation, extend the Build America Bonds program, provide other infrastructure job creation tax incentives, and for other purposes",Passed,0,173,0,4,233,14,0,5,0,0,0,0,233,187,0,9
174,D,111,H J RES 80,23-Mar-2010,2:50 PM,On Motion to Suspend the Rules and Pass,Recognizing and honoring the Blinded Veterans Association on its 65th anniversary of representing blinded veterans and their families,Passed,172,0,0,5,244,0,0,8,0,0,0,0,416,0,0,13
175,D,111,H RES 1186,23-Mar-2010,4:24 PM,On Motion to Suspend the Rules and Agree,Expressing support for designation of April as National Distracted Driving Awareness Month,Passed,167,2,0,8,243,0,0,9,0,0,0,0,410,2,0,17
176,D,111,H R 3976,23-Mar-2010,4:33 PM,"On Motion to Suspend the Rules and Pass, as Amended",Helping Heroes Keep Their Homes Act of 2009,Passed,168,4,0,5,248,0,0,4,0,0,0,0,416,4,0,9
177,D,111,H R 4592,23-Mar-2010,4:40 PM,"On Motion to Suspend the Rules and Pass, as Amended",Energy Jobs for Veterans Act,Passed,152,19,0,6,245,0,0,7,0,0,0,0,397,19,0,13
178,D,111,H CON RES 257,24-Mar-2010,12:46 PM,On Agreeing to the Concurrent Resolution,Adjournment Resolution,Passed,11,158,0,8,225,17,0,10,0,0,0,0,236,175,0,18
179,D,111,H RES 1204,24-Mar-2010,12:56 PM,On Agreeing to the Resolution,"Providing for consideration of H.R. 4899, making emergency supplemental appropriations for disaster relief and summer jobs for the fiscal year ending September 30, 2010, and for other purposes",Passed,1,174,0,2,232,17,0,3,0,0,0,0,233,191,0,5
180,D,111,H RES 917,24-Mar-2010,1:04 PM,"On Motion to Suspend the Rules and Agree, as Amended",Recognizing the Florida Keys Scenic Highway on the occasion of its designation as an All-American Road by the U.S. Department of Transportation,Passed,173,2,0,2,247,0,0,5,0,0,0,0,420,2,0,7
181,D,111,H R 4849,24-Mar-2010,3:28 PM,On Motion to Recommit with Instructions,Small Business and Infrastructure Jobs Tax Act,Failed,174,0,0,3,10,239,0,3,0,0,0,0,184,239,0,6
182,D,111,H R 4849,24-Mar-2010,3:37 PM,On Passage,Small Business and Infrastructure Jobs Tax Act,Passed,4,171,0,2,242,7,0,3,0,0,0,0,246,178,0,5
183,D,111,H R 4098,24-Mar-2010,3:46 PM,"On Motion to Suspend the Rules and Pass, as Amended",Secure Federal File Sharing Act,Passed,160,13,0,4,248,0,1,3,0,0,0,0,408,13,1,7
184,D,111,H R 1879,24-Mar-2010,3:53 PM,"On Motion to Suspend the Rules and Pass, as Amended",National Guard Employment Protection Act of 2009,Passed,171,1,0,5,245,0,0,7,0,0,0,0,416,1,0,12
185,D,111,H R 4899,24-Mar-2010,5:11 PM,On Motion to Table the Appeal of the Ruling of the Chair,"Making emergency supplemental appropriations for disaster relief and summer jobs for fiscal year ending September 30, 2010, and for other purposes",Passed,0,173,0,4,239,3,0,10,0,0,0,0,239,176,0,14
186,D,111,H R 4899,24-Mar-2010,5:18 PM,On Passage,"Making emergency supplemental appropriations for disaster relief and summer jobs for fiscal year ending September 30, 2010, and for other purposes",Passed,5,167,1,4,234,8,0,10,0,0,0,0,239,175,1,14
187,D,111,H RES 1220,25-Mar-2010,2:58 PM,On Motion to Refer the Resolution,Raising a question of the privileges of the House,Passed,163,0,10,4,243,1,5,3,0,0,0,0,406,1,15,7
188,D,111,H RES 1212,25-Mar-2010,3:08 PM,On Agreeing to the Resolution,"Providing for consideration of the Senate amendments to H.R. 1586 to impose an additional tax on bonuses received from certain TARP recipients, and for other purposes",Passed,0,173,0,4,231,17,0,4,0,0,0,0,231,190,0,8
189,D,111,JOURNAL,25-Mar-2010,3:14 PM,On Approving the Journal,None,Passed,20,151,0,6,221,27,0,4,0,0,0,0,241,178,0,10
190,D,111,H R 1586,25-Mar-2010,5:21 PM,"On Concurring in Senate Amendments, With Amendment to Senate Amendment To Text","To impose an additional tax on bonuses received from certain TARP recipients, and for other purposes",Passed,34,139,0,4,242,6,0,4,0,0,0,0,276,145,0,8
191,D,111,H RES 1125,25-Mar-2010,5:30 PM,"On Motion to Suspend the Rules and Agree, as Amended","Supporting the goals and ideals of National Public Works Week, and for other purposes",Failed,0,171,0,6,249,1,0,2,0,0,0,0,249,172,0,8
192,D,111,H R 4360,25-Mar-2010,5:36 PM,On Motion to Suspend the Rules and Pass,"Major Charles R. Soltes, Jr., O.D. Department of Veterans Affairs Blind Rehabilitation Center",Passed,171,0,0,6,246,0,0,6,0,0,0,0,417,0,0,12
193,D,111,H RES 1225,25-Mar-2010,8:23 PM,On Agreeing to the Resolution,Providing for consideration of the Senate amendments to the bill (H. R. 4872) to provide for reconciliation pursuant to Title II of the concurrent resolution on the budget for fiscal year 2010 (S. Con. Res. 13).,Passed,0,174,0,3,225,25,0,2,0,0,0,0,225,199,0,5
194,D,111,H R 4872,25-Mar-2010,9:02 PM,On Motion to Concur in Senate Amendments,Reconciliation Act of 2010,Passed,0,175,0,2,220,32,0,1,0,0,0,0,220,207,0,3
195,D,111,H RES 1215,25-Mar-2010,9:11 PM,"On Motion to Suspend the Rules and Agree, as Amended",Expressing support for Bangladesh’s return to democracy,Passed,150,7,0,20,230,0,0,22,0,0,0,0,380,7,0,42
196,D,111,H RES 1222,13-Apr-2010,7:03 PM,On Motion to Suspend the Rules and Agree,Supporting the goals and ideals of National Library Week,Passed,157,0,0,20,240,0,0,12,0,0,0,0,397,0,0,32
197,D,111,H RES 1041,13-Apr-2010,7:18 PM,On Motion to Suspend the Rules and Agree,"Congratulating and commending the University of Idaho’s football team for winning the 2009 Humanitarian Bowl in Boise, Idaho",Passed,156,0,0,21,238,1,2,11,0,0,0,0,394,1,2,32
198,D,111,H RES 1042,13-Apr-2010,7:27 PM,On Motion to Suspend the Rules and Agree,Commending the Boise State University Broncos football team for winning the 2010 Fiesta Bowl,Passed,152,0,1,24,233,1,2,16,0,0,0,0,385,1,3,40
199,D,111,H RES 1236,14-Apr-2010,3:37 PM,On Motion to Suspend the Rules and Agree,"Honoring the coal miners who perished in the Upper Big Branch Mine-South in Raleigh County, West Virginia, extending condolences to their families and recognizing the valiant efforts of emergency response workers at the mine disaster.",Passed,168,0,0,9,241,0,0,11,0,0,0,0,409,0,0,20
200,D,111,H R 4994,14-Apr-2010,3:46 PM,"On Motion to Suspend the Rules and Pass, as Amended","To amend the Internal Revenue Code of 1986 to reduce taxpayer burdens and enhance taxpayer protections, and for other purposes.",Passed,156,9,0,12,243,0,0,9,0,0,0,0,399,9,0,21
201,D,111,H R 3125,14-Apr-2010,4:03 PM,"On Motion to Suspend the Rules and Pass, as Amended",To require an inventory of radio spectrum bands managed by the National Telecommunications and Information Administration and the Federal Communications Commission.,Passed,150,18,0,9,244,0,0,8,0,0,0,0,394,18,0,17
202,D,111,H RES 1249,14-Apr-2010,4:28 PM,On Motion to Refer the Resolution,None,Passed,0,154,12,11,235,3,5,9,0,0,0,0,235,157,17,20
203,D,111,H RES 1246,14-Apr-2010,4:48 PM,On Motion to Suspend the Rules and Agree,"Expressing sympathy to the people of Poland in the aftermath of the tragic plane crash that killed the country’s President, First Lady, and 94 others on April 10, 2010",Passed,164,0,0,13,240,0,0,13,0,0,0,0,404,0,0,26
204,D,111,H RES 1248,15-Apr-2010,1:37 PM,On Agreeing to the Resolution,"Providing for consideration of the bill (H.R. 4715), Clean Estuaries Act of 2010 and waiving a requirement of clause 6(a) of rule XIII with respect to consideration of certain resolutions reported from the Committee on Rules, and providing for consideration of motions to suspend the rules",Passed,0,168,0,9,235,3,0,14,0,0,0,0,235,171,0,23
205,D,111,H RES 1062,15-Apr-2010,1:56 PM,"On Motion to Suspend the Rules and Agree, as Amended","Recognizing the Coast Guard Group Astoria’s more than 60 years of service to the Pacific Northwest, and for other purposes",Passed,165,0,0,12,236,0,0,17,0,0,0,0,401,0,0,29
206,D,111,H RES 1255,15-Apr-2010,4:16 PM,On Motion to Refer the Resolution,Raising a question of the privileges of the House,Passed,151,0,13,13,234,0,5,14,0,0,0,0,385,0,18,27
207,D,111,H R 4715,15-Apr-2010,4:36 PM,On Agreeing to the Amendment,None,Agreed to,56,107,0,14,238,2,0,19,0,0,0,0,294,109,0,33
208,D,111,H R 4715,15-Apr-2010,5:08 PM,On Motion to Recommit with Instructions,"To amend the Federal Water Pollution Control Act to reauthorize the National Estuary Program, and for other purposes.",Failed,164,0,0,13,28,214,0,11,0,0,0,0,192,214,0,24
209,D,111,H R 4715,15-Apr-2010,5:17 PM,On Passage,"To amend the Federal Water Pollution Control Act to reauthorize the National Estuary Program, and for other purposes.",Passed,38,126,0,13,240,2,0,11,0,0,0,0,278,128,0,24
210,D,111,H RES 1242,15-Apr-2010,5:25 PM,On Motion to Suspend the Rules and Agree,Congratulating the Duke University men’s basketball team for winning the 2010 NCAA Division I Men’s Basketball National Championship,Passed,161,0,0,16,229,0,12,12,0,0,0,0,390,0,12,28
211,D,111,H R 4851,15-Apr-2010,8:08 PM,On Motion to Concur in the Senate Amendment,Continuing Extension Act,Passed,49,111,0,17,240,1,0,12,0,0,0,0,289,112,0,29
212,D,111,H RES 1257,20-Apr-2010,6:59 PM,On Motion to Suspend the Rules and Agree,"Supporting the goals and ideals of National Financial Literacy Month, 2010, and for other purposes",Passed,161,4,0,12,236,0,0,17,0,0,0,0,397,4,0,29
213,D,111,H RES 1271,20-Apr-2010,7:08 PM,On Motion to Suspend the Rules and Agree,Honoring the life and achievements of Rev. Benjamin Lawson Hooks,Passed,165,0,0,12,242,0,0,11,0,0,0,0,407,0,0,23
214,D,111,S 1963,21-Apr-2010,3:43 PM,"On Motion to Suspend the Rules and Pass, as Amended","To amend title 38, United States Code, to provide assistance to caregivers of veterans, to improve the provision of health care to veterans, and for other purposes",Passed,174,0,0,3,245,0,0,8,0,0,0,0,419,0,0,11
215,D,111,H RES 1104,21-Apr-2010,3:52 PM,On Motion to Suspend the Rules and Agree,Supporting the mission and goals of 2010 National Crime Victims’ Rights Week,Passed,174,0,0,3,243,0,0,10,0,0,0,0,417,0,0,13
216,D,111,H RES 1216,21-Apr-2010,4:08 PM,On Motion to Suspend the Rules and Agree,Congratulating Reverend Daniel P. Coughlin on his 10th year of service as Chaplain of the House of Representatives,Passed,173,0,0,4,239,0,0,15,0,0,0,0,412,0,0,19
217,D,111,H RES 1287,22-Apr-2010,12:15 PM,On Ordering the Previous Question,Flake Privileged Resolution,Failed,163,0,11,3,24,218,5,6,0,0,0,0,187,218,16,9
218,D,111,H RES 1287,22-Apr-2010,12:32 PM,On Motion to Refer the Resolution,Flake Privileged Resolution,Passed,161,0,12,4,241,0,5,7,0,0,0,0,402,0,17,11
219,D,111,H R 2194,22-Apr-2010,12:40 PM,On Motion to Instruct Conferees,"Comprehensive Iran Sanctions, Accountability, and Divestment Act",Passed,171,4,0,2,232,7,3,11,0,0,0,0,403,11,3,13
220,D,111,H RES 1270,22-Apr-2010,12:50 PM,On Motion to Suspend the Rules and Agree,Expressing support for Mathematics Awareness Month,Passed,168,2,0,7,239,0,0,14,0,0,0,0,407,2,0,21
221,D,111,H R 4543,26-Apr-2010,6:58 PM,On Motion to Suspend the Rules and Pass,Anthony J. Cortese Post Office Building,Passed,156,0,0,21,214,0,0,39,0,0,0,0,370,0,0,60
222,D,111,H RES 1103,26-Apr-2010,7:07 PM,"On Motion to Suspend the Rules and Agree, as Amended",Celebrating the life of Sam Houston on the 217th anniversary of his birth,Passed,156,0,0,21,219,0,0,34,0,0,0,0,375,0,0,55
223,D,111,H R 4861,26-Apr-2010,7:14 PM,On Motion to Suspend the Rules and Pass,Steve Goodman Post Office Building,Passed,153,0,0,24,218,0,0,35,0,0,0,0,371,0,0,59
224,D,111,H RES 1131,27-Apr-2010,4:20 PM,"On Motion to Suspend and Agree, as Amended","Expressing support for designation of the week of April 18, 2010 through April 23, 2010, as National Assistant Principals Week",Passed,169,0,0,8,242,0,0,11,0,0,0,0,411,0,0,19
225,D,111,H R 5017,27-Apr-2010,4:31 PM,"On Motion to Suspend the Rules and Pass, as Amended",Rural Housing Preservation and Stabilzation Act,Passed,108,62,0,7,244,0,0,9,0,0,0,0,352,62,0,16
226,D,111,H R 5146,27-Apr-2010,4:41 PM,On Motion to Suspend the Rules and Pass,To provide that Members of Congress shall not receive a cost of living adjustment in pay during fiscal year 2011,Passed,170,0,0,7,232,15,0,6,0,0,0,0,402,15,0,13
227,D,111,H R 5013,28-Apr-2010,2:48 PM,On Agreeing to the Amendment,None,Agreed to,169,0,0,8,247,0,0,12,0,0,0,0,416,0,0,20
228,D,111,H R 5013,28-Apr-2010,2:58 PM,On Agreeing to the Amendment,None,Agreed to,168,2,0,7,249,0,0,10,0,0,0,0,417,2,0,17
229,D,111,H R 5013,28-Apr-2010,3:33 PM,On Motion to Recommit with Instructions,Implementing Management for Performance and Related Reforms to Obtain Value in Every Acquisition Act of 2010,Passed,172,0,0,5,247,1,0,5,0,0,0,0,419,1,0,10
230,D,111,H R 5013,28-Apr-2010,3:41 PM,On Passage,Implementing Management for Performance and Related Reforms to Obtain Value in Every Acquisition Act of 2010,Passed,170,3,0,4,247,0,0,6,0,0,0,0,417,3,0,10
231,D,111,H RES 1305,29-Apr-2010,12:47 PM,On Ordering the Previous Question,Providing for consideration of the bill (H.R. 2499) to provide for a federally sanctioned self-determination process for the people of Puerto Rico,Passed,0,171,0,6,218,17,0,18,0,0,0,0,218,188,0,24
232,D,111,H RES 1305,29-Apr-2010,1:01 PM,On Agreeing to the Resolution,Providing for consideration of the bill (H.R. 2499) to provide for a federally sanctioned self-determination process for the people of Puerto Rico,Passed,1,170,0,6,221,20,0,12,0,0,0,0,222,190,0,18
233,D,111,H RES 1305,29-Apr-2010,1:32 PM,Table Motion to Reconsider,Providing for consideration of the bill (H.R. 2499) to provide for a federally sanctioned self-determination process for the people of Puerto Rico,Passed,3,165,0,9,196,21,0,36,0,0,0,0,199,186,0,45
234,D,111,H R 2499,29-Apr-2010,5:29 PM,On Agreeing to the Amendment,None,Agreed to,149,19,0,9,74,160,0,25,0,0,0,0,223,179,0,34
235,D,111,H R 2499,29-Apr-2010,5:38 PM,On Agreeing to the Amendment,None,Failed,118,49,0,10,46,187,0,26,0,0,0,0,164,236,0,36
236,D,111,H R 2499,29-Apr-2010,5:44 PM,On Agreeing to the Amendment,None,Failed,1,165,0,11,12,221,0,26,0,0,0,0,13,386,0,37
237,D,111,H R 2499,29-Apr-2010,5:51 PM,On Agreeing to the Amendment,None,Agreed to,114,53,0,10,187,47,0,25,0,0,0,0,301,100,0,35
238,D,111,H R 2499,29-Apr-2010,5:58 PM,On Agreeing to the Amendment,None,Failed,0,166,0,11,11,221,0,27,0,0,0,0,11,387,0,38
239,D,111,H R 2499,29-Apr-2010,6:05 PM,On Agreeing to the Amendment,None,Failed,62,104,0,11,50,181,0,28,0,0,0,0,112,285,0,39
240,D,111,H R 2499,29-Apr-2010,6:11 PM,On Agreeing to the Amendment,None,Failed,116,48,0,13,55,175,0,29,0,0,0,0,171,223,0,42
241,D,111,H R 2499,29-Apr-2010,6:39 PM,On Motion to Recommit with Instructions,Puerto Rico Democracy Act,Failed,162,6,0,9,32,192,0,29,0,0,0,0,194,198,0,38
242,D,111,H R 2499,29-Apr-2010,6:55 PM,On Passage,Puerto Rico Democracy Act,Passed,39,129,0,9,184,40,1,28,0,0,0,0,223,169,1,37
243,D,111,H RES 1307,4-May-2010,6:59 PM,On Motion to Suspend the Rules and Agree,Honoring the National Science Foundation for 60 years of service to the Nation,Passed,150,2,0,25,220,0,0,33,0,0,0,0,370,2,0,58
244,D,111,H RES 1213,4-May-2010,7:09 PM,On Motion to Suspend the Rules and Agree,"Recognizing the need to improve the participation and performance of America’s students in Science, Technology, Engineering, and Mathematics (STEM) fields, supporting the ideals of National Lab Day, and for other purposes",Passed,151,2,0,24,227,0,0,26,0,0,0,0,378,2,0,50
245,D,111,H RES 1132,4-May-2010,7:16 PM,"On Motion to Suspend the Rules and Agree, as Amended",Honoring the USS New Mexico as the sixth Virginia-class submarine commissioned by the U.S. Navy to protect and defend the United States,Passed,152,0,0,25,226,1,0,26,0,0,0,0,378,1,0,51
246,D,111,H RES 1320,5-May-2010,2:20 PM,"On Motion to Suspend the Rules and Agree, as Amended","Attempted Terrorist Attack in Times Square on May 1, 2010",Passed,172,0,0,5,246,0,0,7,0,0,0,0,418,0,0,12
247,D,111,H RES 1272,5-May-2010,2:33 PM,On Motion to Suspend the Rules and Agree,"Commemorating the 40th anniversary of the May 4, 1970, Kent State University shootings",Passed,168,0,2,7,247,0,0,6,0,0,0,0,415,0,2,13
248,D,111,H RES 1301,5-May-2010,2:45 PM,"On Motion to Suspend the Rules and Agree, as Amended",Supporting the goals and ideals of National Train Day,Passed,50,119,0,8,246,0,0,7,0,0,0,0,296,119,0,15
249,D,111,H RES 1329,6-May-2010,11:53 AM,On Agreeing to the Resolution,"Providing for consideration of the bill (H.R. 5019) to provide for the establishment of the Home Star Retrofit Rebate Program, and for other purposes",Passed,0,171,0,6,229,11,0,13,0,0,0,0,229,182,0,19
250,D,111,H RES 1295,6-May-2010,12:03 PM,On Motion to Suspend the Rules and Agree,Celebrating the role of mothers in the United States and supporting the goals and ideals of Mother’s Day,Passed,170,0,0,7,247,0,0,6,0,0,0,0,417,0,0,13
251,D,111,H R 1722,6-May-2010,12:11 PM,"On Motion to Suspend the Rules and Pass, as Amended",Telework Improvements Act,Failed,24,147,0,6,244,0,0,9,0,0,0,0,268,147,0,15
252,D,111,H R 5019,6-May-2010,2:35 PM,On Agreeing to the Amendment,None,Failed,166,1,0,10,14,236,0,9,0,0,0,0,180,237,0,19
253,D,111,H R 5019,6-May-2010,2:42 PM,On Agreeing to the Amendment,None,Failed,167,1,0,9,23,227,0,9,0,0,0,0,190,228,0,18
254,D,111,H R 5019,6-May-2010,3:37 PM,On Motion to Recommit with Instructions,Home Star Energy Retrofit Act,Passed,168,1,0,8,178,67,0,8,0,0,0,0,346,68,0,16
255,D,111,H R 5019,6-May-2010,3:44 PM,On Passage,Home Star Energy Retrofit Act,Passed,12,154,0,11,234,7,0,12,0,0,0,0,246,161,0,23
256,D,111,H RES 1294,11-May-2010,6:56 PM,On Motion to Suspend the Rules and Agree,Expressing support for designation of the first Saturday in May as National Explosive Ordnance Disposal Day to honor those who are serving and have served in the noble and self-sacrificing profession of Explosive Ordnance Disposal in the United States Armed Forces,Passed,160,0,0,17,228,0,0,25,0,0,0,0,388,0,0,42
257,D,111,H RES 1328,11-May-2010,7:04 PM,On Motion to Suspend the Rules and Agree,Honoring the life and legacy of William Earnest “Ernie” Harwell,Passed,163,0,0,14,231,0,0,22,0,0,0,0,394,0,0,36
258,D,111,H RES 1299,11-May-2010,7:17 PM,On Motion to Suspend the Rules and Agree,Supporting the goals and ideals of Peace Officers Memorial Day,Passed,161,0,0,16,234,0,0,19,0,0,0,0,395,0,0,35
259,D,111,H RES 1344,12-May-2010,2:31 PM,On Agreeing to the Resolution,"Providing for consideration of the bill H.R. 5116, the America COMPETES Reauthorization Act of 2010",Passed,0,172,0,5,243,5,0,5,0,0,0,0,243,177,0,10
260,D,111,H R 5014,12-May-2010,2:39 PM,"On Motion to Suspend the Rules and Pass, as Amended",To clarify the health care provided by the Secretary of Veterans Affairs that constitutes minimum essential coverage,Passed,171,0,0,6,246,0,0,7,0,0,0,0,417,0,0,13
261,D,111,H CON RES 268,12-May-2010,2:47 PM,On Motion to Suspend the Rules and Agree,"Supporting the goals and ideals of National Women’s Health Week, and for other purposes",Passed,171,0,0,6,247,0,0,6,0,0,0,0,418,0,0,12
262,D,111,H R 5116,12-May-2010,5:56 PM,On Agreeing to the Amendment,None,Agreed to,165,5,0,7,252,1,0,6,0,0,0,0,417,6,0,13
263,D,111,H R 5116,12-May-2010,6:04 PM,On Agreeing to the Amendment,None,Failed,161,8,0,8,2,250,0,7,0,0,0,0,163,258,0,15
264,D,111,H R 5116,12-May-2010,6:17 PM,On Agreeing to the Amendment,None,Agreed to,1,170,0,6,253,3,0,3,0,0,0,0,254,173,0,9
265,D,111,H R 5116,12-May-2010,6:23 PM,On Agreeing to the Amendment,None,Agreed to,9,161,0,7,241,13,0,5,0,0,0,0,250,174,0,12
266,D,111,H R 5116,12-May-2010,6:31 PM,On Agreeing to the Amendment,None,Agreed to,159,10,0,8,254,0,0,5,0,0,0,0,413,10,0,13
267,D,111,H R 5116,13-May-2010,11:45 AM,On Agreeing to the Amendment,None,Agreed to,2,168,0,7,246,3,0,10,0,0,0,0,248,171,0,17
268,D,111,H R 5116,13-May-2010,11:53 AM,On Agreeing to the Amendment,None,Agreed to,170,0,0,7,249,0,0,10,0,0,0,0,419,0,0,17
269,D,111,H R 5116,13-May-2010,12:01 PM,On Agreeing to the Amendment,None,Agreed to,168,0,0,9,251,0,0,8,0,0,0,0,419,0,0,17
270,D,111,H R 5116,13-May-2010,12:56 PM,On Motion to Recommit with Instructions,America COMPETES Reauthorization Act,Passed,171,1,0,5,121,125,0,7,0,0,0,0,292,126,0,12
271,D,111,H RES 1338,13-May-2010,1:04 PM,On Motion to Suspend the Rules and Agree,Recognizing the significant accomplishments of AmeriCorps,Passed,44,128,0,5,236,0,0,17,0,0,0,0,280,128,0,22
272,D,111,H RES 1337,13-May-2010,1:11 PM,On Motion to Suspend the Rules and Agree,"Expressing the sympathy and condolences of the House of Representatives to those people affected by the flooding in Tennessee, Kentucky, and Mississippi in May, 2010",Passed,171,0,0,6,231,0,0,22,0,0,0,0,402,0,0,28
273,D,111,H R 2288,18-May-2010,7:02 PM,"On Motion to Suspend the Rules and Pass, as Amended",Endangered Fish Recovery Programs Improvement Act of 2009,Passed,36,119,0,22,228,3,0,22,0,0,0,0,264,122,0,44
274,D,111,H R 4614,18-May-2010,7:10 PM,"On Motion to Suspend the Rules and Pass, as Amended",Katie Sepich Enhanced DNA Collection Act of 2010,Passed,124,32,0,21,233,0,0,20,0,0,0,0,357,32,0,41
275,D,111,H RES 1327,18-May-2010,7:17 PM,On Motion to Suspend the Rules and Agree,"Honoring the life, achievements, and contributions of Floyd Dominy",Passed,155,0,0,22,235,0,0,18,0,0,0,0,390,0,0,40
276,D,111,H R 1514,19-May-2010,12:42 PM,On Motion to Suspend the Rules and Pass,Juvenile Accountability Block Grants Program Reauthorization Act of 2009,Passed,119,44,0,14,245,1,0,7,0,0,0,0,364,45,0,21
277,D,111,H R 5325,19-May-2010,12:51 PM,On Motion to Suspend the Rules and Pass,America COMPETES Reauthorization Act,Failed,15,148,0,14,246,0,0,8,0,0,0,0,261,148,0,22
278,D,111,H RES 1325,19-May-2010,12:59 PM,"On Motion to Suspend the Rules and Agree, as Amended",Recognizing National Missing Children’s Day,Passed,164,0,0,13,246,0,0,7,0,0,0,0,410,0,0,20
279,D,111,H RES 1362,19-May-2010,1:08 PM,On Motion to Suspend the Rules and Agree,Celebrating the life and achievements of Lena Mary Calhoun Horne and honoring her for her triumphs against racial discrimination and her steadfast commitment to the civil rights of all people,Passed,162,1,0,14,243,0,0,10,0,0,0,0,405,1,0,24
280,D,111,H R 5099,19-May-2010,4:25 PM,On Motion to Suspend the Rules and Pass,Michael C. Rothberg Post Office,Passed,163,1,0,13,247,0,0,6,0,0,0,0,410,1,0,19
281,D,111,H RES 403,19-May-2010,4:33 PM,"On Motion to Suspend the Rules and Agree, as Amended",Expressing the sense of the House of Representatives that there should be established a National Teacher Day to honor and celebrate teachers in the United States,Passed,159,2,1,15,246,0,0,7,0,0,0,0,405,2,1,22
282,D,111,H RES 1292,19-May-2010,4:41 PM,"On Motion to Suspend the Rules and Agree, as Amended",Congratulating the Emporia State University Lady Hornets women’s basketball team for winning the 2010 NCAA Division II National Championship,Passed,162,1,0,14,245,0,1,7,0,0,0,0,407,1,1,21
283,D,111,H RES 1364,19-May-2010,4:48 PM,On Motion to Suspend the Rules and Agree,"Honoring the historic and community significance of the Chatham County Courthouse and expressing condolences to Chatham County and the town of Pittsboro for the fire damage sustained by the courthouse on March 25, 2010",Passed,164,1,0,12,242,0,0,11,0,0,0,0,406,1,0,23
284,D,111,H R 5327,20-May-2010,1:48 PM,"On Motion to Suspend the Rules and Pass, as Amended",To authorize assistance to Israel for the Iron Dome anti-missile defense system,Passed,166,1,0,10,244,3,0,6,0,0,0,0,410,4,0,16
285,D,111,H RES 1256,20-May-2010,1:57 PM,On Motion to Suspend the Rules and Agree,Congratulating Phil Mickelson on winning the 2010 Masters golf tournament,Passed,162,0,4,11,239,0,4,10,0,0,0,0,401,0,8,21
286,D,111,H RES 1336,20-May-2010,2:18 PM,On Motion to Suspend the Rules and Agree,Congratulating the University of Texas men’s swimming and diving team for winning the NCAA Division I national championship,Passed,164,0,4,9,241,0,3,10,0,0,0,0,405,0,7,19
287,D,111,H RES 1361,20-May-2010,2:26 PM,"On Motion to Suspend the Rules and Agree, as Amended",Recognizing North Carolina Central University on its 100th anniversary,Passed,166,1,0,10,242,0,0,12,0,0,0,0,408,1,0,22
288,D,111,H RES 1363,20-May-2010,4:08 PM,On Ordering the Previous Question,Granting the authority provided under clause 4(c)(3) of rule X of the Rules of the House of Representatives to the Committee on Education and Labor for purposes of its investigation into underground coal mining safety,Passed,0,168,0,9,240,9,0,5,0,0,0,0,240,177,0,14
289,D,111,H RES 1363,20-May-2010,4:15 PM,On Agreeing to the Resolution,Granting the authority provided under clause 4(c)(3) of rule X of the Rules of the House of Representatives to the Committee on Education and Labor for purposes of its investigation into underground coal mining safety,Passed,166,1,0,10,247,0,0,7,0,0,0,0,413,1,0,17
290,D,111,H R 5128,20-May-2010,4:23 PM,"On Motion to Suspend the Rules and Pass, as Amended","To designate the Department of the Interior Building in Washington, District of Columbia, as the “Steawart Lee Undall Department of the Interior Building”",Passed,164,1,0,12,245,0,0,9,0,0,0,0,409,1,0,21
291,D,111,H CON RES 278,24-May-2010,7:03 PM,On Motion to Suspend the Rules and Agree,"Expressing the sense of Congress that a grateful Nation supports and salutes Sons and Daughters in Touch on its 20th Anniversary that is being held on Father’s Day, 2010, at the Vietnam Veterans Memorial in Washington, the District of Columbia",Passed,153,0,0,23,218,0,0,36,0,0,0,0,371,0,0,59
292,D,111,H R 1017,24-May-2010,7:12 PM,"On Motion to Suspend the Rules and Pass, as Amended",Chiropractic Care Available to All Veterans Act,Passed,146,6,0,24,219,0,0,35,0,0,0,0,365,6,0,59
293,D,111,H R 5330,24-May-2010,7:22 PM,"On Motion to Suspend the Rules and Pass, as Amended","To amend the Antitrust Criminal Penalty Enhancement and Reform Act of 2004 to extend the operation of such Act for a 5-year period ending June 22, 2015, and for other purposes",Passed,150,4,0,22,216,0,0,38,0,0,0,0,366,4,0,60
294,D,111,H R 5145,25-May-2010,3:01 PM,"On Motion to Suspend the Rules and Pass, as Amended",Assuring Quality Care for Veterans Act,Passed,165,2,0,9,248,0,0,6,0,0,0,0,413,2,0,15
295,D,111,H RES 1258,25-May-2010,3:08 PM,"On Motion to Suspend the Rules and Agree, as Amended",Expressing support for designation of May 2010 as Mental Health Month,Passed,166,1,0,9,248,0,0,6,0,0,0,0,414,1,0,15
296,D,111,H RES 1382,25-May-2010,3:31 PM,On Motion to Suspend the Rules and Agree,"Expressing sympathy to the families of those killed by North Korea in the sinking of the Republic of Korea Ship Cheonan, and solidarity with the Republic of Korea in the aftermath of this tragic incident",Passed,166,2,0,9,245,1,0,8,0,0,0,0,411,3,0,17
297,D,111,H RES 584,25-May-2010,3:41 PM,On Motion to Suspend the Rules and Agree,Recognizing the importance of manufactured and modular housing in the United States,Passed,162,4,1,10,246,0,0,8,0,0,0,0,408,4,1,18
298,D,111,H R 3885,25-May-2010,6:00 PM,On Motion to Suspend the Rules and Pass,Veterans Dog Training Therapy Act,Passed,159,4,0,14,244,0,0,10,0,0,0,0,403,4,0,24
299,D,111,H R 2711,25-May-2010,6:09 PM,On Motion to Suspend the Rules and Concur in the Senate Amendments,Special Agent Samuel Hicks Families of Fallen Heroes Act,Passed,167,0,0,10,249,0,0,5,0,0,0,0,416,0,0,15
300,D,111,H RES 1189,25-May-2010,6:17 PM,On Motion to Suspend the Rules and Agree,Commending Lance Mackey on winning a record 4th straight Iditarod Trail Sled Dog Race,Passed,165,0,2,10,246,0,1,7,0,0,0,0,411,0,3,17
301,D,111,H RES 1172,25-May-2010,6:25 PM,On Motion to Suspend the Rules and Agree,Recognizing the life and achievements of Will Keith Kellogg,Passed,166,0,0,11,244,0,0,10,0,0,0,0,410,0,0,21
302,D,111,H RES 1347,26-May-2010,6:17 PM,On Motion to Suspend the Rules and Agree,"Honoring the workers who perished on the Deepwater Horizon offshore oil platform in the Gulf of Mexico off the coast of Louisiana, extending condolences to their families, and recognizing the valiant efforts of emergency response workers at the disaster site",Passed,164,0,0,13,239,0,0,15,0,0,0,0,403,0,0,28
303,D,111,H RES 1385,26-May-2010,6:26 PM,On Motion to Suspend the Rules and Agree,"Recognizing and honoring the courage and sacrifice of the members of the Armed Forces and veterans, and for other purposes",Passed,169,0,0,8,245,0,0,9,0,0,0,0,414,0,0,17
304,D,111,H RES 1316,26-May-2010,6:34 PM,"On Motion to Suspend the Rules and Agree, as Amended",Celebrating Asian/Pacific American Heritage Month,Passed,167,0,0,10,241,0,0,13,0,0,0,0,408,0,0,23
305,D,111,H RES 1169,26-May-2010,6:43 PM,"On Motion to Suspend the Rules and Agree, as Amended",Honoring the 125th anniversary of Rollins College,Passed,132,36,0,9,239,0,0,15,0,0,0,0,371,36,0,24
306,D,111,H CON RES 282,27-May-2010,12:18 PM,On Agreeing to the Resolution,Providing for an adjournment or recess of the two Houses,Passed,10,160,0,7,220,27,0,7,0,0,0,0,230,187,0,14
307,D,111,H RES 1404,27-May-2010,12:31 PM,On Agreeing to the Resolution,"Providing for consideration of the bill H.R. 5136, the National Defense Authorization Act for Fiscal Year 2011",Passed,1,167,0,9,240,11,0,3,0,0,0,0,241,178,0,12
308,D,111,H RES 1161,27-May-2010,12:38 PM,On Motion to Suspend the Rules and Agree,"Honoring the Centennial Celebration of Women at Marquette University, the fist Catholic university in the world to offer co-education as part of its regular undergraduate program",Passed,168,0,0,9,212,0,36,6,0,0,0,0,380,0,36,15
309,D,111,H RES 1372,27-May-2010,12:53 PM,On Motion to Suspend the Rules and Agree,Honoring the University of Georgia Graduate School on the occasion of its centennial,Passed,167,0,0,10,245,0,1,8,0,0,0,0,412,0,1,18
310,D,111,H R 5136,27-May-2010,5:03 PM,On Agreeing to the Amendment,None,Agreed to,172,0,0,5,249,0,0,11,0,0,0,0,421,0,0,16
311,D,111,H R 5136,27-May-2010,5:11 PM,On Agreeing to the Amendment,None,Agreed to,171,0,0,6,252,0,0,8,0,0,0,0,423,0,0,14
312,D,111,H R 5136,27-May-2010,5:20 PM,On Agreeing to the Amendment,None,Agreed to,87,85,0,5,254,0,0,6,0,0,0,0,341,85,0,11
313,D,111,H R 5136,27-May-2010,9:17 PM,On Agreeing to the Amendment,None,Agreed to,164,8,0,5,246,0,0,14,0,0,0,0,410,8,0,19
314,D,111,H R 5136,27-May-2010,9:26 PM,On Agreeing to the Amendment,None,Agreed to,126,47,0,4,246,5,0,9,0,0,0,0,372,52,0,13
315,D,111,H R 5136,27-May-2010,9:34 PM,On Agreeing to the Amendment,None,Agreed to,12,161,0,4,206,49,0,6,0,0,0,0,218,210,0,10
316,D,111,H R 5136,27-May-2010,9:51 PM,On Agreeing to the Amendment,None,Failed,57,116,0,4,136,115,3,6,0,0,0,0,193,231,3,10
317,D,111,H R 5136,27-May-2010,10:07 PM,On Agreeing to the Amendment,None,Agreed to,5,168,0,4,229,26,0,6,0,0,0,0,234,194,0,10
318,D,111,H R 5136,27-May-2010,10:16 PM,On Agreeing to the Amendment,None,Agreed to,10,161,0,6,243,11,0,6,0,0,0,0,253,172,0,12
319,D,111,JOURNAL,28-May-2010,11:00 AM,On Approving the Journal,None,Passed,16,151,1,9,214,31,0,9,0,0,0,0,230,182,1,18
320,D,111,H RES 1391,28-May-2010,11:09 AM,"On Motion to Suspend the Rules and Agree, as Amended",Congratulating Israel for its accession to membership in the Organization for Economic Co-operation and Development,Passed,172,0,0,5,246,0,0,8,0,0,0,0,418,0,0,13
321,D,111,H RES 1403,28-May-2010,11:17 AM,On Ordering the Previous Question,"Providing for consideration of the Senate amendment to the bill (H.R. 4213) to amend the Internal Revenue Code of 1986 to extend certain expiring provisions, and for other purposes",Passed,0,169,0,8,235,13,0,6,0,0,0,0,235,182,0,14
322,D,111,H RES 1403,28-May-2010,11:27 AM,On Agreeing to the Amendment,None,Agreed to,0,172,0,5,215,34,0,6,0,0,0,0,215,206,0,11
323,D,111,H RES 1403,28-May-2010,11:36 AM,"On Agreeing to the Resolution, as Amended","Providing for consideration of the Senate amendment to the bill (H.R. 4213) to amend the Internal Revenue Code of 1986 to extend certain expiring provisions, and for other purposes",Passed,0,170,0,7,221,29,0,5,0,0,0,0,221,199,0,12
324,D,111,H R 4213,28-May-2010,1:38 PM,On concurring in Senate amdt with amdt (except portion comprising section 523),"American Workers, State, and Business Relief Act of 2010",Passed,1,170,0,6,214,34,0,7,0,0,0,0,215,204,0,13
325,D,111,H R 4213,28-May-2010,1:52 PM,On concurring in Senate amdt with portion of amdt comprising section 523,"American Workers, State, and Business Relief Act of 2010",Agreed to,15,156,0,6,230,15,0,10,0,0,0,0,245,171,0,16
326,D,111,H R 5116,28-May-2010,2:21 PM,"First Portion of the Divided Question, Proposing to Strike Section 228",America COMPETES Reauthorization Act,Failed,170,1,0,6,5,242,0,7,0,0,0,0,175,243,0,13
327,D,111,H R 5116,28-May-2010,2:27 PM,"Second Portion of the Divided Question, Proposing to Strike Sections 406(b) and (c)",America COMPETES Reauthorization Act,Failed,163,5,0,9,0,239,0,15,0,0,0,0,163,244,0,24
328,D,111,H R 5116,28-May-2010,2:35 PM,"Sixth Portion of the Divided Question, Proposing to Amend Section 702",America COMPETES Reauthorization Act,Failed,171,0,0,6,26,215,0,13,0,0,0,0,197,215,0,19
329,D,111,H R 5116,28-May-2010,2:41 PM,"Seventh Portion of the Divided Question, Proposing to Add a Section 704",America COMPETES Reauthorization Act,Passed,165,0,0,12,244,0,0,10,0,0,0,0,409,0,0,22
330,D,111,H R 5116,28-May-2010,2:48 PM,"Eighth Portion of the Divided Question, Proposing to Add a Section 705",America COMPETES Reauthorization Act,Passed,169,0,0,8,179,68,0,7,0,0,0,0,348,68,0,15
331,D,111,H R 5116,28-May-2010,2:54 PM,"Ninth Portion of the Divided Question, Proposing to Add a Section 706",America COMPETES Reauthorization Act,Failed,169,1,0,7,12,233,0,9,0,0,0,0,181,234,0,16
332,D,111,H R 5116,28-May-2010,3:01 PM,On Passage,America COMPETES Reauthorization Act,Passed,17,150,0,10,245,0,0,10,0,0,0,0,262,150,0,20
333,D,111,H R 5136,28-May-2010,3:19 PM,"On Agreeing to the En Bloc Amendments, as Modified",None,Agreed to,168,1,0,8,248,0,0,12,0,0,0,0,416,1,0,20
334,D,111,H R 5136,28-May-2010,3:45 PM,Table Appeal of the Ruling of the Chair,National Defense Authorization Act for Fiscal Year 2011,Passed,3,165,0,9,224,18,0,12,0,0,0,0,227,183,0,21
335,D,111,H R 5136,28-May-2010,4:09 PM,On Motion to Recommit with Instructions,National Defense Authorization Act for Fiscal Year 2011,Passed,168,1,0,8,114,130,0,10,0,0,0,0,282,131,0,18
336,D,111,H R 5136,28-May-2010,4:19 PM,On Passage,National Defense Authorization Act for Fiscal Year 2011,Passed,9,160,0,8,220,26,0,9,0,0,0,0,229,186,0,17
337,D,111,H R 1061,8-Jun-2010,6:26 PM,"On Motion to Suspend the Rules and Pass, as Amended",Hoh Indian Tribe Safe Homelands Act,Passed,146,0,0,31,201,0,0,53,0,0,0,0,347,0,0,84
338,D,111,H RES 518,8-Jun-2010,6:34 PM,"On Motion to Suspend the Rules and Agree, as Amended","Honoring the life of Jacques-Yves Cousteau, explorer, researcher, and pioneer in the field of marine conservation",Passed,146,0,0,31,208,0,0,46,0,0,0,0,354,0,0,77
339,D,111,H RES 1424,9-Jun-2010,2:54 PM,On Ordering the Previous Question,"Providing for consideration of the bill H.R. 5072, the FHA Reform Act",Passed,0,170,0,7,230,10,0,14,0,0,0,0,230,180,0,21
340,D,111,H RES 1424,9-Jun-2010,3:02 PM,On Agreeing to the Resolution,"Providing for consideration of the bill H.R. 5072, the FHA Reform Act",Passed,0,168,0,9,239,4,0,11,0,0,0,0,239,172,0,20
341,D,111,H RES 989,9-Jun-2010,3:11 PM,On Motion to Suspend the Rules and Agree,"Expressing the sense of the House of Representatives that the United States should adopt national policies and pursue international agreements to prevent ocean acidification, to study the impacts of ocean acidification, and to address the effects of ocean acidification on marine ecosystems and coastal economies",Failed,19,150,0,8,222,20,0,12,0,0,0,0,241,170,0,20
342,D,111,H RES 1178,9-Jun-2010,3:20 PM,"On Motion to Suspend the Rules and Agree, as Amended",Directing the Clerk of the House of Representatives to compile the cost estimates prepared by the Congressional Budget Office which are included in reports filed by the committees of the House on approved legislation and post such estimates on the official public Internet site of the Office of the Clerk,Passed,147,22,0,8,243,0,0,11,0,0,0,0,390,22,0,19
343,D,111,H R 4173,9-Jun-2010,5:02 PM,On Motion to Instruct Conferees,Wall Street Reform and Consumer Protection Act of 2009,Failed,170,0,0,7,28,217,0,9,0,0,0,0,198,217,0,16
344,D,111,H RES 1330,9-Jun-2010,5:10 PM,"On Motion to Suspend the Rules and Agree, as Amended","Recognizing June 8, 2010, as World Ocean Day",Passed,125,44,0,8,244,0,0,10,0,0,0,0,369,44,0,18
345,D,111,H R 5278,9-Jun-2010,5:22 PM,On Motion to Suspend the Rules and Pass,"To designate the facility of the United States Postal Service located at 405 West Second Street in Dixon, Illinois, as the “President Ronald W. Reagan Post Office Building”",Passed,169,0,0,8,247,0,0,7,0,0,0,0,416,0,0,15
346,D,111,H R 5133,9-Jun-2010,5:29 PM,On Motion to Suspend the Rules and Pass,"To designate the facility of the United States Postal Service located at 331 1st Street in Carlstadt, New Jersey, as the “Staff Sergeant Frank T. Carvill and Lance Corporal Michael A. Schwarz Post Office Building”",Passed,165,0,0,12,244,0,0,10,0,0,0,0,409,0,0,22
347,D,111,H R 5072,10-Jun-2010,1:29 PM,On Agreeing to the Amendment,None,Agreed to,167,3,0,7,250,0,0,10,0,0,0,0,417,3,0,17
348,D,111,H R 5072,10-Jun-2010,1:40 PM,On Agreeing to the Amendment,None,Failed,124,46,0,7,7,243,0,10,0,0,0,0,131,289,0,17
349,D,111,H R 5072,10-Jun-2010,1:50 PM,On Agreeing to the Amendment,None,Failed,105,65,0,7,1,251,0,8,0,0,0,0,106,316,0,15
350,D,111,H R 5072,10-Jun-2010,1:57 PM,On Agreeing to the Amendment,None,Failed,109,61,0,7,12,240,0,8,0,0,0,0,121,301,0,15
351,D,111,H R 5072,10-Jun-2010,2:04 PM,On Agreeing to the Amendment,None,Agreed to,170,1,0,6,250,3,0,7,0,0,0,0,420,4,0,13
352,D,111,H R 5072,10-Jun-2010,2:10 PM,On Agreeing to the Amendment,None,Agreed to,169,0,0,8,247,0,1,12,0,0,0,0,416,0,1,20
353,D,111,H R 5072,10-Jun-2010,2:39 PM,On Passage,FHA Reform Act of 2010,Passed,165,3,0,9,241,1,0,12,0,0,0,0,406,4,0,21
354,D,111,S 3473,10-Jun-2010,2:47 PM,On Motion to Suspend the Rules and Pass,To amend the Oil Pollution Act of 1990 to authorize advances from Oil Spill Liability Trust Fund for the Deepwater Horizon oil spill,Passed,165,0,0,12,245,0,1,8,0,0,0,0,410,0,1,20
355,D,111,H RES 1368,14-Jun-2010,6:58 PM,On Motion to Suspend the Rules and Agree,Supporting the goals of National Dairy Month,Passed,145,0,0,32,214,0,0,40,0,0,0,0,359,0,0,72
356,D,111,H RES 1409,14-Jun-2010,7:16 PM,On Motion to Suspend the Rules and Agree,"Expressing support for designation of June 20, 2010, as “American Eagle Day”, and celebrating the recovery and restoration of the bald eagle, the national symbol of the United States",Passed,148,0,0,30,212,0,0,42,0,0,0,0,360,0,0,72
357,D,111,H R 5502,14-Jun-2010,7:26 PM,On Motion to Suspend the Rules and Pass,To amend the effective date of the gift card provisions of the Credit Card Accountability Responsibility and Disclosure Act of 2009,Passed,147,0,0,31,210,0,0,44,0,0,0,0,357,0,0,75
358,D,111,H RES 1383,15-Jun-2010,3:23 PM,On Motion to Suspend the Rules and Agree,Honoring Dr. Larry Case on his retirement as National FFA Advisor,Passed,164,0,0,14,245,0,0,9,0,0,0,0,409,0,0,23
359,D,111,H RES 1436,15-Jun-2010,3:36 PM,On Agreeing to the Resolution,"Providing for consideration of H.R. 5486, the Small Business Jobs Tax Relief Act; and providing for consideration of H.R. 5297, the Small Business Lending Fund Act",Passed,0,166,0,12,228,20,0,6,0,0,0,0,228,186,0,18
360,D,111,H R 4855,15-Jun-2010,3:44 PM,"On Motion to Suspend the Rules and Pass, as Amended",Work-Life Balance Award Act,Failed,19,147,0,12,230,16,0,8,0,0,0,0,249,163,0,20
361,D,111,H RES 1389,15-Jun-2010,5:14 PM,On Motion to Suspend the Rules and Agree,"Recognizing the immeasurable contributions of fathers in the healthy development of children, supporting responsible fatherhood, and encouraging greater involvement of fathers in the lives of their children, especially on Father’s Day",Passed,167,0,0,11,249,0,0,5,0,0,0,0,416,0,0,16
362,D,111,H R 5486,15-Jun-2010,5:44 PM,On Motion to Recommit with Instructions,Small Business Jobs Tax Relief Act of 2010,Failed,166,1,0,11,21,229,0,4,0,0,0,0,187,230,0,15
363,D,111,H R 5486,15-Jun-2010,5:51 PM,On Passage,Small Business Jobs Tax Relief Act of 2010,Passed,5,162,0,11,242,8,0,4,0,0,0,0,247,170,0,15
364,D,111,H RES 1322,15-Jun-2010,5:59 PM,On Motion to Suspend the Rules and Agree,Celebrating the 20th anniversary of the Albert Einstein Distinguished Educator Fellowship Program and recognizing the significant contributions of Albert Einstein Fellows,Passed,159,5,0,14,246,0,0,8,0,0,0,0,405,5,0,22
365,D,111,H CON RES 242,16-Jun-2010,4:36 PM,On Motion to Suspend the Rules and Agree,Honoring the NAACP on its 101st anniversary,Passed,172,0,0,6,249,0,0,5,0,0,0,0,421,0,0,11
366,D,111,H RES 1422,16-Jun-2010,4:45 PM,On Motion to Suspend the Rules and Agree,Honoring the Department of Justice on the occasion of its 140th anniversary,Passed,168,3,0,7,248,0,0,6,0,0,0,0,416,3,0,13
367,D,111,H RES 1414,16-Jun-2010,4:54 PM,"On Motion to Suspend and Agree, as Amended","Congratulating Urban Prep Charter Academy for Young Men - Englewood Campus, the Nation’s first all-male charter high school, for achieving a 100 percent college acceptance rate for all 107 members of its first graduating class of 2010",Passed,171,0,0,7,249,0,0,5,0,0,0,0,420,0,0,12
368,D,111,H RES 1448,17-Jun-2010,12:02 PM,On Ordering the Previous Question,"Providing for further consideration of the bill (H.R. 5297) to create the Small Business Lending Fund Program to direct the Secretary of the Treasury to make capital investments in eligible institutions in order to increase the availability of credit for small businesses, and for other purposes",Passed,0,172,0,6,241,7,0,6,0,0,0,0,241,179,0,12
369,D,111,H RES 1448,17-Jun-2010,12:09 PM,On Agreeing to the Resolution,"Providing for further consideration of the bill (H.R. 5297) to create the Small Business Lending Fund Program to direct the Secretary of the Treasury to make capital investments in eligible institutions in order to increase the availability of credit for small businesses, and for other purposes",Passed,0,169,0,9,237,10,0,7,0,0,0,0,237,179,0,16
370,D,111,H RES 1429,17-Jun-2010,12:18 PM,On Motion to Suspend the Rules and Agree,Celebrating the symbol of the United States flag and supporting the goals and ideals of Flag Day,Passed,170,0,0,8,248,0,0,6,0,0,0,0,418,0,0,14
371,D,111,H R 5297,17-Jun-2010,1:07 PM,On Agreeing to the Amendment,None,Agreed to,165,0,0,13,255,0,0,5,0,0,0,0,420,0,0,18
372,D,111,H R 5297,17-Jun-2010,1:14 PM,On Agreeing to the Amendment,None,Agreed to,165,0,1,12,249,0,0,11,0,0,0,0,414,0,1,23
373,D,111,H R 5297,17-Jun-2010,1:23 PM,On Agreeing to the Amendment,None,Agreed to,166,3,0,9,252,0,0,8,0,0,0,0,418,3,0,17
374,D,111,H R 5297,17-Jun-2010,1:55 PM,On Motion to Recommit with Instructions,Small Business Lending Fund Act of 2010,Failed,171,0,0,7,9,237,0,8,0,0,0,0,180,237,0,15
375,D,111,H R 5297,17-Jun-2010,2:03 PM,On Passage,Small Business Lending Fund Act of 2010,Passed,3,169,0,6,238,13,0,3,0,0,0,0,241,182,0,9
376,D,111,H CON RES 288,22-Jun-2010,6:33 PM,On Motion to Suspend the Rules and Agree,Supporting National Men’s Health Week,Passed,154,0,0,24,234,0,0,20,0,0,0,0,388,0,0,44
377,D,111,H RES 546,22-Jun-2010,6:41 PM,On Motion to Suspend the Rules and Agree,"Recognizing the historical significance of Juneteenth Independence Day, and expressing the sense of the House of Representatives that history should be regarded as a means for understanding the past and more effectively facing the challenges of the future",Passed,156,0,0,22,234,0,0,20,0,0,0,0,390,0,0,42
378,D,111,H RES 1407,22-Jun-2010,6:50 PM,On Motion to Suspend the Rules and Agree,Supporting the goals and ideals of High-Performance Building Week,Passed,136,20,0,22,235,0,0,19,0,0,0,0,371,20,0,41
379,D,111,H R 5551,23-Jun-2010,12:17 PM,"On Motion to Suspend the Rules and Pass, as Amended",To require the Secretary of the Treasury to make a certification when making purchases under the Small Business Lending Fund Program,Passed,164,0,0,14,247,0,0,7,0,0,0,0,411,0,0,21
380,D,111,H RES 1434,23-Jun-2010,12:27 PM,On Motion to Suspend the Rules and Agree,Recognizing National Homeownership Month and the importance of homeownership in the United States,Passed,159,6,0,13,246,0,0,8,0,0,0,0,405,6,0,21
381,D,111,H RES 1369,23-Jun-2010,12:34 PM,On Motion to Suspend the Rules and Agree,Recognizing the significance of National Caribbean-American Heritage Month,Passed,163,0,0,15,247,0,0,7,0,0,0,0,410,0,0,22
382,D,111,H R 5481,23-Jun-2010,4:48 PM,"On Motion to Suspend the Rules and Pass, as Amended",To give subpoena power to the National Commission on the BP Deepwater Horizon Oil Spill and Offshore Drilling,Passed,169,1,2,6,251,0,0,3,0,0,0,0,420,1,2,9
383,D,111,H R 3993,23-Jun-2010,4:59 PM,"On Motion to Suspend the Rules and Pass, as Amended",Calling Card Consumer Protection Act,Passed,133,41,0,4,248,0,0,6,0,0,0,0,381,41,0,10
384,D,111,H RES 1388,23-Jun-2010,5:08 PM,On Motion to Suspend the Rules and Agree,Supporting the goals and ideals of National Hurricane Preparedness Week,Passed,172,0,0,6,247,0,0,7,0,0,0,0,419,0,0,13
385,D,111,H RES 1468,24-Jun-2010,12:14 PM,On Ordering the Previous Question,"Providing for consideration of H.R. 5175, the Democracy is Strengthened by Casting Light on Spending in Elections Act, and for other purposes",Passed,0,173,0,5,243,8,0,3,0,0,0,0,243,181,0,8
386,D,111,H RES 1468,24-Jun-2010,12:23 PM,On Agreeing to the Resolution,"Providing for consideration of H.R. 5175, the Democracy is Strengthened by Casting Light on Spending in Elections Act, and for other purposes",Passed,0,171,0,7,220,34,0,1,0,0,0,0,220,205,0,8
387,D,111,H CON RES 285,24-Jun-2010,12:31 PM,On Motion to Suspend the Rules and Agree,Recognizing the important role that fathers play in the lives of their children and families and supporting the goals and ideals of designating 2010 as the Year of the Father,Passed,173,0,0,5,250,0,0,4,0,0,0,0,423,0,0,9
388,D,111,H R 5175,24-Jun-2010,3:30 PM,On Agreeing to the Amendment,None,Failed,57,114,0,7,0,255,0,5,0,0,0,0,57,369,0,12
389,D,111,H R 5175,24-Jun-2010,3:40 PM,On Agreeing to the Amendment,None,Agreed to,31,140,0,7,243,12,0,5,0,0,0,0,274,152,0,12
390,D,111,H R 5175,24-Jun-2010,4:17 PM,On Motion to Recommit with Instructions,Democracy is Strengthened by Casting Light on Spending in Elections Act or the DISCLOSE Act,Failed,171,1,0,6,37,216,0,2,0,0,0,0,208,217,0,8
391,D,111,H R 5175,24-Jun-2010,4:29 PM,On Passage,Democracy is Strengthened by Casting Light on Spending in Elections Act or the DISCLOSE Act,Passed,2,170,0,6,217,36,0,2,0,0,0,0,219,206,0,8
392,D,111,H RES 1464,24-Jun-2010,4:38 PM,On Motion to Suspend the Rules and Agree,"Recognizing the 50th anniversary of the conclusion of the United States-Japan Treaty of Mutual Cooperation and Security and expressing appreciation to the Government of Japan and the Japanese people for enhancing peace, prosperity, and security in the Asia-Pacific region",Passed,165,1,0,12,247,1,0,6,0,0,0,0,412,2,0,18
393,D,111,H R 3962,24-Jun-2010,7:09 PM,On Motion to Suspend the Rules and Concur in the Senate Amendments,"To provide affordable, quality health care for all Americans and reduce the growth in health care spending, and for other purposes",Passed,170,0,0,8,247,1,0,6,0,0,0,0,417,1,0,14
394,D,111,H R 2194,24-Jun-2010,7:16 PM,On Motion to Suspend the Rules and Agree to the Conference Report,"Comprehensive Iran Sanctions, Accountability, and Divestment Act",Passed,167,2,0,9,241,6,1,7,0,0,0,0,408,8,1,16
395,D,111,JOURNAL,29-Jun-2010,11:00 AM,On Approving the Journal,None,Passed,13,149,1,15,206,26,0,22,0,0,0,0,219,175,1,37
396,D,111,H RES 1439,29-Jun-2010,11:10 AM,On Motion to Suspend the Rules and Agree,Congratulating the Chicago Blackhawks on winning the 2010 Stanley Cup Championship,Passed,163,1,1,13,232,4,0,18,0,0,0,0,395,5,1,31
397,D,111,ADJOURN,29-Jun-2010,11:28 AM,On Motion to Adjourn,None,Failed,20,147,0,11,3,232,0,19,0,0,0,0,23,379,0,30
398,D,111,H R 5618,29-Jun-2010,3:15 PM,On Motion to Suspend the Rules and Pass,Restoration of Emergency Unemployment Compensation Act,Failed,30,139,0,9,231,16,0,8,0,0,0,0,261,155,0,17
399,D,111,H RES 1244,29-Jun-2010,3:24 PM,"On Motion to Suspend the Rules and Agree, as Amended",Recognizing the National Collegiate Cyber Defense Competition for its now five-year effort to promote cyber security curriculum in institutions of higher learning,Passed,169,2,0,7,243,0,0,11,0,0,0,0,412,2,0,18
400,D,111,H R 5552,29-Jun-2010,3:38 PM,"On Motion to Suspend the Rules and Pass, as Amended",Firearms Excise Tax Improvement Act,Passed,170,1,0,7,242,5,0,7,0,0,0,0,412,6,0,14
401,D,111,H R 5623,29-Jun-2010,3:45 PM,"On Motion to Suspend the Rules and Pass, as Amended",Homebuyer Assistance and Improvement Act,Passed,165,5,0,8,244,0,0,10,0,0,0,0,409,5,0,18
402,D,111,H CON RES 284,30-Jun-2010,11:11 AM,"On Motion to Suspend the Rules and Agree, as Amended",Recognizing the work and importance of special education teachers,Passed,171,0,0,7,244,0,0,10,0,0,0,0,415,0,0,17
403,D,111,H R 5395,30-Jun-2010,11:18 AM,On Motion to Suspend the Rules and Pass,"To designate the facility of the United States Postal Service located at 151 North Maitland Avenue in Maitland, Florida, as the “Paula Hawkins Post Office Building”",Passed,170,0,0,8,239,0,0,15,0,0,0,0,409,0,0,23
404,D,111,H RES 1446,30-Jun-2010,11:27 AM,On Motion to Suspend the Rules and Agree,"Recognizing the residents of the City of Tracy, California, on the occasion of the 100th anniversary of the city’s incorporation, for their century of dedicated service to the United States",Passed,171,0,0,7,248,0,0,6,0,0,0,0,419,0,0,13
405,D,111,H R 4307,30-Jun-2010,11:34 AM,On Motion to Suspend the Rules and Pass,"To name the Department of Veterans Affairs community-based outpatient clinic in Artesia, New Mexico, as the “Alejandro Renteria Ruiz Department of Veterans Affairs Clinic”",Passed,171,0,0,7,246,0,0,8,0,0,0,0,417,0,0,15
406,D,111,H RES 1487,30-Jun-2010,1:15 PM,On Ordering the Previous Question,"Waiving a requirement of clause 6(a) of rule XIII with respect to consideration of certain resolutions reported from the Committee on Rules, and for other purposes",Passed,1,173,0,4,242,9,0,3,0,0,0,0,243,182,0,7
407,D,111,H RES 1487,30-Jun-2010,1:23 PM,On Agreeing to the Resolution,"Waiving a requirement of clause 6(a) of rule XIII with respect to consideration of certain resolutions reported from the Committee on Rules, and for other purposes",Passed,0,175,0,3,237,14,0,3,0,0,0,0,237,189,0,6
408,D,111,H R 4505,30-Jun-2010,1:36 PM,On Motion to Suspend the Rules and Pass,To enable State homes to furnish nursing home care to parents any of whose children died while serving in the Armed Forces,Passed,171,0,0,7,249,0,0,5,0,0,0,0,420,0,0,12
409,D,111,H CON RES 293,30-Jun-2010,3:15 PM,On Agreeing to the Resolution,Providing for an adjournment or recess of the two Houses,Passed,9,159,0,10,213,27,0,14,0,0,0,0,222,186,0,24
410,D,111,H RES 1490,30-Jun-2010,3:23 PM,On Agreeing to the Resolution,"Rule providing for the consideration of the conference report to accompany H.R. 4173, the Dodd-Frank Wall Street Reform and Consumer Protection Act",Passed,0,175,0,3,234,14,0,6,0,0,0,0,234,189,0,9
411,D,111,H R 1554,30-Jun-2010,3:33 PM,"On Motion to Suspend the Rules and Pass, as Amended",Fountainhead Property Land Transfer Act,Passed,175,0,0,3,246,1,0,7,0,0,0,0,421,1,0,10
412,D,111,H R 4173,30-Jun-2010,6:46 PM,On Motion to Recommit the Conference Report with Instructions,Wall Street Reform and Consumer Protection Act of 2009,Failed,175,0,0,3,23,229,0,2,0,0,0,0,198,229,0,5
413,D,111,H R 4173,30-Jun-2010,6:54 PM,On Agreeing to the Conference Report,Wall Street Reform and Consumer Protection Act of 2009,Passed,3,173,0,2,234,19,0,2,0,0,0,0,237,192,0,4
414,D,111,H R 4445,30-Jun-2010,7:03 PM,"On Motion to Suspend the Rules and Pass, as Amended",Indian Pueblo Cultural Center Clarification Act,Passed,169,0,0,9,242,0,0,12,0,0,0,0,411,0,0,21
415,D,111,H RES 1228,1-Jul-2010,10:56 AM,"On Motion to Suspend the Rules and Agree, as Amended",Honoring the veterans of Helicopter Attack Light Squadron Three and their families,Passed,172,0,0,6,238,0,0,16,0,0,0,0,410,0,0,22
416,D,111,H R 2340,1-Jul-2010,11:03 AM,"On Motion to Suspend the Rules and Pass, as Amended",Salmon Lake Land Selection Resolution Act,Passed,173,0,0,5,237,0,0,17,0,0,0,0,410,0,0,22
417,D,111,H RES 1460,1-Jul-2010,11:15 AM,On Motion to Suspend the Rules and Agree,Recognizing the important role pollinators play in supporting the ecosystem and supporting the goals and ideals of National Pollinator Week,Passed,171,0,1,6,241,0,0,13,0,0,0,0,412,0,1,19
418,D,111,H RES 1495,1-Jul-2010,12:53 PM,On Agreeing to the Resolution,"Providing for consideration of the bill (H.R. 5618) to continue Federal unemployment programs, and waiving a requirement of clause 6(a) of rule XIII with respect to consideration of certain resolutions reported from the Committee on Rules",Passed,0,175,0,3,231,14,0,9,0,0,0,0,231,189,0,12
419,D,111,H RES 1321,1-Jul-2010,1:02 PM,"On Motion to Suspend the Rules and Agree, As Amended",Expressing the sense of the House of Representatives that the political situation in Thailand be solved peacefully and through democratic means.,Passed,172,3,0,3,239,1,0,14,0,0,0,0,411,4,0,17
420,D,111,H RES 1405,1-Jul-2010,1:09 PM,"On Motion to Suspend the Rules and Agree, As Amended",Congratulating the people of the 17 African nations that in 2010 are marking the 50th year of their national independence.,Passed,174,0,0,4,236,0,0,18,0,0,0,0,410,0,0,22
421,D,111,H RES 1412,1-Jul-2010,2:34 PM,"On Motion to Suspend the Rules and Agree, As Amended",Congratulating the Government of South Africa upon its first two successful convictions for human trafficking,Passed,168,1,0,9,246,0,0,8,0,0,0,0,414,1,0,17
422,D,111,H R 5618,1-Jul-2010,3:03 PM,On Motion to Table the Appeal of the Ruling of the Chair,Restoration of Emergency Unemployment Compensation Act,Passed,0,169,0,9,220,27,0,7,0,0,0,0,220,196,0,16
423,D,111,H R 5618,1-Jul-2010,3:27 PM,On Passage,Restoration of Emergency Unemployment Compensation Act,Passed,29,142,0,7,241,11,0,3,0,0,0,0,270,153,0,10
424,D,111,QUORUM,1-Jul-2010,5:21 PM,Call of the House,None,Passed,0,0,169,9,0,0,247,7,0,0,0,0,0,0,416,16
425,D,111,H R 5609,1-Jul-2010,5:28 PM,"On Motion to Suspend the Rules and Pass, as Amended",To amend the Federal Election Campaign Act of 1971 to prohibit any registered lobbyist whose clients include foreign governments which are found to be sponsors of international terrorism or include other foreign nationals from making contributions and other campaign-related disbursements in elections for public office,Passed,167,1,0,10,241,3,0,10,0,0,0,0,408,4,0,20
426,D,111,H CON RES 290,1-Jul-2010,5:38 PM,On Motion to Suspend the Rules and Agree,Expressing support for designation of June 30 as “National ESIGN Day”,Passed,155,15,0,8,242,0,0,12,0,0,0,0,397,15,0,20
427,D,111,QUORUM,1-Jul-2010,7:37 PM,Call of the House,None,Passed,0,0,170,8,0,0,249,6,0,0,0,0,0,0,419,14
428,D,111,H RES 1500,1-Jul-2010,8:02 PM,On Agreeing to the Resolution,"Providing for consideration of the Senate amendments to the bill (H.R. 4899) making emergency supplemental appropriations for disaster relief and summer jobs for the fiscal year ending September 30, 2010",Passed,0,172,0,6,215,38,0,2,0,0,0,0,215,210,0,8
429,D,111,H RES 1462,1-Jul-2010,8:13 PM,"On Motion to Suspend the Rules and Agree, as Amended","Expressing support for the people of Guatemala, Honduras, and El Salvador as they persevere through the aftermath of Tropical Storm Agatha which swept across Central America causing deadly floods and mudslides",Passed,165,1,0,12,238,0,0,16,0,0,0,0,403,1,0,28
430,D,111,H R 4899,1-Jul-2010,10:34 PM,Second Portion of the Divided Question [Amendment 2],"Making emergency supplemental appropriations for disaster relief and summer jobs for fiscal year ending September 30, 2010, and for other purposes",Passed,3,167,1,7,236,15,0,4,0,0,0,0,239,182,1,11
431,D,111,H R 4899,1-Jul-2010,10:41 PM,Third Portion of the Divided Question [Amendment 3],"Making emergency supplemental appropriations for disaster relief and summer jobs for fiscal year ending September 30, 2010, and for other purposes",Failed,3,168,0,7,22,208,22,3,0,0,0,0,25,376,22,10
432,D,111,H R 4899,1-Jul-2010,10:47 PM,Fourth Portion of the Divided Question [Amendment 4],"Making emergency supplemental appropriations for disaster relief and summer jobs for fiscal year ending September 30, 2010, and for other purposes",Failed,7,164,0,7,93,157,0,4,0,0,0,0,100,321,0,11
433,D,111,H R 4899,1-Jul-2010,10:54 PM,Fifth Portion of the Divided Question [Amendment 5],"Making emergency supplemental appropriations for disaster relief and summer jobs for fiscal year ending September 30, 2010, and for other purposes",Failed,9,162,0,7,153,98,0,4,0,0,0,0,162,260,0,11
434,D,111,H R 4514,13-Jul-2010,6:30 PM,"On Motion to Suspend the Rules and Pass, as Amended",Colonel Charles Young Home Study Act,Passed,125,26,0,27,225,0,0,29,0,0,0,0,350,26,0,56
435,D,111,H R 4438,13-Jul-2010,6:38 PM,"On Motion to Suspend the Rules and Pass, as Amended",San Antonio Missions National Historical Park Boundary Expansion Act of 2010,Passed,39,113,0,26,225,1,0,28,0,0,0,0,264,114,0,54
436,D,111,H R 4773,13-Jul-2010,6:46 PM,On Motion to Suspend the Rules and Pass,Fort Pulaski National Monument Lease Authorization Act,Passed,151,0,0,27,228,0,0,26,0,0,0,0,379,0,0,53
437,D,111,H RES 1509,14-Jul-2010,1:29 PM,On Ordering the Previous Question,"Providing for consideration of the bill (H.R. 1722) to improve teleworking in executive agencies by developing a telework program that allows employees to telework at least 20 percent of the hours worked in every 2 administrative workweeks, and for other purposes",Passed,0,173,0,5,232,11,0,11,0,0,0,0,232,184,0,16
438,D,111,H RES 1509,14-Jul-2010,1:38 PM,On Agreeing to the Resolution,"Providing for consideration of the bill (H.R. 1722) to improve teleworking in executive agencies by developing a telework program that allows employees to telework at least 20 percent of the hours worked in every 2 administrative workweeks, and for other purposes",Passed,1,171,0,6,237,9,0,8,0,0,0,0,238,180,0,14
439,D,111,H R 2864,14-Jul-2010,1:46 PM,"On Motion to Suspend the Rules and Pass, as Amended","To amend the Hydrographic Services Improvement Act of 1998 to authorize funds to acquire hydrographic data and provide hydrographic services specific to the Arctic for safe navigation, delineating the United States extended continental shelf, and the monitoring and description of costal changes",Passed,173,0,0,5,247,0,0,7,0,0,0,0,420,0,0,12
440,D,111,H R 1722,14-Jul-2010,3:37 PM,On Motion to Recommit with Instructions,Telework Improvements Act,Passed,174,0,0,4,129,119,0,6,0,0,0,0,303,119,0,10
441,D,111,H R 1722,14-Jul-2010,3:45 PM,On Passage,Telework Improvements Act,Passed,45,129,0,4,245,2,0,7,0,0,0,0,290,131,0,11
442,D,111,S 1508,14-Jul-2010,3:53 PM,On Motion to Suspend the Rules and Pass,Improper Payments Elimination and Recovery Act,Passed,170,0,0,8,244,0,0,10,0,0,0,0,414,0,0,18
443,D,111,H RES 1517,15-Jul-2010,11:26 AM,On Agreeing to the Resolution,"Providing for consideration of H.R. 5114, Flood Insurance Reform Priorities Act",Passed,1,174,0,3,238,8,0,8,0,0,0,0,239,182,0,11
444,D,111,H R 5114,15-Jul-2010,1:44 PM,On Agreeing to the Amendment,None,Agreed to,171,2,0,5,252,1,0,7,0,0,0,0,423,3,0,12
445,D,111,H R 5114,15-Jul-2010,1:53 PM,On Agreeing to the Amendment,None,Agreed to,172,0,0,6,249,0,0,11,0,0,0,0,421,0,0,17
446,D,111,H R 5114,15-Jul-2010,2:26 PM,On Motion to Recommit with Instructions,Flood Insurance Reform Priorities Act,Failed,172,2,0,4,19,227,0,8,0,0,0,0,191,229,0,12
447,D,111,H R 5114,15-Jul-2010,2:35 PM,On Passage,Flood Insurance Reform Priorities Act,Passed,85,89,0,4,244,1,0,9,0,0,0,0,329,90,0,13
448,D,111,H RES 1472,19-Jul-2010,6:34 PM,On Motion to Suspend the Rules and Agree,"Expressing support for designation of the week of September 13, 2010, as National Adult Education and Family Literacy Week",Passed,144,0,0,34,225,0,0,29,0,0,0,0,369,0,0,63
449,D,111,H CON RES 126,19-Jul-2010,6:41 PM,"On Motion to Suspend the Rules and Agree, as Amended",Recognizing the 50th anniversary of Title VI international education programs within the Department of Education,Passed,131,16,0,31,224,0,0,30,0,0,0,0,355,16,0,61
450,D,111,H RES 1219,19-Jul-2010,6:47 PM,On Motion to Suspend the Rules and Agree,Expressing support for designation of September as National Child Awareness Month,Passed,151,0,0,27,222,0,0,32,0,0,0,0,373,0,0,59
451,D,111,H RES 1491,20-Jul-2010,6:04 PM,On Motion to Suspend the Rules and Agree,Congratulating the University of South Carolina Gamecocks on winning the 2010 NCAA Division I College World Series,Passed,164,4,0,10,236,2,2,14,0,0,0,0,400,6,2,24
452,D,111,H R 5604,20-Jul-2010,6:13 PM,On Motion to Suspend the Rules and Pass,Surface Transportation Savings Act of 2010,Passed,163,0,0,15,239,0,0,15,0,0,0,0,402,0,0,30
453,D,111,H RES 1516,20-Jul-2010,6:21 PM,On Motion to Suspend the Rules and Agree,"Recognizing the 65th anniversary of the end of World War II, honoring the service members who fought in World War II and their families, and honoring the service members who are currently serving in combat operations",Passed,167,0,0,11,241,0,0,13,0,0,0,0,408,0,0,24
454,D,111,H CON RES 292,21-Jul-2010,1:55 PM,On Motion to Suspend the Rules and Agree,"Supporting the goals and ideals of National Aerospace Week, and for other purposes",Passed,171,0,0,7,242,0,0,12,0,0,0,0,413,0,0,19
455,D,111,H R 725,21-Jul-2010,2:05 PM,On Motion to Suspend the Rules and Concur in the Senate Amendment,"To protect Indian arts and crafts through the improvement of applicable criminal proceedings, and for other purposes",Passed,78,92,0,8,248,0,0,6,0,0,0,0,326,92,0,14
456,D,111,H R 4380,21-Jul-2010,2:16 PM,"On Motion to Suspend the Rules and Pass, as Amended",United States Manufacturing Enhancement Act of 2010,Passed,129,42,0,7,249,1,0,4,0,0,0,0,378,43,0,11
457,D,111,H RES 1513,21-Jul-2010,2:25 PM,"On Motion to Suspend the Rules and Agree, as Amended",Congratulating the Saratoga Race Course as it celebrates its 142nd season,Passed,156,11,0,11,240,3,2,9,0,0,0,0,396,14,2,20
458,D,111,H RES 1537,21-Jul-2010,4:02 PM,On Agreeing to the Resolution,Waiving a requirement of clause 6(a) of rule XIII with respect to consideration of certain resolutions reported from the Committee on Rules and providing for consideration of motions to suspend the rules,Passed,0,170,0,8,233,15,0,6,0,0,0,0,233,185,0,14
459,D,111,H R 5566,21-Jul-2010,4:12 PM,"On Motion to Suspend the Rules and Pass, as Amended",Prevention of Interstate Commerce in Animal Crush Videos Act of 2010,Passed,167,3,0,8,249,0,0,5,0,0,0,0,416,3,0,13
460,D,111,H RES 1411,21-Jul-2010,4:21 PM,"On Motion to Suspend the Rules and Agree, As Amended","Honoring the service and commitment of the 111th Fighter Wing, Pennsylvania Air National Guard",Passed,168,0,0,10,249,0,0,5,0,0,0,0,417,0,0,15
461,D,111,H RES 1550,22-Jul-2010,12:00 PM,On Agreeing to the Resolution,"Providing for consideration of the Senate amendment to the House amendment to the Senate amendment to H.R. 4213, Unemployment Compensation Extension Act of 2010",Passed,1,170,0,7,236,10,0,8,0,0,0,0,237,180,0,15
462,D,111,H R 1469,22-Jul-2010,12:12 PM,"On Motion to Suspend the Rules and Pass, as Amended",Child Protection Improvements Act of 2010,Passed,167,4,0,7,246,0,0,8,0,0,0,0,413,4,0,15
463,D,111,H R 4213,22-Jul-2010,2:13 PM,On Motion to Concur in the Senate amdt to the House amdt to the Senate amdt,Unemployment Compensation Extension Act of 2010,Passed,31,142,0,5,241,10,0,4,0,0,0,0,272,152,0,9
464,D,111,H R 5341,22-Jul-2010,2:22 PM,On Motion to Suspend the Rules and Pass,"To designate the facility of the United States Postal Service located at 100 Orndorf Drive in Brighton, Michigan, as the “Joyce Rogers Post Office Building”",Passed,165,0,0,13,246,0,0,8,0,0,0,0,411,0,0,21
465,D,111,H RES 1549,22-Jul-2010,3:50 PM,On Ordering the Previous Question,"Providing for consideration of H.R. 1264, Multiple Peril Insurance Act of 2009",Passed,0,168,0,10,234,11,0,9,0,0,0,0,234,179,0,19
466,D,111,H RES 1549,22-Jul-2010,4:11 PM,On Agreeing to the Resolution,"Providing for consideration of H.R. 1264, Multiple Peril Insurance Act of 2009",Passed,1,166,0,11,227,17,0,10,0,0,0,0,228,183,0,21
467,D,111,H R 1320,26-Jul-2010,6:33 PM,"On Motion to Suspend the Rules and Pass, as Amended","To amend the Federal Advisory Committee Act to increase the transparency and accountability of Federal advisory committees, and for other purposes",Passed,27,124,0,27,223,0,0,31,0,0,0,0,250,124,0,58
468,D,111,H RES 1504,26-Jul-2010,6:42 PM,"On Motion to Suspend the Rules and Agree, as Amended",Recognizing and honoring the 20th anniversary of the enactment of the Americans with Disabilities Act of 1990,Passed,153,0,0,25,224,0,0,30,0,0,0,0,377,0,0,55
469,D,111,H R 3101,26-Jul-2010,7:11 PM,"On Motion to Suspend the Rules and Pass, as Amended",Twenty-First Century Communications and Video Accessibility Act,Passed,128,23,0,27,220,0,0,34,0,0,0,0,348,23,0,61
470,D,111,H RES 1556,27-Jul-2010,4:04 PM,On Agreeing to the Resolution,"Providing for consideration of the concurrent resolution (H.Con.Res. 301) directing the President, pursuant to section 5(c) of the War Powers Resolution, to remove the United States Armed Forces from Pakistan",Passed,5,165,0,8,217,31,0,6,0,0,0,0,222,196,0,14
471,D,111,H R 5730,27-Jul-2010,4:11 PM,On Motion to Suspend the Rules and Pass,"Surface Transportation Earmark Rescission, Savings, and Accountability Act",Passed,163,6,0,9,231,17,0,6,0,0,0,0,394,23,0,15
472,D,111,H RES 1366,27-Jul-2010,4:19 PM,"On Motion to Suspend the Rules and Agree, as Amended",Recognizing and honoring the freight rail industry,Passed,169,0,0,9,242,0,2,10,0,0,0,0,411,0,2,19
473,D,111,H CON RES 301,27-Jul-2010,6:00 PM,On Agreeing to the Resolution,"Directing the President, pursuant to section 5(c) of the War Powers Resolution, to remove the United States Armed Forces from Pakistan",Failed,6,163,1,8,32,209,3,10,0,0,0,0,38,372,4,18
474,D,111,H R 4899,27-Jul-2010,6:11 PM,"On Motion to Suspend the Rules, Recede from the House Amdt, and Concur in the Senate Amdt","Making emergency supplemental appropriations for disaster relief and summer jobs for the fiscal year ending September 30, 2010, and for other purposes",Passed,160,12,0,6,148,102,0,4,0,0,0,0,308,114,0,10
475,D,111,H R 4748,27-Jul-2010,6:19 PM,"On Motion to Suspend the Rules and Pass, as Amended",Northern Border Counternarcotics Strategy Act of 2010,Passed,165,0,0,13,248,0,0,6,0,0,0,0,413,0,0,19
476,D,111,H RES 1559,28-Jul-2010,3:50 PM,On Agreeing to the Resolution,"Providing for consideration of H.R. 5822, making appropriations for military construction, the Department of Veterans Affairs, and related agencies for the fiscal year ending September 30, 2011, and for other purposes and providing for consideration of motions to suspend the rules",Passed,0,171,0,7,243,7,0,4,0,0,0,0,243,178,0,11
477,D,111,H R 4692,28-Jul-2010,4:00 PM,"On Motion to Suspend the Rules and Pass, as Amended",National Manufacturing Strategy Act,Passed,132,38,0,8,247,0,0,7,0,0,0,0,379,38,0,15
478,D,111,H RES 1543,28-Jul-2010,4:08 PM,On Motion to Suspend the Rules and Agree,"Honoring the educational significance of Dr. Jane Goodall’s work on this the 50th anniversary of the beginning of her work in Tanzania, Africa",Passed,170,0,0,8,246,0,0,8,0,0,0,0,416,0,0,16
479,D,111,H R 5827,28-Jul-2010,4:17 PM,"On Motion to Suspend the Rules and Pass, as Amended",To amend title 11 of the United States Code to include firearms in the types of property allowable under the alternative provision for exempting property from the estate,Passed,168,1,0,9,139,112,0,3,0,0,0,0,307,113,0,12
480,D,111,H R 5822,28-Jul-2010,7:11 PM,On Agreeing to the Amendment,None,Agreed to,171,0,0,7,182,69,0,9,0,0,0,0,353,69,0,16
481,D,111,H R 5822,28-Jul-2010,7:19 PM,On Agreeing to the Amendment,None,Failed,108,62,0,8,20,234,0,6,0,0,0,0,128,296,0,14
482,D,111,H R 5822,28-Jul-2010,7:37 PM,On Passage,"Making appropriations for military construction, the Department of Veterans Affairs, and related agencies for the fiscal year ending September 30, 2011, and for other purposes",Passed,164,6,0,8,247,0,0,7,0,0,0,0,411,6,0,15
483,D,111,H CON RES 308,29-Jul-2010,1:23 PM,On Agreeing to the Resolution,Providing for an adjournment of the House,Passed,13,157,0,8,218,32,0,4,0,0,0,0,231,189,0,12
484,D,111,H RES 1569,29-Jul-2010,1:32 PM,On Ordering the Previous Question,"Providing for consideration of the bill (H.R. 5850) making appropriations for the Departments of Transportation, and Housing and Urban Development, and related agencies for the fiscal year ending September 30, 2011, and for other purposes",Passed,0,167,0,11,236,12,0,6,0,0,0,0,236,179,0,17
485,D,111,H RES 1569,29-Jul-2010,1:39 PM,On Agreeing to the Resolution,"Providing for consideration of the bill (H.R. 5850) making appropriations for the Departments of Transportation, and Housing and Urban Development, and related agencies for the fiscal year ending September 30, 2011, and for other purposes",Passed,0,168,0,10,231,17,0,6,0,0,0,0,231,185,0,16
486,D,111,H RES 1568,29-Jul-2010,1:47 PM,On Agreeing to the Resolution,"Providing for consideration of the bill (H.R. 5893) to amend the Internal Revenue Code of 1986 to create jobs through increased investment in infrastructure, to eliminate loopholes which encourage companies to move operations offshore, and for other purposes",Passed,0,169,0,9,233,13,0,8,0,0,0,0,233,182,0,17
487,D,111,H R 3040,29-Jul-2010,1:54 PM,"On Motion to Suspend the Rules and Pass, as Amended",Senior Financial Empowerment Act of 2010,Passed,89,79,0,10,246,2,0,6,0,0,0,0,335,81,0,16
488,D,111,H R 5850,29-Jul-2010,6:08 PM,On Agreeing to the Amendment,None,Failed,165,3,0,10,41,214,0,5,0,0,0,0,206,217,0,15
489,D,111,H R 5850,29-Jul-2010,6:17 PM,On Agreeing to the Amendment,None,Failed,167,1,0,10,30,224,0,6,0,0,0,0,197,225,0,16
490,D,111,H R 5850,29-Jul-2010,6:26 PM,On Agreeing to the Amendment,None,Failed,156,12,0,10,13,240,0,7,0,0,0,0,169,252,0,17
491,D,111,H R 847,29-Jul-2010,9:46 PM,"On Motion to Suspend the Rules and Pass, as Amended",James Zadroga 9/11 Health and Compensation Act,Failed,12,155,0,11,243,4,0,7,0,0,0,0,255,159,0,18
492,D,111,H R 5850,29-Jul-2010,10:04 PM,On Agreeing to the Amendment,None,Failed,165,3,0,10,12,244,0,4,0,0,0,0,177,247,0,14
493,D,111,H R 5850,29-Jul-2010,10:11 PM,On Agreeing to the Amendment,None,Failed,152,15,0,11,7,250,0,3,0,0,0,0,159,265,0,14
494,D,111,H R 5850,29-Jul-2010,10:17 PM,On Agreeing to the Amendment,None,Failed,123,43,0,12,6,250,0,4,0,0,0,0,129,293,0,16
495,D,111,H R 5850,29-Jul-2010,10:24 PM,On Agreeing to the Amendment,None,Failed,151,17,0,10,12,243,0,5,0,0,0,0,163,260,0,15
496,D,111,H R 5850,29-Jul-2010,10:30 PM,On Agreeing to the Amendment,None,Failed,148,20,0,10,9,247,0,4,0,0,0,0,157,267,0,14
497,D,111,H R 5850,29-Jul-2010,10:37 PM,On Agreeing to the Amendment,None,Failed,151,16,0,11,14,242,0,4,0,0,0,0,165,258,0,15
498,D,111,H R 5850,29-Jul-2010,10:43 PM,On Agreeing to the Amendment,None,Failed,146,21,0,11,13,243,0,4,0,0,0,0,159,264,0,15
499,D,111,H R 5850,29-Jul-2010,11:01 PM,On Passage,"Making appropriations for the Departments of Transportation, and Housing and Urban Development, and related agencies for the fiscal year ending September 30, 2011, and for other purposes",Passed,14,154,0,10,237,13,0,4,0,0,0,0,251,167,0,14
500,D,111,H RES 1574,30-Jul-2010,11:51 AM,On Agreeing to the Resolution,"Providing for consideration of (H.R. 3534) the Consolidated Land, Energy, and Aquatic Resources Act and providing for consideration of (H.R. 5851) the Offshore Oil and Gas Worker Whistleblower Protection Act",Passed,0,165,0,13,220,29,0,5,0,0,0,0,220,194,0,18
501,D,111,H RES 1558,30-Jul-2010,11:59 AM,On Motion to Suspend the Rules and Agree,"Expessing the sense of the House of Representatives that fruit and vegatable and commodity producers are encouraged to display the American flag on labels of products grown in the United States, reminding us all to take pride in the healthy bounty produced by American farmers and workers",Passed,162,1,0,15,241,0,0,13,0,0,0,0,403,1,0,28
502,D,111,H R 5901,30-Jul-2010,12:09 PM,On Motion to Suspend the Rules and Pass,Real Estate Jobs and Investment Act of 2010,Passed,155,10,0,13,247,1,0,6,0,0,0,0,402,11,0,19
503,D,111,H RES 1566,30-Jul-2010,12:16 PM,On Motion to Suspend the Rules and Agree,Recognizing the 50th anniversary of the Student Nonviolent Coordinating Committee (SNCC) and the pioneering of college students whose determination and nonviolent resistance led to the desegregation of lunch counters and places of public accommodation over a 5-year period,Passed,161,0,0,17,249,0,0,5,0,0,0,0,410,0,0,22
504,D,111,H R 5414,30-Jul-2010,12:23 PM,"On Motion to Suspend the Rules and Pass, as Amended","To provide for the conveyance of a small parcel of National Forest System land in the Frances Marion National Forest in South Carolina, and for other purposes",Passed,162,0,0,16,246,0,0,8,0,0,0,0,408,0,0,24
505,D,111,H R 5851,30-Jul-2010,5:04 PM,On Motion to Recommit with Instructions,Offshore Oil and Gas Worker Whistleblower Protection Act of 2010,Failed,161,0,0,17,10,234,0,10,0,0,0,0,171,234,0,27
506,D,111,H R 5851,30-Jul-2010,5:12 PM,On Passage,Offshore Oil and Gas Worker Whistleblower Protection Act of 2010,Passed,68,92,0,18,247,1,0,7,0,0,0,0,315,93,0,25
507,D,111,H R 3534,30-Jul-2010,5:29 PM,On Agreeing to the Amendment,None,Agreed to,12,148,1,17,238,13,0,9,0,0,0,0,250,161,1,26
508,D,111,H R 3534,30-Jul-2010,5:33 PM,On Agreeing to the Amendment,None,Agreed to,155,1,0,22,249,0,0,11,0,0,0,0,404,1,0,33
509,D,111,H R 3534,30-Jul-2010,5:37 PM,On Agreeing to the Amendment,None,Agreed to,152,5,0,21,247,3,0,10,0,0,0,0,399,8,0,31
510,D,111,H R 3534,30-Jul-2010,5:40 PM,On Agreeing to the Amendment,None,Agreed to,15,144,0,19,243,5,0,12,0,0,0,0,258,149,0,31
511,D,111,H R 3534,30-Jul-2010,5:45 PM,On Agreeing to the Amendment,None,Agreed to,3,156,1,18,213,39,0,9,0,0,0,0,216,195,1,27
512,D,111,H R 3534,30-Jul-2010,6:16 PM,On Motion to Recommit with Instructions,"Consolidated Land, Energy, and Aquatic Resources Act of 2010",Failed,149,11,0,18,17,228,1,8,0,0,0,0,166,239,1,26
513,D,111,H R 3534,30-Jul-2010,6:23 PM,On Passage,"Consolidated Land, Energy, and Aquatic Resources Act of 2010",Passed,2,154,1,21,207,39,0,9,0,0,0,0,209,193,1,30
514,D,111,H R 5982,30-Jul-2010,6:30 PM,On Motion to Suspend the Rules and Pass,"To amend the Internal Revenue Code of 1986 to repeal the expansion of certain information reporting requirements to corporations and to payments for property, to eliminate loopholes which encourage companies to move operations offshore, and for other purposes",Failed,2,153,0,23,239,1,0,14,0,0,0,0,241,154,0,37
515,D,111,MOTION,10-Aug-2010,12:39 PM,Table Appeal of the Ruling of the Chair,None,Passed,1,157,0,20,235,6,0,13,0,0,0,0,236,163,0,33
516,D,111,H RES 1606,10-Aug-2010,1:37 PM,On Ordering the Previous Question,"Providing for consideration of the Senate amendment to the House amendment to the Senate amendment to H.R. 1586, to modernize the air traffic control system, improve the safety, reliability, and availability of transportation by air in the United States, provide for modernization of the air traffic control system, etc.",Passed,0,160,0,18,244,4,0,6,0,0,0,0,244,164,0,24
517,D,111,H RES 1606,10-Aug-2010,1:46 PM,On Agreeing to the Resolution,"Providing for consideration of the Senate amendment to the House amendment to the Senate amendment to H.R. 1586, to modernize the air traffic control system, improve the safety, reliability, and availability of transportation by air in the United States, provide for modernization of the air traffic control system, etc.",Passed,0,157,0,21,229,16,0,9,0,0,0,0,229,173,0,30
518,D,111,H R 1586,10-Aug-2010,3:26 PM,On Motion to Concur in Senate Amendment to House Amendment to Senate Amendment,"To modernize the air traffic control system, improve the safety, reliability, and availability of transportation by air in the United States, provide for modernization of the air traffic control system, reauthorize the Federal Aviation Administration, and for other purposes.",Passed,2,158,0,18,245,3,0,7,0,0,0,0,247,161,0,25
519,D,111,H RES 1052,14-Sep-2010,6:31 PM,On Motion to Suspend the Rules and Agree,"Honoring the members of the Army National Guard and Air National Guard of the State of Oklahoma for their service and sacrifice on behalf of the United States since September 11, 2001",Passed,158,0,0,20,220,0,0,34,0,0,0,0,378,0,0,54
520,D,111,H RES 1571,14-Sep-2010,6:43 PM,"On Motion to Suspend the Rules and Agree, as Amended",Acknowledging and congratulating Miami Dade College on the occasion of its 50th anniversary of service to the students and residents of the State of Florida,Passed,158,0,0,20,220,0,0,34,0,0,0,0,378,0,0,54
521,D,111,H R 2039,15-Sep-2010,2:24 PM,"On Motion to Suspend the Rules and Pass, as Amended",Congressional Made in America Promise Act of 2010,Passed,139,35,0,4,232,1,0,21,0,0,0,0,371,36,0,25
522,D,111,H R 5873,15-Sep-2010,2:34 PM,On Motion to Suspend the Rules and Pass,Captain Rhett W. Schiller Post Office,Passed,174,0,0,4,237,0,0,17,0,0,0,0,411,0,0,21
523,D,111,H RES 1522,15-Sep-2010,2:41 PM,On Motion to Suspend the Rules and Agree,Expressing support for designation of the last week of September as National Hereditary Breast and Ovarian Cancer Week and the last Wednesday of September as National Previvor Day,Passed,173,0,0,5,235,0,0,19,0,0,0,0,408,0,0,24
524,D,111,H R 5366,15-Sep-2010,2:49 PM,On Motion to Suspend the Rules and Pass,Overseas Contractor Reform Act,Passed,173,0,0,5,236,0,0,18,0,0,0,0,409,0,0,23
525,D,111,H RES 1610,15-Sep-2010,2:59 PM,On Motion to Suspend the Rules and Agree,"Expressing the sense of the House of Representatives regarding the terrorist attacks launched against the United States on September 11, 2001",Passed,173,0,0,5,237,0,0,18,0,0,0,0,410,0,0,23
526,D,111,H RES 1620,16-Sep-2010,11:52 AM,On Ordering the Previous Question,"Providing for consideration of H.R. 4785, the Rural Energy Savings Program Act",Passed,0,171,0,7,226,15,0,13,0,0,0,0,226,186,0,20
527,D,111,H RES 1620,16-Sep-2010,12:01 PM,On Agreeing to the Resolution,"Providing for consideration of H.R. 4785, the Rural Energy Savings Program Act",Passed,2,171,0,5,223,17,0,14,0,0,0,0,225,188,0,19
528,D,111,H R 3562,16-Sep-2010,12:12 PM,On Motion to Suspend the Rules and Concur in the Senate Amendments,"To designate the Federal building under construction at 1220 Echelon Parkway in Jackson, Mississippi, as the “Chaney, Goodman, Schwerner Federal Building”",Passed,170,0,0,8,239,0,0,15,0,0,0,0,409,0,0,23
529,D,111,H R 4785,16-Sep-2010,1:49 PM,On Agreeing to the Amendment,None,Agreed to,164,0,0,14,238,0,0,22,0,0,0,0,402,0,0,36
530,D,111,H R 4785,16-Sep-2010,2:20 PM,On Passage,Rural Energy Savings Program Act,Passed,6,167,0,5,234,5,0,15,0,0,0,0,240,172,0,20
531,D,111,H RES 1613,16-Sep-2010,2:30 PM,"On Motion to Suspend the Rules and Agree, as Amended","Expressing condolences to and solidarity with the people of Pakistan in the aftermath of the devastating floods that began on July 22, 2010",Passed,165,2,0,11,231,0,0,23,0,0,0,0,396,2,0,34
532,D,111,H R 5131,22-Sep-2010,6:33 PM,"On Motion to Suspend the Rules and Pass, as Amended",Coltsville National Historical Park Act,Failed,1,168,0,9,214,6,0,34,0,0,0,0,215,174,0,43
533,D,111,H R 3470,22-Sep-2010,6:43 PM,"On Motion to Suspend the Rules and Pass, as Amended",Nationally Enhancing the Wellbeing of Babies through Outreach and Research Now Act,Passed,106,64,0,8,218,0,0,36,0,0,0,0,324,64,0,44
534,D,111,MOTION,23-Sep-2010,12:51 PM,Table the Appeal of the Ruling of the Chair,None,Passed,1,166,0,11,235,6,0,13,0,0,0,0,236,172,0,24
535,D,111,H RES 1640,23-Sep-2010,12:59 PM,On Ordering the Previous Question,Providing for consideration of the Senate amendment to the bill (H.R. 5297) to create the Small Business Lending Fund Program and to amend the Internal Revenue Code of 1986 to provide tax incentives for small business job creation,Passed,0,170,0,8,230,11,0,13,0,0,0,0,230,181,0,21
536,D,111,H RES 1640,23-Sep-2010,1:08 PM,On Agreeing to the Resolution,Providing for consideration of the Senate amendment to the bill (H.R. 5297) to create the Small Business Lending Fund Program and to amend the Internal Revenue Code of 1986 to provide tax incentives for small business job creation,Passed,0,170,0,8,226,16,0,12,0,0,0,0,226,186,0,20
537,D,111,H R 5110,23-Sep-2010,1:15 PM,"On Motion to Suspend the Rules and Pass, as Amended",Casa Grande Ruins National Monument Boundary Modification Act of 2010,Failed,2,172,0,4,242,2,0,10,0,0,0,0,244,174,0,14
538,D,111,H R 4823,23-Sep-2010,1:25 PM,"On Motion to Suspend the Rules and Pass, as Amended",Sedona-Red Rock National Scenic Area Act of 2010,Failed,12,160,0,6,246,0,0,8,0,0,0,0,258,160,0,14
539,D,111,H R 5297,23-Sep-2010,3:03 PM,On Motion to Concur in the Senate Amendment,Small Business Lending Fund Act of 2010,Passed,1,174,0,3,236,13,0,6,0,0,0,0,237,187,0,9
540,D,111,H R 5307,23-Sep-2010,3:11 PM,"On Motion to Suspend the Rules and Pass, as Amended",Ultralight Smuggling Prevention Act,Passed,166,3,0,9,246,0,0,8,0,0,0,0,412,3,0,17
541,D,111,H R 5756,23-Sep-2010,3:20 PM,"On Motion to Suspend the Rules and Pass, as Amended",Training and Research for Autism Improvements Nationwide Act,Passed,147,24,0,7,246,0,0,8,0,0,0,0,393,24,0,15
542,D,111,H R 3199,23-Sep-2010,3:28 PM,"On Motion to Suspend the Rules and Pass, as Amended",Emergency Medic Transition Act of 2010,Passed,165,5,0,8,247,0,0,7,0,0,0,0,412,5,0,15
543,D,111,H R 1745,23-Sep-2010,3:36 PM,"On Motion to Suspend the Rules and Pass, as Amended",Family Health Care Accessibility Act of 2010,Passed,170,1,0,7,247,0,0,7,0,0,0,0,417,1,0,14
544,D,111,H R 5710,23-Sep-2010,3:44 PM,"On Motion to Suspend the Rules and Pass, as Amended",National All Schedules Prescription Electronic Reporting Reauthorization Act of 2010,Passed,140,31,0,7,244,1,0,9,0,0,0,0,384,32,0,16
545,D,111,ADJOURN,29-Sep-2010,12:14 PM,On Motion to Adjourn,None,Failed,1,168,0,9,1,241,1,11,0,0,0,0,2,409,1,20
546,D,111,H CON RES 321,29-Sep-2010,12:47 PM,On Agreeing to the Resolution,Adjournment Resolution,Passed,0,170,0,8,210,39,0,6,0,0,0,0,210,209,0,14
547,D,111,H RES 1674,29-Sep-2010,12:57 PM,On Ordering the Previous Question,"Providing for consideration of H.R. 847, “James Zadroga 9/11 Health and Compensation Act of 2010”, H.R. 2378, “Currency Reform for Fair Trade Act”, and the Senate Amendment to H.R. 2701, “Intelligence Authorization Act for Fiscal Year 2010”",Passed,0,171,0,7,235,12,0,7,0,0,0,0,235,183,0,14
548,D,111,H RES 1674,29-Sep-2010,1:06 PM,On Agreeing to the Resolution,"Providing for consideration of H.R. 847, “James Zadroga 9/11 Health and Compensation Act of 2010”, H.R. 2378, “Currency Reform for Fair Trade Act”, and the Senate Amendment to H.R. 2701, “Intelligence Authorization Act for Fiscal Year 2010”",Passed,1,169,0,8,233,14,0,7,0,0,0,0,234,183,0,15
549,D,111,H R 847,29-Sep-2010,3:29 PM,On Motion to Recommit with Instructions,James Zadroga 9/11 Health and Compensation Act,Failed,171,4,0,3,14,240,0,1,0,0,0,0,185,244,0,4
550,D,111,H R 847,29-Sep-2010,3:37 PM,On Passage,James Zadroga 9/11 Health and Compensation Act,Passed,17,157,0,4,251,3,0,1,0,0,0,0,268,160,0,5
551,D,111,H R 3685,29-Sep-2010,3:46 PM,On Motion to Suspend the Rules and Pass,To require the Secretary of Veterans Affairs to include on the main page of the Internet website of the Department of Veterans Affairs a hyperlink to the VetSuccess Internet website and to publicize such Internet website,Passed,174,0,0,4,251,0,0,3,0,0,0,0,425,0,0,7
552,D,111,H R 5993,29-Sep-2010,3:54 PM,"On Motion to Suspend the Rules and Pass, as Amended",Securing America’s Veterans Insurance Needs and Goals Act of 2010,Passed,109,64,0,5,249,2,0,3,0,0,0,0,358,66,0,8
553,D,111,H RES 1326,29-Sep-2010,4:02 PM,"On Motion to Suspend the Rules and Agree, as Amended",Calling on the Government of Japan to immediately address the growing problem of abduction to and retention of United States citizen minor children in Japan,Passed,169,1,0,8,247,0,0,7,0,0,0,0,416,1,0,15
554,D,111,H R 2378,29-Sep-2010,5:57 PM,On Passage,Currency Reform for Fair Trade Act,Passed,99,74,0,5,249,5,0,1,0,0,0,0,348,79,0,6
555,D,111,H R 6160,29-Sep-2010,6:08 PM,"On Motion to Suspend the Rules and Pass, as Amended",Rare Earths and Critical Materials Revitalization Act,Passed,74,97,0,7,251,1,0,2,0,0,0,0,325,98,0,9
556,D,111,H R 4072,29-Sep-2010,6:18 PM,"On Motion to Suspend the Rules and Pass, as Amended",To require that certain Federal job training and career education programs give priority to programs that provide a national industry-recognized and portable credential,Passed,161,10,0,7,251,0,0,3,0,0,0,0,412,10,0,10
557,D,111,H R 3421,29-Sep-2010,6:26 PM,"On Motion to Suspend the Rules and Pass, as Amended",Medical Debt Relief Act,Passed,87,81,0,10,249,1,0,4,0,0,0,0,336,82,0,14
558,D,111,H R 2701,29-Sep-2010,11:15 PM,On Motion to Concur in the Senate Amendment,Intelligence Authorization Act for Fiscal Year 2010,Passed,1,172,0,5,243,9,0,2,0,0,0,0,244,181,0,7
559,D,111,H RES 1682,29-Sep-2010,11:23 PM,On Ordering the Previous Question,"Providing for consideration of the Senate amendments to the bill (H.R. 3081) making appropriations for the Department of State, foreign operations, and related programs for the fiscal year ending September 30, 2010, and for other purposes",Passed,0,173,0,5,240,13,0,1,0,0,0,0,240,186,0,6
560,D,111,H RES 1682,29-Sep-2010,11:29 PM,On Agreeing to the Resolution,"Providing for consideration of the Senate amendments to the bill (H.R. 3081) making appropriations for the Department of State, foreign operations, and related programs for the fiscal year ending September 30, 2010, and for other purposes",Passed,0,172,0,6,233,19,0,2,0,0,0,0,233,191,0,8
561,D,111,S 3729,29-Sep-2010,11:36 PM,On Motion to Suspend the Rules and Pass,To authorize the programs of the National Aeronautics and Space Administration for fiscal years 2011 through 2013,Passed,119,54,0,5,185,64,0,5,0,0,0,0,304,118,0,10
562,D,111,H R 946,29-Sep-2010,11:44 PM,On Motion to Suspend the Rules and Concur in the Senate Amendments,Plain Writing Act of 2010,Passed,92,80,0,6,249,2,0,3,0,0,0,0,341,82,0,9
563,D,111,H R 512,29-Sep-2010,11:52 PM,"On Motion to Suspend the Rules and Pass, as Amended",To amend the Federal Election Campaign Act of 1971 to prohibit certain State election administration officials from actively participating in electoral campaigns,Passed,45,128,0,5,251,1,0,2,0,0,0,0,296,129,0,7
564,D,111,H R 3081,30-Sep-2010,12:18 AM,On Motion to Concur in the Senate Amendments,"Making appropriations for the Department of State, foreign operations, and related programs for the fiscal year ending September 30, 2010, and for other purposes",Passed,1,172,0,5,227,22,0,5,0,0,0,0,228,194,0,10
565,D,111,H R 3940,30-Sep-2010,12:25 AM,On Motion to Suspend the Rules and Concur in the Senate Amendments,To amend Public Law 96-597 to clarify the authority of the Secretary of the Interior to extend grants and other assistance to facilitate political status public education programs for the peoples of the non-self governing territories of the United States,Passed,159,3,0,16,227,2,0,25,0,0,0,0,386,5,0,41
566,D,111,S 3689,15-Nov-2010,6:30 PM,"On Motion to Suspend the Rules and Pass, as Amended","To clarify, improve, and correct the laws relating to copyrights",Passed,164,0,0,14,221,0,1,32,0,0,0,0,385,0,1,46
567,D,111,H RES 1713,15-Nov-2010,6:38 PM,On Motion to Suspend the Rules and Agree,Recognizing the 50th anniversary of Ruby Bridges desegregating a previously all-White public elementary school,Passed,162,0,0,16,214,0,0,40,0,0,0,0,376,0,0,56
568,D,111,H CON RES 328,15-Nov-2010,6:51 PM,On Motion to Suspend the Rules and Agree,Expressing the sense of the Congress regarding the successful and substantial contributions of the amendments to the patent and trademark laws that were initially enacted in 1980 by Public Law 96-517 (commonly referred to as the “Bayh-Dole Act”) on the occassion of the 30th anniversary of its enactment,Passed,161,1,0,16,224,0,0,30,0,0,0,0,385,1,0,46
569,D,111,H RES 716,16-Nov-2010,4:51 PM,On Motion to Suspend the Rules and Agree,Recognizing Gail Abarbanel and the Rape Treatment Center,Passed,173,0,0,5,242,0,0,12,0,0,0,0,415,0,0,17
570,D,111,H RES 1475,16-Nov-2010,4:59 PM,On Motion to Suspend the Rules and Agree,"Congratulates the town of Tarboro, North Carolina, on the occasion of its 250th anniversary",Passed,171,0,0,7,235,0,0,19,0,0,0,0,406,0,0,26
571,D,111,H RES 1428,16-Nov-2010,5:14 PM,On Motion to Suspend the Rules and Agree,Recognizing Brooklyn Botanic Garden on its 100th anniversary as the preeminent horticultural attraction in the borough of Brooklyn and its longstanding commitment to environmental stewardship and education for the city,Passed,165,0,1,13,236,0,0,18,0,0,0,0,401,0,1,31
572,D,111,H CON RES 332,17-Nov-2010,5:15 PM,On Agreeing to the Resolution,Adjournment Resolution,Passed,11,163,0,5,223,21,0,10,0,0,0,0,234,184,0,15
573,D,111,H R 3808,17-Nov-2010,5:24 PM,"On Passage of the Bill, the Objections of the President Notwithstanding",To require any Federal or State court to recognize any notarization made by a notary public licensed by a State other than the State where the court is located when such notarization occurs in or affects interstate commerce,Failed,169,5,0,5,16,230,0,8,0,0,0,0,185,235,0,13
574,D,111,H R 5758,17-Nov-2010,5:38 PM,On Motion to Suspend the Rules and Pass,"To designate the facility of the United States Postal Service located at 2 Government Center in Fall River, Massachusetts, as the “Sergeant Robert Barrett Post Office Building”",Passed,172,0,0,7,245,0,0,9,0,0,0,0,417,0,0,16
575,D,111,H RES 1715,17-Nov-2010,5:45 PM,On Motion to Suspend the Rules and Agree,Congratulating Joe Paterno on his 400th win as Penn State Nittany Lions football coach,Passed,172,1,0,6,245,2,0,7,0,0,0,0,417,3,0,13
576,D,111,H RES 1721,18-Nov-2010,11:44 AM,On Ordering the Previous Question,"Providing for the Consideration of the Senate amendment to H.R. 1722, the Telework Enhancement Act",Passed,0,168,0,11,239,3,0,12,0,0,0,0,239,171,0,23
577,D,111,H RES 1721,18-Nov-2010,11:52 AM,On Agreeing to the Resolution,"Providing for the Consideration of the Senate amendment to H.R. 1722, the Telework Enhancement Act",Passed,1,167,0,11,234,4,0,16,0,0,0,0,235,171,0,27
578,D,111,H R 1722,18-Nov-2010,1:52 PM,On Motion to Concur in the Senate Amendment,Telework Improvements Act,Passed,14,149,0,16,240,3,0,11,0,0,0,0,254,152,0,27
579,D,111,H R 6419,18-Nov-2010,2:01 PM,"On Motion to Suspend the Rules and Pass, as Amended",Emergency Unemployment Compensation Continuation Act,Failed,21,143,0,15,237,11,0,7,0,0,0,0,258,154,0,22
580,D,111,S 3774,18-Nov-2010,2:17 PM,On Motion to Suspend the Rules and Pass,To extend the deadline for Social Services Block Grant expenditures of supplemental funds appropriated following disasters occurring in 2008,Passed,127,32,0,21,239,8,0,7,0,0,0,0,366,40,0,28
581,D,111,H R 5877,29-Nov-2010,6:31 PM,On Motion to Suspend the Rules and Pass,"To designate the facility of the United States Postal Service located at 655 Centre Street in Jamaica Plain, Massachusetts, as the “Lance Corporal Alexander Scott Arredondo, United States Marine Corps Post Office Building”",Passed,154,0,0,25,212,0,0,42,0,0,0,0,366,0,0,67
582,D,111,H RES 771,29-Nov-2010,6:39 PM,On Motion to Suspend the Rules and Agree,Supporting the goals and ideals of a National Mesothelioma Awareness Day,Passed,152,0,0,27,211,0,0,43,0,0,0,0,363,0,0,70
583,D,111,H RES 1736,30-Nov-2010,1:43 PM,On Agreeing to the Resolution,"Providing for consideration of the Senate amendments to the bill (H.R. 4783) to accelerate the income tax benefits for charitable cash contributions for the relief of victims of the earthquake in Chile, and to extend the period from which such contributions for the relief of victims of the earthquake in Haiti may be ac",Passed,2,159,0,18,221,9,0,24,0,0,0,0,223,168,0,42
584,D,111,H R 4783,30-Nov-2010,4:03 PM,On Motion to Concur in the Senate Amendments,"To accelerate the income tax benefits for charitable cash contributions for the relief of victims of the earthquake in Chile, and to extend the period from which such contributions for the relief of victims of the earthquake in Haiti may be accelerated.",Passed,16,149,0,14,240,3,0,11,0,0,0,0,256,152,0,25
585,D,111,H RES 1585,30-Nov-2010,4:18 PM,"On Motion to Suspend the Rules and Agree, as Amended","Honoring and recognizing the exemplary service and sacrifice of the 60th Air Mobility Wing, the 349th Air Mobility Wing, the 15th Expeditionary Mobility Task Force, and the 615th Contingency Response Wing civilians and families serving at Travis Air Force Base, California",Passed,168,0,0,11,240,0,0,14,0,0,0,0,408,0,0,25
586,D,111,H RES 1740,30-Nov-2010,4:29 PM,On Motion to Suspend the Rules and Agree,Recognizing and honoring the National Guard on the occasion of its 374th anniversary,Passed,166,0,0,13,238,0,0,16,0,0,0,0,404,0,0,29
587,D,111,H RES 1742,1-Dec-2010,12:28 PM,On Ordering the Previous Question,"Providing for consideration of S. 3307, the Healthy, Hunger-Free Kids Act",Passed,0,169,0,10,232,11,0,11,0,0,0,0,232,180,0,21
588,D,111,H RES 1742,1-Dec-2010,12:36 PM,On Agreeing to the Resolution,"Providing for consideration of S. 3307, the Healthy, Hunger-Free Kids Act",Passed,1,162,0,16,229,12,0,13,0,0,0,0,230,174,0,29
589,D,111,H RES 1741,1-Dec-2010,12:44 PM,On Agreeing to the Resolution,"Providing for consideration of H.J.Res. 101, Making further continuing appropriations for fiscal year 2011, and for other purposes",Passed,0,166,0,13,236,6,0,12,0,0,0,0,236,172,0,25
590,D,111,H CON RES 323,1-Dec-2010,12:51 PM,On Motion to Suspend the Rules and Agree,"Supporting the goal of ensuring that all Holocaust survivors in the United States are able to live with dignity, comfort, and security in their remaining years",Passed,168,0,0,11,238,0,0,16,0,0,0,0,406,0,0,27
591,D,111,H RES 1735,1-Dec-2010,12:59 PM,On Motion to Suspend the Rules and Agree,"Condemning North Korea in the strongest terms for its uprovoked military attack against South Korea on November 23, 2010",Passed,165,1,0,13,238,1,0,15,0,0,0,0,403,2,0,28
592,D,111,H RES 1430,1-Dec-2010,1:06 PM,"On Motion to Suspend the Rules and Agree, as Amended",Honoring and saluting golf legend Juan Antonio “Chi Chi” Rodriguez for his commitment to Latino youth programs of the Congressional Hispanic Caucus Institute,Passed,165,2,0,12,240,0,0,14,0,0,0,0,405,2,0,26
593,D,111,H J RES 101,1-Dec-2010,3:03 PM,On Passage,"Making further continuing appropriations for fiscal year 2011, and for other purposes",Passed,2,170,0,7,237,8,0,9,0,0,0,0,239,178,0,16
594,D,111,H RES 1217,1-Dec-2010,3:34 PM,"On Motion to Suspend the Rules and Agree, as Amended",Honoring Fort Drum’s soldiers of the 10th Mountain Division for their past and continuing contributions to the security of the United States,Passed,172,0,0,7,243,0,0,11,0,0,0,0,415,0,0,18
595,D,111,H RES 1724,1-Dec-2010,3:45 PM,"On Motion to Suspend the Rules and Agree, as Amended","Commending the City of Jacksonville, Arkansas, for its outstanding support in creating a unique and lasting partnership with Little Rock Air Force Base, members of the Armed Forces stationed there and their families, and the Air Force",Passed,170,0,0,9,241,0,0,13,0,0,0,0,411,0,0,22
596,D,111,H RES 1745,2-Dec-2010,11:44 AM,On Ordering the Previous Question,"Providing for consideration of the Senate amendment to the bill (H.R. 4853) to amend the Internal Revenue Code of 1986 to extend the funding & expenditure authority of the Airport and Airway Trust Fund, to amend title 49, United States Code, to extend authorizations for the airport improvement program",Passed,0,169,0,10,224,17,0,13,0,0,0,0,224,186,0,23
597,D,111,H RES 1745,2-Dec-2010,11:55 AM,On Agreeing to the Resolution,"Providing for consideration of the Senate amendment to the bill (H.R. 4853) to amend the Internal Revenue Code of 1986 to extend the funding & expenditure authority of the Airport and Airway Trust Fund, to amend title 49, United States Code, to extend authorizations for the airport improvement program",Passed,0,170,0,9,213,33,0,9,0,0,0,0,213,203,0,18
598,D,111,H RES 1638,2-Dec-2010,12:03 PM,On Motion to Suspend the Rules and Agree,Supporting the goals and ideals of National GEAR UP Day,Passed,166,0,0,13,239,0,0,15,0,0,0,0,405,0,0,28
599,D,111,H RES 1598,2-Dec-2010,12:11 PM,On Motion to Suspend the Rules and Agree,Expressing support for the designation of the month of October as National Work and Family Month,Passed,168,0,0,11,244,0,0,10,0,0,0,0,412,0,0,21
600,D,111,H RES 1576,2-Dec-2010,12:21 PM,"On Motion to Suspend the Rules and Agree, as Amended",Expressing the sense of the House of Representatives that a National Day of Recognition for Parents of Children with Special Needs should be established,Passed,170,0,0,9,243,0,0,11,0,0,0,0,413,0,0,20
601,D,111,H R 6469,2-Dec-2010,3:08 PM,On Motion to Suspend the Rules and Pass,To amend section 17 of the Richard B. Russell National School Lunch Act to include a condition of receipt of funds under the child and adult care food program,Passed,166,3,0,10,250,0,0,5,0,0,0,0,416,3,0,15
602,D,111,S 3307,2-Dec-2010,3:25 PM,On Motion to Recommit with Instructions,"Healthy, Hunger-Free Kids Act of 2010",Failed,170,1,0,8,30,220,0,4,0,0,0,0,200,221,0,12
603,D,111,S 3307,2-Dec-2010,3:36 PM,On Passage,"Healthy, Hunger-Free Kids Act of 2010",Passed,17,153,0,9,247,4,0,4,0,0,0,0,264,157,0,13
604,D,111,H R 4853,2-Dec-2010,3:55 PM,On Motion to Concur in the Senate Amendment with an Amendment,"Airport and Airway Extension Act of 2010, Part III",Passed,3,168,0,8,231,20,0,4,0,0,0,0,234,188,0,12
605,D,111,H RES 1313,2-Dec-2010,4:05 PM,On Motion to Suspend the Rules and Agree,"Expressing support for designation of May as “Child Advocacy Center Month” and commending the National Child Advocacy Center in Huntsville, Alabama, on their 25th anniversary in 2010",Passed,165,0,0,14,248,0,0,6,0,0,0,0,413,0,0,20
606,D,111,H RES 1737,2-Dec-2010,5:36 PM,On Agreeing to the Amendment,None,Failed,3,162,0,14,143,105,0,6,0,0,0,0,146,267,0,20
607,D,111,H RES 1737,2-Dec-2010,5:53 PM,On Agreeing to the Resolution,In the matter of Representative Charles B. Rangel of New York,Passed,163,2,0,14,170,77,0,7,0,0,0,0,333,79,0,21
608,D,111,H R 6400,7-Dec-2010,6:30 PM,On Motion to Suspend the Rules and Pass,"To designate the facility of the United States Postal Service located at 111 North 6th Street in St. Louis, Missouri as the “Earl Wilson, Jr. Post Office”",Passed,157,0,0,22,225,0,0,29,0,0,0,0,382,0,0,51
609,D,111,H RES 1642,7-Dec-2010,6:38 PM,On Motion to Suspend the Rules and Agree,"Recognizing the centennial of the City of Lilburn, Georgia, and supporting the goals and ideals of a City Lilburn Day",Passed,154,0,0,25,225,0,0,29,0,0,0,0,379,0,0,54
610,D,111,H RES 1264,7-Dec-2010,6:47 PM,On Motion to Suspend the Rules and Agree,Expressing support for the designation of March as National Essential Tremor Awareness Month,Passed,157,1,0,21,230,0,0,24,0,0,0,0,387,1,0,45
611,D,111,H R 5987,8-Dec-2010,12:06 PM,"On Motion to Suspend the Rules and Pass, as Amended",Seniors Protection Act of 2010,Failed,26,141,0,12,228,12,0,15,0,0,0,0,254,153,0,27
612,D,111,H RES 1717,8-Dec-2010,12:14 PM,"On Motion to Suspend the Rules and Agree, as Amended",Congratulating imprisoned Chinese democracy advocate Liu Xiaobo on the award of the 2010 Nobel Peace Prize,Passed,164,1,0,14,238,0,0,17,0,0,0,0,402,1,0,31
613,D,111,H RES 1540,8-Dec-2010,12:23 PM,"On Motion to Suspend the Rules and Agree, as Amended",Supporting the goal of eradicating illicit marijuana cultivation on Federal lands and calling on the Director of the Office of National Drug Control Policy to develop a coordinated strategy to permanently dismantle Mexican drug trafficking organizations operating on Federal lands,Passed,165,1,0,13,235,3,0,16,0,0,0,0,400,4,0,29
614,D,111,H RES 1531,8-Dec-2010,12:31 PM,On Motion to Suspend the Rules and Agree,Expressing support for designation of 2011 as “World Veterinary Year” to bring attention to and show appreciation for the veterinary profession on its 250th anniversary,Passed,167,0,0,12,239,0,0,15,0,0,0,0,406,0,0,27
615,D,111,H RES 1752,8-Dec-2010,2:33 PM,On Agreeing to the Resolution,"Waiving a requirement of clause 6(a) of rule XIII with respect to consideration of certain resolutions reported from the Committee on Rules, and providing for consideration of motions to suspend the rules",Passed,0,167,0,12,215,27,0,12,0,0,0,0,215,194,0,24
616,D,111,H R 6495,8-Dec-2010,2:41 PM,"On Motion to Suspend the Rules and Pass, as Amended",Robert C. Byrd Mine Safety Protection Act of 2010,Failed,1,166,0,12,213,27,0,14,0,0,0,0,214,193,0,26
617,D,111,H RES 1402,8-Dec-2010,2:49 PM,"On Motion to Suspend the Rules and Agree, as Amended","Recognizing the 50th anniversary of the National Council for International Visitors, and expressing support for designation of February 16, 2011, as “Citizen Diplomacy Day”",Passed,154,13,1,11,240,0,0,14,0,0,0,0,394,13,1,25
618,D,111,H RES 1704,8-Dec-2010,2:56 PM,"On Motion to Suspend the Rules and Agree, as Amended",Honoring the 2500th anniversary of the Battle of Marathon,Passed,124,42,1,12,235,2,4,13,0,0,0,0,359,44,5,25
619,D,111,H RES 1755,8-Dec-2010,4:01 PM,On Agreeing to the Resolution,"Providing for consideration of H.R. 3082, making appropriations for military construction, the Department of Veterans Affairs, and related agencies for the fiscal year ending September 30, 2010, and for other purposes",Passed,0,169,0,10,207,37,0,11,0,0,0,0,207,206,0,21
620,D,111,H R 4501,8-Dec-2010,4:09 PM,"On Motion to Suspend the Rules and Pass, as Amended",Guarantee of a Legitimate Deal Act of 2010,Passed,85,81,0,13,239,0,0,15,0,0,0,0,324,81,0,28
621,D,111,H RES 1746,8-Dec-2010,4:17 PM,"On Motion to Suspend the Rules and Agree, as Amended",Recognizing and supporting the efforts of Welcome Back Veterans to augment the services provided by the Departments of Defense and Veterans’ Affairs in providing timely and world-class care for veterans and members of the Armed Forces suffering from PTSD and related psychiatric disorders,Passed,167,0,0,12,242,0,0,12,0,0,0,0,409,0,0,24
622,D,111,H R 3082,8-Dec-2010,6:34 PM,On Motion to Concur in the Senate Amendment with an Amendment,"Making appropriations for military construction, the Department of Veterans Affairs, and related agencies for the fiscal year ending September 30, 2010, and for other purposes",Passed,0,171,0,8,212,35,0,8,0,0,0,0,212,206,0,16
623,D,111,H RES 1756,8-Dec-2010,6:44 PM,On Agreeing to the Resolution,"Providing for consideration of the Senate amendments to the bill (H.R. 5281) to amend title 28, United States Code, to clarify and improve certain provisions relating to the removal of litigation against Federal officers or agencies to Federal courts, and for other pusposes",Passed,0,171,0,8,211,37,0,7,0,0,0,0,211,208,0,15
624,D,111,S 3998,8-Dec-2010,6:51 PM,On Motion to Suspend the Rules and Pass,To extend the Child Safety Pilot Program,Passed,163,2,0,14,238,0,0,16,0,0,0,0,401,2,0,30
625,D,111,H R 5281,8-Dec-2010,9:01 PM,"On Motion to Concur in Senate Amendments #1 and #2, and in #3 With Amendment","To amend title 28, United States Code, to clarify and improve certain provisions relating to the removal of litigation against Federal officers or agencies to Federal courts, and for other purposes",Passed,8,160,0,11,208,38,0,9,0,0,0,0,216,198,0,20
626,D,111,H R 4994,9-Dec-2010,1:09 PM,On Motion to Suspend the Rules and Concur in the Senate Amendments,Medicare and Medicaid Extenders Act,Passed,166,1,0,12,243,1,0,10,0,0,0,0,409,2,0,22
627,D,111,H R 6412,9-Dec-2010,1:38 PM,On Motion to Suspend the Rules and Pass,Access to Criminal History Records for State Sentencing Commissions Act of 2010,Passed,151,1,0,27,220,0,0,34,0,0,0,0,371,1,0,61
628,D,111,S 1405,14-Dec-2010,6:32 PM,On Motion to Suspend the Rules and Pass,Longfellow House-Washington’s Headquarters National Historic Site Designation Act,Passed,153,0,0,26,211,0,0,43,0,0,0,0,364,0,0,69
629,D,111,S 3167,14-Dec-2010,6:40 PM,On Motion to Suspend the Rules and Pass,Census Oversight Efficiency and Management Reform Act of 2010,Failed,1,154,0,24,200,13,0,41,0,0,0,0,201,167,0,65
630,D,111,H R 6510,14-Dec-2010,6:49 PM,On Motion to Suspend the Rules and Pass,"To direct the Administrator of General Services to convey a parcel of real property in Houston, Texas, to the Military Museum of Texas, and for other purposes",Passed,153,0,0,26,210,0,0,44,0,0,0,0,363,0,0,70
631,D,111,H R 5446,15-Dec-2010,1:12 PM,On Motion to Suspend the Rules and Pass,“Harry T. and Harriette Moore Post Office”,Passed,166,0,0,13,239,0,0,15,0,0,0,0,405,0,0,28
632,D,111,H RES 1759,15-Dec-2010,1:22 PM,On Motion to Suspend the Rules and Agree,Expressing support for designation of January 23rd as “Ed Roberts Day”,Passed,154,8,4,13,236,0,0,18,0,0,0,0,390,8,4,31
633,D,111,S CON RES 72,15-Dec-2010,1:31 PM,On Motion to Suspend the Rules and Agree,Recognizing the 45th anniversary of the White House Fellows Program,Passed,165,1,0,13,236,0,0,18,0,0,0,0,401,1,0,31
634,D,111,H R 6205,15-Dec-2010,1:40 PM,On Motion to Suspend the Rules and Pass,“Private Isaac T. Cortes Post Office”,Passed,165,0,0,14,234,0,0,20,0,0,0,0,399,0,0,34
635,D,111,H RES 1764,15-Dec-2010,2:59 PM,On Agreeing to the Resolution,Providing for consideration of the Senate amendment to H.R. 2965,Passed,2,168,0,9,230,12,0,12,0,0,0,0,232,180,0,21
636,D,111,H RES 1761,15-Dec-2010,3:08 PM,On Motion to Suspend the Rules and Agree,"Congratulating Auburn University quarterback and College Park, Georgia, native Cameron Newton on winning the 2010 Heisman Trophy for being the most outstanding college football player in the United States",Passed,150,8,12,9,228,7,6,13,0,0,0,0,378,15,18,22
637,D,111,H RES 1743,15-Dec-2010,3:16 PM,"On Motion to Suspend the Rules and Agree, as Amended",Congratulating Gerda Weissmann Klein on being selected to receive the Presidential Medal of Freedom,Passed,167,0,0,12,240,0,0,14,0,0,0,0,407,0,0,26
638,D,111,H R 2965,15-Dec-2010,5:24 PM,On Motion to Concur in the Senate Amendment with an Amendment,"Don’t Ask, Don’t Tell Repeal Act of 2010",Passed,15,160,0,4,235,15,0,5,0,0,0,0,250,175,0,9
639,D,111,ADJOURN,16-Dec-2010,12:17 PM,On Motion to Adjourn,None,Failed,7,159,0,13,7,226,1,20,0,0,0,0,14,385,1,33
640,D,111,S 841,16-Dec-2010,2:11 PM,On Motion to Suspend the Rules and Pass,Pedestrian Safety Enhancement Act of 2010,Passed,137,30,0,12,242,0,0,12,0,0,0,0,379,30,0,24
641,D,111,S 3860,16-Dec-2010,2:22 PM,On Motion to Suspend the Rules and Pass,To require reports on the management of Arlington National Cemetery.,Passed,164,3,0,12,243,0,0,11,0,0,0,0,407,3,0,23
642,D,111,S 3447,16-Dec-2010,2:29 PM,On Motion to Suspend the Rules and Pass,"To amend title 38, United States Code, to improve educational assistance for veterans who served in the Armed Forces after September 11, 2001, and for other purposes.",Passed,164,3,0,12,245,0,0,10,0,0,0,0,409,3,0,22
643,D,111,H RES 1766,16-Dec-2010,7:17 PM,On Agreeing to the Amendment,Providing for consideration of the Senate amendment to the House amendment to the Senate amendment to the bill (H.R. 4853) to amend the Internal Revenue Code of 1986 to extend the funding and expenditure authority of the Airport and Airway Trust Fund,Passed,0,171,0,8,230,15,0,9,0,0,0,0,230,186,0,17
644,D,111,H RES 1766,16-Dec-2010,7:26 PM,"On Agreeing to the Resolution, as Amended",Providing for consideration of the Senate amendment to the House amendment to the Senate amendment to the bill (H.R. 4853) to amend the Internal Revenue Code of 1986 to extend the funding and expenditure authority of the Airport and Airway Trust Fund,Passed,0,170,0,9,214,31,0,9,0,0,0,0,214,201,0,18
645,D,111,S 987,16-Dec-2010,7:33 PM,On Motion to Suspend the Rules and Pass,"To protect girls in developing countries through the prevention of child marriage, and for other purposes.",Failed,12,157,0,10,229,9,0,16,0,0,0,0,241,166,0,26
646,D,111,H R 4853,16-Dec-2010,11:41 PM,On Agreeing to the Amendment,None,Failed,0,173,0,6,194,60,1,5,0,0,0,0,194,233,1,11
647,D,111,H R 4853,17-Dec-2010,12:00 AM,On Motion to Concur in the Senate Amdt to the House Amdt to the Senate Amdt,"Airport and Airway Extension Act of 2010, Part III",Passed,138,36,0,5,139,112,0,3,0,0,0,0,277,148,0,8
648,D,111,H RES 1377,17-Dec-2010,1:18 PM,On Motion to Suspend the Rules and Agree,"Honoring the accomplishments of Norman Yoshino Mineta, and for other purposes",Passed,160,0,0,19,224,0,0,30,0,0,0,0,384,0,0,49
649,D,111,H R 1107,17-Dec-2010,1:27 PM,On Motion to Suspend the Rules and Concur in the Senate Amendments,"An act to enact certain laws relating to public contracts as title 41, United States Code, “Public Contracts”",Passed,159,0,0,20,226,0,0,28,0,0,0,0,385,0,0,48
650,D,111,H R 6523,17-Dec-2010,1:36 PM,"On Motion to Suspend the Rules and Pass, as Amended",Ike Skelton National Defense Authorization Act for Fiscal Year 2011,Passed,154,6,0,19,187,42,0,25,0,0,0,0,341,48,0,44
651,D,111,H R 628,17-Dec-2010,1:49 PM,On Motion to Suspend the Rules and Concur in the Senate Amendment,An act to establish a pilot program in certain United States district courts to encourage enhancement of expertise in patent cases among district judges,Passed,153,1,0,25,218,0,0,36,0,0,0,0,371,1,0,61
652,D,111,H CON RES 336,17-Dec-2010,4:05 PM,On Agreeing to the Resolution,Providing for the sine die adjournment of the second session of the One Hundred Eleventh Congress,Passed,11,140,0,28,185,13,0,56,0,0,0,0,196,153,0,84
653,D,111,H RES 1776,17-Dec-2010,4:12 PM,On Agreeing to the Resolution,"Providing for consideration of the joint resolution (H.J.Res. 105) making further continuing appropriations for fiscal year 2011, and for other purposes",Passed,0,149,0,30,184,10,0,60,0,0,0,0,184,159,0,90
654,D,111,H R 2142,17-Dec-2010,4:20 PM,On Motion to Suspend the Rules and Concur in the Senate Amendment,GPRA Modernization Act of 2010,Failed,23,127,0,29,189,4,0,61,0,0,0,0,212,131,0,90
655,D,111,H R 5510,17-Dec-2010,4:53 PM,"On Motion to Suspend the Rules and Pass, as Amended",Aiding Those Facing Foreclosure Act of 2010,Failed,6,140,0,33,204,5,0,45,0,0,0,0,210,145,0,78
656,D,111,S 3874,17-Dec-2010,5:05 PM,On Motion to Suspend the Rules and Pass,Reduction of Lead in Drinking Water Act,Passed,31,108,0,40,195,1,0,58,0,0,0,0,226,109,0,98
657,D,111,H RES 1771,21-Dec-2010,1:00 PM,On Agreeing to the Resolution,"Waiving a requirement of clause 6(a) of rule XIII with respect to consideration of certain resolutions reported from the Committee on Rules, and providing for consideration of motions to suspend the rules",Passed,0,146,0,33,199,5,0,50,0,0,0,0,199,151,0,83
658,D,111,H R 6540,21-Dec-2010,1:06 PM,On Motion to Suspend the Rules and Pass,Defense Level Playing Field Act,Passed,122,21,0,36,203,2,0,49,0,0,0,0,325,23,0,85
659,D,111,H R 5116,21-Dec-2010,4:31 PM,On Motion to Concur in the Senate Amendment,America COMPETES Reauthorization Act,Passed,16,130,0,33,212,0,0,42,0,0,0,0,228,130,0,75
660,D,111,H R 2142,21-Dec-2010,4:42 PM,On Motion to Concur in the Senate Amendment,GPRA Modernization Act of 2010,Passed,8,138,0,33,208,1,0,45,0,0,0,0,216,139,0,78
661,D,111,H R 2751,21-Dec-2010,4:49 PM,On Motion to Concur in the Senate Amendments,FDA Food Safety Modernization Act,Passed,10,136,0,33,205,8,0,41,0,0,0,0,215,144,0,74
662,D,111,H R 3082,21-Dec-2010,7:35 PM,On Motion to Concur in the Senate amendment to House amendment to Senate amendment,"Making appropriations for military construction, the Department of Veterans Affairs, and related agencies for the fiscal year ending September 30, 2010, and for other purposes",Passed,1,146,0,32,192,19,0,43,0,0,0,0,193,165,0,75
663,D,111,H R 6547,21-Dec-2010,7:44 PM,On Motion to Suspend the Rules and Pass,Protecting Students from Sexual and Violent Predators Act,Passed,113,20,0,46,201,0,0,53,0,0,0,0,314,20,0,99
664,D,111,H R 847,22-Dec-2010,5:36 PM,On Motion to Concur in the Senate Amendment,James Zadroga 9/11 Health and Compensation Act,Passed,31,59,0,89,175,1,0,79,0,0,0,0,206,60,0,168
