Roll Call,Majority,Congress Num,Legislation Number,Date,Time,Question,Description,Result,Republican Yes,Republican No,Republican Present,Republican Not Voting,Democrat Yes,Democrat No,Democrat Present,Democrat Not Voting,Independent Yes,Independent No,Independent Present,Independent Not Voting,Total Yes,Total No,Total Present,Total Not Voting
1,R,114,QUORUM,5-Jan-2016,6:57 PM,Call of the House,None,Passed,0,0,231,15,0,0,166,22,0,0,0,0,0,0,397,37
2,R,114,H RES 579,6-Jan-2016,3:30 PM,On Ordering the Previous Question,Providing for consideration of the Senate amendment to the bill (H.R. 3762) to provide for reconciliation pursuant to section 2002 of the concurrent resolution on the budget for fiscal year 2016,Passed,238,0,0,7,1,175,0,12,0,0,0,0,239,175,0,19
3,R,114,H RES 579,6-Jan-2016,3:40 PM,On Agreeing to the Resolution,Providing for consideration of the Senate amendment to the bill (H.R. 3762) to provide for reconciliation pursuant to section 2002 of the concurrent resolution on the budget for fiscal year 2016,Passed,237,0,0,8,0,177,0,11,0,0,0,0,237,177,0,19
4,R,114,H RES 580,6-Jan-2016,3:48 PM,On Ordering the Previous Question,Providing for consideration of the bill (H.R. 712) Sunshine for Regulatory Decrees and Settlements Act of 2015 and providing for consideration of the bill (H.R. 1155) Searching for and Cutting Regulations that are Unnecessarily Burdensome Act of 2015,Passed,240,0,0,5,1,176,0,11,0,0,0,0,241,176,0,16
5,R,114,H RES 580,6-Jan-2016,3:57 PM,On Agreeing to the Resolution,Providing for consideration of the bill (H.R. 712) Sunshine for Regulatory Decrees and Settlements Act of 2015 and providing for consideration of the bill (H.R. 1155) Searching for and Cutting Regulations that are Unnecessarily Burdensome Act of 2015,Passed,238,0,0,7,1,176,0,11,0,0,0,0,239,176,0,18
6,R,114,H R 3762,6-Jan-2016,5:54 PM,On Motion to Concur in the Senate Amendment,An Act to provide for reconciliation pursuant to section 2002 of the concurrent resolution on the budget for fiscal year 2016,Passed,239,3,0,4,1,178,0,9,0,0,0,0,240,181,0,13
7,R,114,H R 712,7-Jan-2016,3:41 PM,On Agreeing to the Amendment,None,Failed,0,240,0,5,175,2,0,11,0,0,0,0,175,242,0,16
8,R,114,H R 712,7-Jan-2016,3:46 PM,On Agreeing to the Amendment,None,Failed,0,241,0,4,174,3,0,11,0,0,0,0,174,244,0,15
9,R,114,H R 712,7-Jan-2016,3:50 PM,On Agreeing to the Amendment,None,Failed,5,233,0,7,175,2,0,11,0,0,0,0,180,235,0,18
10,R,114,H R 712,7-Jan-2016,3:53 PM,On Agreeing to the Amendment,None,Failed,0,239,0,6,173,2,0,13,0,0,0,0,173,241,0,19
11,R,114,H R 712,7-Jan-2016,4:11 PM,On Motion to Recommit with Instructions,Sunshine for Regulatory Decrees and Settlements Act of 2015,Failed,0,241,0,4,171,3,0,14,0,0,0,0,171,244,0,18
12,R,114,H R 712,7-Jan-2016,4:20 PM,On Passage,Sunshine for Regulatory Decrees and Settlements Act of 2015,Passed,241,0,0,4,3,173,0,12,0,0,0,0,244,173,0,16
13,R,114,H R 1155,7-Jan-2016,4:26 PM,On Agreeing to the Amendment,None,Failed,0,236,0,9,174,3,0,11,0,0,0,0,174,239,0,20
14,R,114,H R 1155,7-Jan-2016,4:30 PM,On Agreeing to the Amendment,None,Failed,0,239,0,6,172,5,0,11,0,0,0,0,172,244,0,17
15,R,114,H R 1155,7-Jan-2016,4:33 PM,On Agreeing to the Amendment,None,Failed,3,237,0,5,173,4,0,11,0,0,0,0,176,241,0,16
16,R,114,H R 1155,7-Jan-2016,4:37 PM,On Agreeing to the Amendment,None,Failed,2,238,0,5,174,1,0,13,0,0,0,0,176,239,0,18
17,R,114,H R 1155,7-Jan-2016,4:40 PM,On Agreeing to the Amendment,None,Failed,0,241,0,4,173,3,0,12,0,0,0,0,173,244,0,16
18,R,114,H R 1155,7-Jan-2016,4:44 PM,On Agreeing to the Amendment,None,Failed,0,241,0,4,173,4,0,11,0,0,0,0,173,245,0,15
19,R,114,H R 1155,7-Jan-2016,5:03 PM,On Motion to Recommit with Instructions,Searching for and Cutting Regulations that are Unnecessarily Burdensome Act of 2015 or the “SCRUB Act of 2015”,Failed,0,239,0,6,178,0,0,10,0,0,0,0,178,239,0,16
20,R,114,H R 1155,7-Jan-2016,5:09 PM,On Passage,Searching for and Cutting Regulations that are Unnecessarily Burdensome Act of 2015 or the “SCRUB Act of 2015”,Passed,239,2,0,4,6,172,0,10,0,0,0,0,245,174,0,14
21,R,114,H RES 581,7-Jan-2016,5:16 PM,On Ordering the Previous Question,"Providing for consideration of the bill (H.R. 1927) to amend title 28, United States Code, to improve fairness in class action litigation.",Passed,235,0,0,10,1,176,0,11,0,0,0,0,236,176,0,21
22,R,114,H RES 581,7-Jan-2016,5:26 PM,On Agreeing to the Resolution,"Providing for consideration of the bill (H.R. 1927) to amend title 28, United States Code, to improve fairness in class action litigation.",Passed,234,0,0,11,0,176,0,12,0,0,0,0,234,176,0,23
23,R,114,H R 1927,8-Jan-2016,12:03 PM,On Agreeing to the Amendment,None,Failed,8,209,0,28,150,2,0,36,0,0,0,0,158,211,0,64
24,R,114,H R 1927,8-Jan-2016,12:07 PM,On Agreeing to the Amendment,None,Failed,4,218,0,23,159,3,0,26,0,0,0,0,163,221,0,49
25,R,114,H R 1927,8-Jan-2016,12:10 PM,On Agreeing to the Amendment,None,Failed,0,228,0,17,163,4,0,21,0,0,0,0,163,232,0,38
26,R,114,H R 1927,8-Jan-2016,12:14 PM,On Agreeing to the Amendment,None,Failed,2,227,0,16,170,2,0,16,0,0,0,0,172,229,0,32
27,R,114,H R 1927,8-Jan-2016,12:18 PM,On Agreeing to the Amendment,None,Failed,6,223,0,16,171,1,0,16,0,0,0,0,177,224,0,32
28,R,114,H R 1927,8-Jan-2016,12:22 PM,On Agreeing to the Amendment,None,Failed,7,220,0,18,170,3,0,15,0,0,0,0,177,223,0,33
29,R,114,H R 1927,8-Jan-2016,12:25 PM,On Agreeing to the Amendment,None,Failed,6,221,1,17,171,2,0,15,0,0,0,0,177,223,1,32
30,R,114,H R 1927,8-Jan-2016,12:28 PM,On Agreeing to the Amendment,None,Failed,2,227,0,16,172,1,0,15,0,0,0,0,174,228,0,31
31,R,114,H R 1927,8-Jan-2016,12:32 PM,On Agreeing to the Amendment,None,Failed,7,221,0,17,172,1,0,15,0,0,0,0,179,222,0,32
32,R,114,H R 1927,8-Jan-2016,12:47 PM,On Motion to Recommit with Instructions,"To amend title 28, United States Code, to improve fairness in class action litigation",Failed,1,227,0,17,172,0,0,16,0,0,0,0,173,227,0,33
33,R,114,H R 1927,8-Jan-2016,12:56 PM,On Passage,"To amend title 28, United States Code, to improve fairness in class action litigation",Passed,211,16,1,17,0,172,0,16,0,0,0,0,211,188,1,33
34,R,114,H R 598,11-Jan-2016,6:54 PM,"On Motion to Suspend the Rules and Pass, as Amended",Taxpayers Right-To-Know Act,Passed,236,0,0,9,177,0,0,11,0,0,0,0,413,0,0,20
35,R,114,H R 3231,11-Jan-2016,7:00 PM,"On Motion to Suspend the Rules and Pass, as Amended",Federal Intern Protection Act of 2015,Passed,235,0,0,10,179,0,0,9,0,0,0,0,414,0,0,19
36,R,114,H RES 583,12-Jan-2016,2:06 PM,On Ordering the Previous Question,Providing for consideration of the bill (H.R. 1644) STREAM Act ; providing for consideration of the joint resolution (S.J.Res. 22) congressional disapproval of the rule submitted by the Corps of Engineers and the EPA relating to “waters of the U.S.”; and consideration of (H.R. 3662) Iran Terror Finance Transparency Act,Passed,232,0,0,13,1,173,0,14,0,0,0,0,233,173,0,27
37,R,114,H RES 583,12-Jan-2016,2:29 PM,On Agreeing to the Resolution,Providing for consideration of the bill (H.R. 1644) STREAM Act; providing for consideration of the joint resolution (S.J.Res. 22) congressional disapproval of the rule submitted by the Corps of Engineers and the EPA relating to “waters of the U.S.”; and consideration of (H.R. 3662) Iran Terror Finance Transparency Act,Passed,239,0,0,6,0,183,0,5,0,0,0,0,239,183,0,11
38,R,114,H R 1644,12-Jan-2016,4:28 PM,On Agreeing to the Amendment,None,Failed,15,220,0,10,174,3,0,11,0,0,0,0,189,223,0,21
39,R,114,H R 1644,12-Jan-2016,4:33 PM,On Agreeing to the Amendment,None,Failed,22,216,0,7,181,3,0,4,0,0,0,0,203,219,0,11
40,R,114,H R 1644,12-Jan-2016,4:36 PM,On Agreeing to the Amendment,None,Failed,8,233,0,4,182,2,0,4,0,0,0,0,190,235,0,8
41,R,114,H R 1644,12-Jan-2016,4:53 PM,On Motion to Recommit with Instructions,Supporting Transparent Regulatory and Environmental Actions in Mining (STREAM) Act,Failed,2,236,0,7,184,1,0,3,0,0,0,0,186,237,0,10
42,R,114,H R 1644,12-Jan-2016,4:59 PM,On Passage,Supporting Transparent Regulatory and Environmental Actions in Mining (STREAM) Act,Passed,231,10,0,4,4,178,0,6,0,0,0,0,235,188,0,10
43,R,114,H R 757,12-Jan-2016,5:06 PM,"On Motion to Suspend the Rules and Pass, as Amended",North Korea Sanctions Enforcement Act of 2016,Passed,236,2,0,7,182,0,0,6,0,0,0,0,418,2,0,13
44,R,114,,13-Jan-2016,,,This vote was vacated by unanimous consent on 13-Jan-2016.,,0,0,0,0,0,0,0,0,0,0,0,0,0,0,0,0
45,R,114,S J RES 22,13-Jan-2016,11:55 AM,On Passage,"Providing for congressional disapproval under chapter 8 of title 5, United States Code, of the rule submitted by the Corps of Engineers and the Environmental Protection Agency relating to the definition of “waters of the United States” under the Federal Water Pollution Control Act",Passed,241,1,0,3,12,165,0,11,0,0,0,0,253,166,0,14
46,R,114,H R 2187,1-Feb-2016,6:47 PM,"On Motion to Suspend the Rules and Pass, as Amended",Fair Investment Opportunities for Professional Experts Act,Passed,203,1,0,41,144,7,0,37,0,0,0,0,347,8,0,78
47,R,114,H R 4168,1-Feb-2016,6:54 PM,On Motion to Suspend the Rules and Pass,Small Business Capital Formation Enhancement Act,Passed,224,1,0,20,166,0,0,22,0,0,0,0,390,1,0,42
48,R,114,H RES 594,2-Feb-2016,2:26 PM,On Ordering the Previous Question,"Providing for consideration of the bill (H.R. 3700) to provide housing opportunities in the United States through modernization of various housing programs, and for other purposes.",Passed,235,0,0,10,1,178,0,9,0,0,0,0,236,178,0,19
49,R,114,H RES 594,2-Feb-2016,2:33 PM,On Agreeing to the Resolution,"Providing for consideration of the bill (H.R. 3700) to provide housing opportunities in the United States through modernization of various housing programs, and for other purposes.",Passed,238,0,0,7,4,177,0,7,0,0,0,0,242,177,0,14
50,R,114,H R 3700,2-Feb-2016,5:40 PM,On Agreeing to the Amendment,None,Agreed to,235,4,0,6,1,174,0,13,0,0,0,0,236,178,0,19
51,R,114,H R 3700,2-Feb-2016,5:44 PM,On Agreeing to the Amendment,None,Failed,3,238,0,4,178,1,0,9,0,0,0,0,181,239,0,13
52,R,114,H R 3700,2-Feb-2016,5:52 PM,On Passage,Housing Opportunity Through Modernization Act,Passed,243,0,0,2,184,0,0,4,0,0,0,0,427,0,0,6
53,R,114,H R 3762,2-Feb-2016,5:58 PM,"Passage, Objections of the President To The Contrary Notwithstanding",An Act to provide for reconciliation pursuant to section 2002 of the concurrent resolution on the budget for fiscal year 2016,Failed,240,3,0,2,1,183,0,4,0,0,0,0,241,186,0,6
54,R,114,H R 3662,2-Feb-2016,6:04 PM,On Passage,Iran Terror Finance Transparency Act,Passed,243,0,0,2,3,181,0,4,0,0,0,0,246,181,0,6
55,R,114,H RES 595,3-Feb-2016,1:52 PM,On Ordering the Previous Question,"Providing for consideration of H.R. 1675, the Encouraging Employee Ownership Act of 2015, and providing for consideration of H.R. 766, the Financial Institution Customer Protection Act of 2015",Passed,239,0,0,6,1,176,0,11,0,0,0,0,240,176,0,17
56,R,114,H RES 595,3-Feb-2016,1:59 PM,On Agreeing to the Resolution,"Providing for consideration of H.R. 1675, the Encouraging Employee Ownership Act of 2015, and providing for consideration of H.R. 766, the Financial Institution Customer Protection Act of 2015",Passed,240,0,0,5,2,175,0,11,0,0,0,0,242,175,0,16
57,R,114,H R 1675,3-Feb-2016,4:28 PM,On Agreeing to the Amendment,None,Failed,1,240,0,4,179,3,0,6,0,0,0,0,180,243,0,10
58,R,114,H R 1675,3-Feb-2016,4:32 PM,On Agreeing to the Amendment,None,Failed,21,213,0,11,173,8,0,7,0,0,0,0,194,221,0,18
59,R,114,H R 1675,3-Feb-2016,4:35 PM,On Agreeing to the Amendment,None,Failed,2,237,0,6,171,11,0,6,0,0,0,0,173,248,0,12
60,R,114,H R 1675,3-Feb-2016,4:53 PM,On Motion to Recommit with Instructions,Encouraging Employee Ownership Act of 2015,Failed,2,240,0,3,182,1,0,5,0,0,0,0,184,241,0,8
61,R,114,H R 1675,3-Feb-2016,4:59 PM,On Passage,Encouraging Employee Ownership Act of 2015,Passed,241,1,0,3,24,158,0,6,0,0,0,0,265,159,0,9
62,R,114,H R 766,4-Feb-2016,12:08 PM,On Motion to Recommit with Instructions,Financial Institution Customer Protection Act of 2015,Failed,0,239,0,6,177,1,0,10,0,0,0,0,177,240,0,16
63,R,114,H R 766,4-Feb-2016,12:17 PM,On Passage,Financial Institution Customer Protection Act of 2015,Passed,240,0,0,5,10,169,0,9,0,0,0,0,250,169,0,14
64,R,114,H R 3036,9-Feb-2016,6:50 PM,"On Motion to Suspend the Rules and Pass, as Amended",9/11 Memorial Act,Passed,216,12,0,17,171,0,0,17,0,0,0,0,387,12,0,34
65,R,114,H RES 609,10-Feb-2016,2:34 PM,On Ordering the Previous Question,"Providing for consideration of the bill (H.R. 3442) Debt Management and Fiscal Responsibility Act, and providing for consideration of the bill (H.R. 3293) Scientific Research in the National Interest Act",Passed,236,0,0,9,1,180,0,7,0,0,0,0,237,180,0,16
66,R,114,H RES 609,10-Feb-2016,2:40 PM,On Agreeing to the Resolution,"Providing for consideration of the bill (H.R. 3442) Debt Management and Fiscal Responsibility Act, and providing for consideration of the bill (H.R. 3293) Scientific Research in the National Interest Act",Passed,234,0,0,11,2,178,0,8,0,0,0,0,236,178,0,19
67,R,114,H R 4470,10-Feb-2016,2:47 PM,"On Motion to Suspend the Rules and Pass, as Amended",Safe Drinking Water Act Improved Compliance Awareness Act,Passed,234,2,0,9,182,0,0,6,0,0,0,0,416,2,0,15
68,R,114,H R 3293,10-Feb-2016,5:08 PM,On Agreeing to the Amendment,None,Failed,4,232,0,9,177,3,0,8,0,0,0,0,181,235,0,17
69,R,114,H R 3293,10-Feb-2016,5:27 PM,On Motion to Recommit with Instructions,Scientific Research in the National Interest Act,Failed,1,235,0,9,176,6,0,6,0,0,0,0,177,241,0,15
70,R,114,H R 3293,10-Feb-2016,5:33 PM,On Passage,Scientific Research in the National Interest Act,Passed,229,4,0,12,7,174,0,7,0,0,0,0,236,178,0,19
71,R,114,H R 3442,11-Feb-2016,4:05 PM,On Agreeing to the Amendment,None,Failed,5,234,0,6,179,0,0,9,0,0,0,0,184,234,0,15
72,R,114,H R 3442,11-Feb-2016,4:10 PM,On Agreeing to the Amendment,None,Agreed to,238,0,0,7,2,176,0,10,0,0,0,0,240,176,0,17
73,R,114,H R 3442,11-Feb-2016,4:13 PM,On Agreeing to the Amendment,None,Failed,0,239,0,6,171,6,0,11,0,0,0,0,171,245,0,17
74,R,114,H R 3442,11-Feb-2016,4:18 PM,On Agreeing to the Amendment,None,Failed,11,227,0,7,179,0,0,9,0,0,0,0,190,227,0,16
75,R,114,H R 3442,11-Feb-2016,4:36 PM,On Motion to Recommit with Instructions,Debt Management and Fiscal Responsibility Act of 2015,Failed,1,237,0,7,178,1,0,9,0,0,0,0,179,238,0,16
76,R,114,H R 3442,11-Feb-2016,4:42 PM,On Passage,Debt Management and Fiscal Responsibility Act of 2015,Passed,239,0,0,6,28,151,0,9,0,0,0,0,267,151,0,15
77,R,114,H RES 611,11-Feb-2016,4:49 PM,On Ordering the Previous Question,"Providing for consideration of H.R. 2017, the Common Sense Nutrition Disclosure Act of 2015; and providing for proceedings during the period from February 15, 2016, through February 22, 2016",Passed,236,0,0,9,1,178,0,9,0,0,0,0,237,178,0,18
78,R,114,H RES 611,11-Feb-2016,4:55 PM,On Agreeing to the Resolution,"Providing for consideration of H.R. 2017, the Common Sense Nutrition Disclosure Act of 2015; and providing for proceedings during the period from February 15, 2016, through February 22, 2016",Passed,233,0,0,12,4,174,0,10,0,0,0,0,237,174,0,22
79,R,114,H R 2017,12-Feb-2016,11:28 AM,On Agreeing to the Amendment,None,Agreed to,233,0,0,12,76,100,1,11,0,0,0,0,309,100,1,23
80,R,114,H R 2017,12-Feb-2016,11:32 AM,On Agreeing to the Amendment,None,Failed,1,230,0,14,147,28,1,12,0,0,0,0,148,258,1,26
81,R,114,H R 2017,12-Feb-2016,11:41 AM,On Passage,Common Sense Nutrition Disclosure Act of 2015,Passed,233,1,0,11,33,143,1,11,0,0,0,0,266,144,1,22
82,R,114,H R 757,12-Feb-2016,11:49 AM,On Motion to Suspend the Rules and Concur in the Senate Amendment,North Korea Sanctions and Policy Enforcement Act of 2016,Passed,232,2,0,11,176,0,0,12,0,0,0,0,408,2,0,23
83,R,114,H R 4408,23-Feb-2016,6:51 PM,"On Motion to Suspend the Rules and Pass, as Amended",National Strategy to Combat Terrorist Travel Act of 2016,Passed,228,0,0,17,164,0,0,24,0,0,0,0,392,0,0,41
84,R,114,H R 4402,23-Feb-2016,7:01 PM,"On Motion to Suspend the Rules and Pass, as Amended",Foreign Fighter Review Act of 2016,Passed,227,0,0,18,170,0,0,18,0,0,0,0,397,0,0,36
85,R,114,H RES 618,24-Feb-2016,1:40 PM,On Ordering the Previous Question,"Providing for consideration of the bill (H.R. 3624) to amend title 28, United States Code, to prevent fraudulent joinder.",Passed,237,0,0,8,0,180,0,8,0,0,0,0,237,180,0,16
86,R,114,H RES 618,24-Feb-2016,1:47 PM,On Agreeing to the Resolution,"Providing for consideration of the bill (H.R. 3624) to amend title 28, United States Code, to prevent fraudulent joinder.",Passed,238,0,0,7,0,180,0,8,0,0,0,0,238,180,0,15
87,R,114,H R 3624,25-Feb-2016,3:35 PM,On Agreeing to the Amendment,None,Failed,5,236,0,4,173,1,0,14,0,0,0,0,178,237,0,18
88,R,114,H R 3624,25-Feb-2016,3:53 PM,On Motion to Recommit with Instructions,Fraudulent Joinder Prevention Act,Failed,2,239,0,4,178,0,0,10,0,0,0,0,180,239,0,14
89,R,114,H R 3624,25-Feb-2016,3:59 PM,On Passage,Fraudulent Joinder Prevention Act,Passed,229,10,0,6,0,179,0,9,0,0,0,0,229,189,0,15
90,R,114,H RES 619,25-Feb-2016,4:07 PM,On Ordering the Previous Question,"Providing for consideration of the bill (H.R. 2406) to protect and enhance opportunities for recreational hunting, fishing, and shooting, and for other purposes",Passed,239,0,0,6,1,178,0,9,0,0,0,0,240,178,0,15
91,R,114,H RES 619,25-Feb-2016,4:14 PM,On Agreeing to the Resolution,"Providing for consideration of the bill (H.R. 2406) to protect and enhance opportunities for recreational hunting, fishing, and shooting, and for other purposes",Passed,238,0,0,7,3,175,0,10,0,0,0,0,241,175,0,17
92,R,114,H R 2406,26-Feb-2016,11:51 AM,On Agreeing to the Amendment,None,Failed,2,233,0,10,159,11,0,18,0,0,0,0,161,244,0,28
93,R,114,H R 2406,26-Feb-2016,11:54 AM,On Agreeing to the Amendment,None,Failed,3,230,0,12,156,12,0,20,0,0,0,0,159,242,0,32
94,R,114,H R 2406,26-Feb-2016,11:58 AM,On Agreeing to the Amendment,None,Failed,1,232,0,12,168,4,0,16,0,0,0,0,169,236,0,28
95,R,114,H R 2406,26-Feb-2016,12:01 PM,On Agreeing to the Amendment,None,Agreed to,230,3,0,12,2,170,0,16,0,0,0,0,232,173,0,28
96,R,114,H R 2406,26-Feb-2016,12:04 PM,On Agreeing to the Amendment,None,Agreed to,229,3,0,13,10,162,0,16,0,0,0,0,239,165,0,29
97,R,114,H R 2406,26-Feb-2016,12:07 PM,On Agreeing to the Amendment,None,Agreed to,223,9,0,13,9,162,0,17,0,0,0,0,232,171,0,30
98,R,114,H R 2406,26-Feb-2016,12:10 PM,On Agreeing to the Amendment,None,Agreed to,231,3,0,11,5,166,0,17,0,0,0,0,236,169,0,28
99,R,114,H R 2406,26-Feb-2016,12:14 PM,On Agreeing to the Amendment,None,Failed,9,224,0,12,167,3,0,18,0,0,0,0,176,227,0,30
100,R,114,H R 2406,26-Feb-2016,12:29 PM,On Motion to Recommit with Instructions,Sportsmen’s Heritage and Recreational Enhancement Act of 2015,Failed,0,234,0,11,165,4,0,19,0,0,0,0,165,238,0,30
101,R,114,H R 2406,26-Feb-2016,12:35 PM,On Passage,Sportsmen’s Heritage and Recreational Enhancement Act of 2015,Passed,230,4,0,11,12,157,0,19,0,0,0,0,242,161,0,30
102,R,114,H R 4238,29-Feb-2016,6:49 PM,On Motion to Suspend the Rules and Pass,To amend the Department of Energy Organization Act and the Local Public Works Capital Development and Investment Act of 1976 to modernize terms relating to minorities,Passed,213,0,0,32,163,0,0,25,0,0,0,0,376,0,0,57
103,R,114,H R 136,1-Mar-2016,2:22 PM,On Motion to Suspend the Rules and Pass,"To designate the facility of the United States Postal Service located at 1103 USPS Building 1103 in Camp Pendleton, California, as the “Camp Pendleton Medal of Honor Post Office”.",Passed,215,0,0,30,166,0,0,22,0,0,0,0,381,0,0,52
104,R,114,H R 3735,1-Mar-2016,2:32 PM,On Motion to Suspend the Rules and Pass,Maya Angelou Memorial Post Office,Passed,205,9,1,30,166,0,0,22,0,0,0,0,371,9,1,52
105,R,114,H R 3716,2-Mar-2016,5:33 PM,On Passage,Ensuring Removal of Terminated Providers from Medicaid and CHIP Act,Passed,235,0,0,10,171,0,0,17,0,0,0,0,406,0,0,27
106,R,114,H RES 635,3-Mar-2016,10:26 AM,On Ordering the Previous Question,"Providing for consideration of H.R. 4557, the Blocking Regulatory Interference from Closing Kilns Act of 2016; and providing for proceedings during the period from March 4, 2016, through March 11, 2016.",Passed,233,0,0,12,0,174,0,14,0,0,0,0,233,174,0,26
107,R,114,H RES 635,3-Mar-2016,10:33 AM,On Agreeing to the Resolution,"Providing for consideration of H.R. 4557, the Blocking Regulatory Interference from Closing Kilns Act of 2016; and providing for proceedings during the period from March 4, 2016, through March 11, 2016.",Passed,233,0,0,12,2,173,0,13,0,0,0,0,235,173,0,25
108,R,114,S 1826,3-Mar-2016,10:39 AM,On Motion to Suspend the Rules and Pass,Lieutenant Colonel James “Maggie” Megellas Post Office,Passed,233,1,0,11,173,0,0,15,0,0,0,0,406,1,0,26
109,R,114,H R 4557,3-Mar-2016,11:40 AM,On Passage,Blocking Regulatory Interference from Closing Kilns Act of 2016,Passed,231,0,0,14,7,163,0,18,0,0,0,0,238,163,0,32
110,R,114,JOURNAL,3-Mar-2016,11:48 AM,On Approving the Journal,None,Passed,123,90,0,32,94,64,1,29,0,0,0,0,217,154,1,61
111,R,114,S 2426,14-Mar-2016,6:47 PM,On Motion to Suspend the Rules and Pass,"To direct the Secretary of State to develop a strategy to obtain observer status for Taiwan in the International Criminal Police Organization, and for other purposes",Passed,225,0,0,20,156,0,0,32,0,0,0,0,381,0,0,52
112,R,114,H CON RES 75,14-Mar-2016,6:54 PM,"On Motion to Suspend the Rules and Agree, as Amended","Expressing the sense of Congress that those who commit or support atrocities against Christians and other ethnic and religious minorities and who target them specifically for ethnic or religious reasons, are committing, and are hereby declared to be committing, “war crimes”, “crimes against humanity”, and “genocide”.",Passed,229,0,0,16,164,0,0,24,0,0,0,0,393,0,0,40
113,R,114,H CON RES 121,14-Mar-2016,7:00 PM,"On Motion to Suspend the Rules and Agree, as Amended","Expressing the sense of the Congress condemning the gross violations of international law amounting to war crimes and crimes against humanity by the Government of Syria, its allies, and other parties to the conflict in Syria",Passed,228,2,0,15,164,1,0,23,0,0,0,0,392,3,0,38
114,R,114,H RES 640,15-Mar-2016,1:53 PM,On Ordering the Previous Question,"Providing for consideration of H.R. 4596, the Small Business Boradband Deployment Act and H.R. 3797, the Satisfying Energy Needs and Saving the Environment Act",Passed,235,0,0,10,0,177,0,11,0,0,0,0,235,177,0,21
115,R,114,H RES 640,15-Mar-2016,2:00 PM,On Agreeing to the Resolution,"Providing for consideration of H.R. 4596, the Small Business Boradband Deployment Act and H.R. 3797, the Satisfying Energy Needs and Saving the Environment Act",Passed,234,0,0,11,1,176,0,11,0,0,0,0,235,176,0,22
116,R,114,H R 2081,15-Mar-2016,2:08 PM,On Motion to Suspend the Rules and Pass,To extend the deadline for commencement of construction of a hydroelectric project involving the Gibson Dam,Passed,234,1,0,10,176,1,0,11,0,0,0,0,410,2,0,21
117,R,114,H R 3447,15-Mar-2016,2:15 PM,"On Motion to Suspend the Rules and Pass, as Amended",To extend the deadline for commencement of construction of a hydroelectric project,Passed,230,1,0,14,176,2,0,10,0,0,0,0,406,3,0,24
118,R,114,H R 3797,15-Mar-2016,3:55 PM,On Agreeing to the Amendment,None,Failed,6,221,0,18,160,3,0,25,0,0,0,0,166,224,0,43
119,R,114,H R 3797,15-Mar-2016,3:59 PM,On Agreeing to the Amendment,None,Failed,4,230,0,11,171,3,0,14,0,0,0,0,175,233,0,25
120,R,114,H R 3797,15-Mar-2016,4:04 PM,On Agreeing to the Amendment,None,Failed,3,234,0,8,176,1,0,11,0,0,0,0,179,235,0,19
121,R,114,H R 3797,15-Mar-2016,4:08 PM,On Agreeing to the Amendment,None,Failed,4,233,0,8,178,1,0,9,0,0,0,0,182,234,0,17
122,R,114,H R 3797,15-Mar-2016,4:26 PM,On Motion to Recommit with Instructions,Satisfying Energy Needs and Saving the Environment Act,Failed,1,235,0,9,172,1,0,15,0,0,0,0,173,236,0,24
123,R,114,H R 3797,15-Mar-2016,4:31 PM,On Passage,Satisfying Energy Needs and Saving the Environment Act,Passed,228,8,0,9,3,175,0,10,0,0,0,0,231,183,0,19
124,R,114,H R 4596,16-Mar-2016,1:22 PM,On Passage,Small Business Broadband Deployment Act,Passed,231,0,0,14,180,0,0,8,0,0,0,0,411,0,0,22
125,R,114,H R 4416,16-Mar-2016,1:29 PM,On Motion to Suspend the Rules and Pass,To extend the deadline for commencement of construction of a hydroelectric project,Passed,238,1,0,6,180,1,0,7,0,0,0,0,418,2,0,13
126,R,114,H R 4434,16-Mar-2016,1:35 PM,On Motion to Suspend the Rules and Pass,To extend the deadline for commencement of construction of a hydroelectric project,Passed,238,1,0,6,179,1,0,8,0,0,0,0,417,2,0,14
127,R,114,H RES 649,17-Mar-2016,10:43 AM,On Ordering the Previous Question,"Providing for consideration of the resolution (H.Res. 639) authorizing the Speaker to appear as amicus curiae on behalf of the House of Representatives in the matter of United States, et al. v. Texas, et al., No. 15-674",Passed,234,0,0,11,0,181,0,7,0,0,0,0,234,181,0,18
128,R,114,H RES 649,17-Mar-2016,10:50 AM,On Agreeing to the Resolution,"Providing for consideration of the resolution (H.Res. 639) authorizing the Speaker to appear as amicus curiae on behalf of the House of Representatives in the matter of United States, et al. v. Texas, et al., No. 15-674",Passed,234,0,0,11,0,180,0,8,0,0,0,0,234,180,0,19
129,R,114,H RES 639,17-Mar-2016,12:33 PM,On Agreeing to the Resolution,"Authorizing the Speaker to appear as amicus curiae on behalf of the House of Representatives in the matter of United States, et al. v. Texas, et al., No. 15-674",Passed,234,5,0,7,0,181,0,7,0,0,0,0,234,186,0,14
130,R,114,H R 4314,21-Mar-2016,6:50 PM,"On Motion to Suspend the Rules and Pass, as Amended",Counterterrorism Screening and Assistance Act of 2016,Passed,228,2,0,15,143,0,0,45,0,0,0,0,371,2,0,60
131,R,114,H RES 653,22-Mar-2016,3:06 PM,On Ordering the Previous Question,"Providing for consideration of H.R. 2745, the Standard Merger and Acquisition Reviews Through Equal Rules Act of 2015; and providing for proceedings during the period from March 24, 2016, through April 11, 2016",Passed,231,0,0,14,0,154,0,34,0,0,0,0,231,154,0,48
132,R,114,H RES 653,22-Mar-2016,3:14 PM,On Agreeing to the Resolution,"Providing for consideration of H.R. 2745, the Standard Merger and Acquisition Reviews Through Equal Rules Act of 2015; and providing for proceedings during the period from March 24, 2016, through April 11, 2016",Passed,233,0,0,12,0,154,0,34,0,0,0,0,233,154,0,46
133,R,114,H R 4742,22-Mar-2016,3:21 PM,On Motion to Suspend the Rules and Pass,Promoting Women in Entrepreneurship Act,Passed,229,4,0,12,154,0,0,34,0,0,0,0,383,4,0,46
134,R,114,H R 4755,22-Mar-2016,3:27 PM,On Motion to Suspend the Rules and Pass,"Inspiring the Next Space Pioneers, Innovators, Researchers, and Explorers (INSPIRE) Women Act",Passed,226,3,0,16,154,0,0,34,0,0,0,0,380,3,0,50
135,R,114,H R 4336,22-Mar-2016,3:34 PM,"On Motion to Suspend the Rules and Pass, as Amended","To amend title 38, United States Code, to provide for the burial of the cremated remains of persons who served as Women’s Air Forces Service Pilots in Arlington National Cemetery",Passed,232,0,0,13,153,0,0,35,0,0,0,0,385,0,0,48
136,R,114,H R 2745,23-Mar-2016,11:00 AM,On Motion to Recommit with Instructions,Standard Merger and Acquisition Reviews Through Equal Rules Act,Failed,2,230,0,13,172,5,0,11,0,0,0,0,174,235,0,24
137,R,114,H R 2745,23-Mar-2016,11:06 AM,On Passage,Standard Merger and Acquisition Reviews Through Equal Rules Act,Passed,230,1,0,14,5,170,0,13,0,0,0,0,235,171,0,27
138,R,114,H RES 658,23-Mar-2016,11:18 AM,On Motion to Suspend the Rules and Agree,"Condemning in the strongest terms the terrorist attacks in Brussels on March 22, 2016, which murdered more than 30 innocent people, and severely wounded many more",Passed,232,0,0,13,177,0,0,11,0,0,0,0,409,0,0,24
139,R,114,H R 1567,12-Apr-2016,6:51 PM,"On Motion to Suspend the Rules and Pass, as Amended",Global Food Security Act of 2016,Passed,201,33,0,11,169,0,0,19,0,0,0,0,370,33,0,30
140,R,114,H R 4676,12-Apr-2016,6:58 PM,"On Motion to Suspend the Rules and Pass, as Amended",Preventing Crimes Against Veterans Act of 2016,Passed,238,0,0,7,173,0,0,15,0,0,0,0,411,0,0,22
141,R,114,H RES 672,13-Apr-2016,1:52 PM,On Ordering the Previous Question,Providing for consideration of the bill (H.R. 2666) to prohibit the Federal Communications Commission from regulating the rates charged for broadband Internet access service,Passed,243,0,0,2,0,182,0,6,0,0,0,0,243,182,0,8
142,R,114,H RES 672,13-Apr-2016,1:59 PM,On Agreeing to the Resolution,Providing for consideration of the bill (H.R. 2666) to prohibit the Federal Communications Commission from regulating the rates charged for broadband Internet access service,Passed,241,0,0,4,1,182,0,5,0,0,0,0,242,182,0,9
143,R,114,H RES 671,13-Apr-2016,2:06 PM,On Ordering the Previous Question,"Providing for consideration of the bill (H.R. 3340) Financial Stability Oversight Council Reform Act and providing for consideration of the bill (H.R. 3791) to raise the consolidated assets threshold under the small bank holding company policy statement, and for other purposes",Passed,243,0,0,2,0,182,0,6,0,0,0,0,243,182,0,8
144,R,114,H RES 671,13-Apr-2016,2:12 PM,On Agreeing to the Resolution,"Providing for consideration of the bill (H.R. 3340) Financial Stability Oversight Council Reform Act and providing for consideration of the bill (H.R. 3791) to raise the consolidated assets threshold under the small bank holding company policy statement, and for other purposes",Passed,242,0,0,3,0,182,0,6,0,0,0,0,242,182,0,9
145,R,114,H R 3340,14-Apr-2016,3:32 PM,Table Appeal of the Ruling of the Chair,Financial Stability Oversight Council Reform Act,Passed,239,0,0,6,0,176,0,12,0,0,0,0,239,176,0,18
146,R,114,H R 3340,14-Apr-2016,3:39 PM,On Passage,Financial Stability Oversight Council Reform Act,Passed,238,1,0,6,1,178,0,9,0,0,0,0,239,179,0,15
147,R,114,H R 3791,14-Apr-2016,3:45 PM,On Agreeing to the Amendment,None,Failed,0,241,0,4,165,12,0,11,0,0,0,0,165,253,0,15
148,R,114,H R 3791,14-Apr-2016,4:10 PM,Table Appeal of the Ruling of the Chair,"To raise the consolidated assets threshold under the small bank holding company policy statement, and for other purposes",Passed,240,0,0,5,1,177,0,10,0,0,0,0,241,177,0,15
149,R,114,H R 3791,14-Apr-2016,4:17 PM,On Passage,"To raise the consolidated assets threshold under the small bank holding company policy statement, and for other purposes",Passed,239,1,0,5,8,170,0,10,0,0,0,0,247,171,0,15
150,R,114,H R 2666,15-Apr-2016,10:56 AM,On Agreeing to the Amendment,None,Failed,4,231,0,10,175,0,0,13,0,0,0,0,179,231,0,23
151,R,114,H R 2666,15-Apr-2016,11:02 AM,On Agreeing to the Amendment,None,Failed,1,229,0,15,172,2,0,14,0,0,0,0,173,231,0,29
152,R,114,H R 2666,15-Apr-2016,11:26 AM,On Passage,No Rate Regulation of Broadband Internet Access Act,Passed,236,0,0,9,5,173,0,10,0,0,0,0,241,173,0,19
153,R,114,H R 4570,18-Apr-2016,6:50 PM,On Motion to Suspend the Rules and Pass,"Jeannette Rankin--Women and Minorities in STEM Fields Program, 100 Years of Women in Congress Act",Passed,220,6,2,17,157,0,0,31,0,0,0,0,377,6,2,48
154,R,114,S 719,18-Apr-2016,6:58 PM,On Motion to Suspend the Rules and Pass,Captain John E. Moran and Captain William Wylie Galt Armed Forces Reserve Center,Passed,227,0,1,17,160,0,0,28,0,0,0,0,387,0,1,45
155,R,114,H RES 688,19-Apr-2016,1:52 PM,On Ordering the Previous Question,"Providing for consideration of H.R. 4890, to impose a ban on the payment of bonuses to employees of the IRS until the Secretary of the Treasury develops and implements a comprehensive customer service strategy; and providing for consideration of H.R. 3724, the Ensuring Integrity in the IRS Workforce Act of 2015",Passed,240,0,0,5,0,172,0,16,0,0,0,0,240,172,0,21
156,R,114,H RES 688,19-Apr-2016,1:59 PM,On Agreeing to the Resolution,"Providing for consideration of H.R. 4890, to impose a ban on the payment of bonuses to employees of the IRS until the Secretary of the Treasury develops and implements a comprehensive customer service strategy; and providing for consideration of H.R. 3724, the Ensuring Integrity in the IRS Workforce Act of 2015",Passed,239,0,0,6,3,172,0,13,0,0,0,0,242,172,0,19
157,R,114,H RES 687,19-Apr-2016,2:05 PM,On Ordering the Previous Question,"Providing for consideration of H.R. 1206, the No Hires for the Delinquent IRS Act; and providing for consideration of H.R. 4885, the IRS Oversight While Eliminating Spending (OWES) Act of 2016",Passed,239,0,0,6,0,173,0,15,0,0,0,0,239,173,0,21
158,R,114,H RES 687,19-Apr-2016,2:11 PM,On Agreeing to the Resolution,"Providing for consideration of H.R. 1206, the No Hires for the Delinquent IRS Act; and providing for consideration of H.R. 4885, the IRS Oversight While Eliminating Spending (OWES) Act of 2016",Passed,239,0,0,6,0,173,0,15,0,0,0,0,239,173,0,21
159,R,114,H R 1206,20-Apr-2016,3:50 PM,On Motion to Recommit with Instructions,No Hires for the Delinquent IRS Act,Failed,0,244,0,1,177,1,0,10,0,0,0,0,177,245,0,11
160,R,114,H R 1206,20-Apr-2016,3:58 PM,On Passage,No Hires for the Delinquent IRS Act,Passed,243,1,0,1,11,169,0,8,0,0,0,0,254,170,0,9
161,R,114,H R 4885,20-Apr-2016,4:09 PM,On Passage,IRS Oversight While Eliminating Spending (OWES) Act of 2016,Passed,244,0,0,1,1,179,0,8,0,0,0,0,245,179,0,9
162,R,114,H R 4890,21-Apr-2016,11:10 AM,On Passage,To impose a ban on the payment of bonuses to employees of the Internal Revenue Service until the Secretary of the Treasury develops and implements a comprehensive customer service strategy,Passed,238,0,0,7,22,158,0,8,0,0,0,0,260,158,0,15
163,R,114,H R 3724,21-Apr-2016,11:19 AM,On Passage,Ensuring Integrity in the IRS Workforce Act of 2016,Passed,241,0,0,4,104,78,0,6,0,0,0,0,345,78,0,10
164,R,114,H R 4820,26-Apr-2016,6:51 PM,"On Motion to Suspend the Rules and Pass, as Amended",Combating Terrorist Recruitment Act of 2016,Passed,231,0,0,14,91,79,0,18,0,0,0,0,322,79,0,32
165,R,114,H R 4096,26-Apr-2016,7:02 PM,On Motion to Suspend the Rules and Pass,Investor Clarity and Bank Parity Act,Passed,229,0,0,16,166,3,0,19,0,0,0,0,395,3,0,35
166,R,114,H R 4923,27-Apr-2016,3:30 PM,"On Motion to Suspend the Rules and Pass, as Amended",American Manufacturing Competitiveness Act of 2016,Passed,235,2,0,8,180,0,0,8,0,0,0,0,415,2,0,16
167,R,114,H R 699,27-Apr-2016,3:37 PM,"On Motion to Suspend the Rules and Pass, as Amended",Email Privacy Act,Passed,238,0,0,7,181,0,0,7,0,0,0,0,419,0,0,14
168,R,114,H RES 701,27-Apr-2016,3:44 PM,On Ordering the Previous Question,"Providing for consideration for H.R. 701, the Helping Angels Lead Our Startups Act",Passed,237,0,0,8,1,181,0,6,0,0,0,0,238,181,0,14
169,R,114,H RES 701,27-Apr-2016,3:51 PM,On Agreeing to the Resolution,"Providing for consideration for H.R. 701, the Helping Angels Lead Our Startups Act",Passed,236,0,0,9,4,177,0,7,0,0,0,0,240,177,0,16
170,R,114,H R 4498,27-Apr-2016,5:19 PM,On Agreeing to the Amendment,None,Failed,0,237,0,8,139,35,0,14,0,0,0,0,139,272,0,22
171,R,114,H R 4498,27-Apr-2016,5:26 PM,On Passage,Helping Angels Lead Our Startups (HALOS) Act,Passed,237,0,0,8,88,89,0,11,0,0,0,0,325,89,0,19
172,R,114,S 1890,27-Apr-2016,5:33 PM,On Motion to Suspend the Rules and Pass,Defend Trade Secrets Act of 2016,Passed,234,2,0,9,176,0,0,12,0,0,0,0,410,2,0,21
173,R,114,H RES 706,28-Apr-2016,1:23 PM,On Ordering the Previous Question,"Providing for consideration of H.R. 4901, the Scholarships for Opportunity and Results Reauthorization Act; and providing for consideration of H. J. Res. 88, disapproving the rule submitted by the Department of Labor relating to the definition of the term “Fiduciary”",Passed,231,1,0,13,0,181,0,7,0,0,0,0,231,182,0,20
174,R,114,H RES 706,28-Apr-2016,1:29 PM,On Agreeing to the Resolution,"Providing for consideration of H.R. 4901, the Scholarships for Opportunity and Results Reauthorization Act; and providing for consideration of H. J. Res. 88, disapproving the rule submitted by the Department of Labor relating to the definition of the term “Fiduciary”",Passed,234,0,0,11,0,183,0,5,0,0,0,0,234,183,0,16
175,R,114,H R 5019,28-Apr-2016,1:37 PM,On Motion to Suspend the Rules and Pass,Fair Access to Investment Research Act of 2016,Passed,233,0,0,12,178,6,0,4,0,0,0,0,411,6,0,16
176,R,114,H J RES 88,28-Apr-2016,3:23 PM,On Passage,Disapproving the rule submitted by the Department of Labor relating to the definition of the term “Fiduciary”,Passed,234,0,0,11,0,183,0,5,0,0,0,0,234,183,0,16
177,R,114,H R 2901,28-Apr-2016,3:31 PM,"On Motion to Suspend the Rules and Pass, as Amended",Flood Insurance Market Parity and Modernization Act,Passed,234,0,0,11,185,0,0,3,0,0,0,0,419,0,0,14
178,R,114,H R 4901,29-Apr-2016,10:44 AM,On Motion to Recommit with Instructions,Scholarships for Opportunity and Results Reauthorization Act,Failed,0,227,0,18,167,1,0,20,0,0,0,0,167,228,0,38
179,R,114,H R 4901,29-Apr-2016,10:51 AM,On Passage,Scholarships for Opportunity and Results Reauthorization Act,Passed,222,8,0,15,2,173,0,13,0,0,0,0,224,181,0,28
180,R,114,H R 4957,10-May-2016,6:50 PM,On Motion to Suspend the Rules and Pass,"To designate the Federal Building located at 99 New York Avenue, N.E., in the District of Columbia as the “Ariel Rios Federal Building”",Passed,235,0,0,10,166,0,0,22,0,0,0,0,401,0,0,32
181,R,114,H R 5052,10-May-2016,6:56 PM,"On Motion to Suspend the Rules and Pass, as Amended",Opioid Program Evaluation Act,Passed,237,0,0,8,173,1,0,14,0,0,0,0,410,1,0,22
182,R,114,H RES 720,11-May-2016,1:28 PM,On Ordering the Previous Question,"Providing for consideration of H.R. 4641, to provide for the establishment of an inter-agency task force to review, modify, and update best practices for pain management and prescribing pain medication, and for other purposes; and H.R. 5046, the Comprehensive Opioid Abuse Reduction Act of 2016",Passed,215,0,0,30,0,173,0,15,0,0,0,0,215,173,0,45
183,R,114,H RES 720,11-May-2016,1:35 PM,On Agreeing to the Resolution,"Providing for consideration of H.R. 4641, to provide for the establishment of an inter-agency task force to review, modify, and update best practices for pain management and prescribing pain medication, and for other purposes; and H.R. 5046, the Comprehensive Opioid Abuse Reduction Act of 2016",Passed,238,0,0,7,17,163,0,8,0,0,0,0,255,163,0,15
184,R,114,H R 4641,11-May-2016,4:15 PM,On Passage,"To provide for the establishment of an inter-agency task force to review, modify, and update best practices for pain management and prescribing pain medication, and for other purposes",Passed,231,4,0,10,181,0,0,7,0,0,0,0,412,4,0,17
185,R,114,H R 4843,11-May-2016,4:22 PM,"On Motion to Suspend the Rules and Pass, as Amended",Infant Plan of Safe Care Improvement Act,Passed,238,0,0,7,183,0,0,5,0,0,0,0,421,0,0,12
186,R,114,H R 5046,12-May-2016,4:02 PM,On Agreeing to the Amendment,None,Failed,13,222,0,10,177,3,0,8,0,0,0,0,190,225,0,18
187,R,114,H R 5046,12-May-2016,4:11 PM,On Passage,Comprehensive Opioid Abuse Reduction Act of 2016,Passed,233,5,0,7,180,0,0,8,0,0,0,0,413,5,0,15
188,R,114,H R 1818,12-May-2016,4:18 PM,"On Motion to Suspend the Rules and Pass, as Amended",Veteran Emergency Medical Technician Support Act of 2016,Passed,233,1,0,11,182,0,0,6,0,0,0,0,415,1,0,17
189,R,114,H R 4586,12-May-2016,4:25 PM,"On Motion to Suspend the Rules and Pass, as Amended",Lali’s Law,Passed,234,4,0,7,181,0,0,7,0,0,0,0,415,4,0,14
190,R,114,H RES 725,13-May-2016,10:29 AM,On Ordering the Previous Question,"Providing for consideration of S. 524, the Comprehensive Addiction and Recovery Act of 2016",Passed,231,0,0,14,1,172,0,15,0,0,0,0,232,172,0,29
191,R,114,H RES 725,13-May-2016,10:37 AM,On Agreeing to the Resolution,"Providing for consideration of S. 524, the Comprehensive Addiction and Recovery Act of 2016",Passed,231,0,0,14,9,165,0,14,0,0,0,0,240,165,0,28
192,R,114,JOURNAL,13-May-2016,10:43 AM,On Approving the Journal,None,Passed,139,87,1,18,96,73,1,18,0,0,0,0,235,160,2,36
193,R,114,S 524,13-May-2016,11:51 AM,On Passage,Comprehensive Addiction and Recovery Act of 2016,Passed,228,4,0,13,172,1,0,15,0,0,0,0,400,5,0,28
194,R,114,H R 4743,16-May-2016,6:50 PM,"On Motion to Suspend the Rules and Pass, as Amended",National Cybersecurity Preparedness Consortium Act of 2016,Passed,224,3,0,18,170,0,0,18,0,0,0,0,394,3,0,36
195,R,114,H R 4407,16-May-2016,6:57 PM,"On Motion to Suspend the Rules and Pass, as Amended",Counterterrorism Advisory Board Act of 2016,Passed,222,5,0,18,167,0,0,21,0,0,0,0,389,5,0,39
196,R,114,H RES 732,17-May-2016,2:30 PM,On Ordering the Previous Question,"Providing for consideration of the bill (H.R. 4909) to authorize appropriations for fiscal year 2017 for military activities of the Department of Defense and for military construction, to prescribe military personnel strengths for such fiscal year, and for other purposes",Passed,239,0,0,6,0,177,0,11,0,0,0,0,239,177,0,17
197,R,114,H RES 732,17-May-2016,2:38 PM,On Agreeing to the Resolution,"Providing for consideration of the bill (H.R. 4909) to authorize appropriations for fiscal year 2017 for military activities of the Department of Defense and for military construction, to prescribe military personnel strengths for such fiscal year, and for other purposes",Passed,234,1,0,10,0,180,0,8,0,0,0,0,234,181,0,18
198,R,114,S 524,17-May-2016,2:45 PM,On Motion to Instruct Conferees,Comprehensive Addiction and Recovery Act of 2016,Failed,3,236,0,6,179,0,0,9,0,0,0,0,182,236,0,15
199,R,114,H R 897,17-May-2016,2:52 PM,"On Motion to Suspend the Rules and Pass, as Amended",Zika Vector Control Act,Failed,239,0,0,6,23,159,0,6,0,0,0,0,262,159,0,12
200,R,114,H RES 735,18-May-2016,2:52 PM,On Agreeing to the Resolution,"Providing for further consideration of the bill (H.R. 4909) to authorize appropriations for fiscal year 2017 for military activities of the Department of Defense and for military construction, to prescribe military personnel strengths for such fiscal year, and for other purposes",Passed,230,5,0,10,0,170,0,18,0,0,0,0,230,175,0,28
201,R,114,H RES 736,18-May-2016,2:59 PM,On Ordering the Previous Question,"Providing for consideration of H.R. 4974, the Military Construction and Veterans Affairs and Related Agencies Appropriations Act, 2017; and providing for consideration of H.R. 5243, the Zika Response Appropriations Act, 2016",Passed,240,0,0,5,0,182,0,6,0,0,0,0,240,182,0,11
202,R,114,H RES 736,18-May-2016,3:05 PM,On Agreeing to the Resolution,"Providing for consideration of H.R. 4974, the Military Construction and Veterans Affairs and Related Agencies Appropriations Act, 2017; and providing for consideration of H.R. 5243, the Zika Response Appropriations Act, 2016",Passed,241,0,0,4,0,183,0,5,0,0,0,0,241,183,0,9
203,R,114,H R 4909,18-May-2016,3:12 PM,On Agreeing to the Amendment,None,Failed,120,121,0,4,91,92,0,5,0,0,0,0,211,213,0,9
204,R,114,H R 4909,18-May-2016,3:15 PM,On Agreeing to the Amendment,None,Failed,3,238,0,4,160,21,0,7,0,0,0,0,163,259,0,11
205,R,114,H R 4909,18-May-2016,3:18 PM,On Agreeing to the Amendment,None,Agreed to,233,8,0,4,10,172,0,6,0,0,0,0,243,180,0,10
206,R,114,H R 5243,18-May-2016,9:05 PM,Table Appeal of the Ruling of the Chair,"Making appropriations for the fiscal year ending September 30, 2016, to strengthen public health activities in response to the Zika virus, and for other purposes",Passed,240,0,0,5,0,183,0,5,0,0,0,0,240,183,0,10
207,R,114,H R 5243,18-May-2016,9:13 PM,On Passage,"Making appropriations for the fiscal year ending September 30, 2016, to strengthen public health activities in response to the Zika virus, and for other purposes",Passed,238,4,0,3,3,180,0,5,0,0,0,0,241,184,0,8
208,R,114,H R 4909,18-May-2016,9:18 PM,On Agreeing to the Amendment,None,Failed,159,83,0,3,0,183,0,5,0,0,0,0,159,266,0,8
209,R,114,H R 4909,18-May-2016,9:22 PM,On Agreeing to the Amendment,None,Agreed to,227,15,0,3,0,183,0,5,0,0,0,0,227,198,0,8
210,R,114,H R 4909,18-May-2016,9:25 PM,On Agreeing to the Amendment,None,Failed,13,228,0,4,125,57,0,6,0,0,0,0,138,285,0,10
211,R,114,H R 4909,18-May-2016,9:28 PM,On Agreeing to the Amendment,None,Failed,3,239,0,3,60,121,1,6,0,0,0,0,63,360,1,9
212,R,114,H R 4909,18-May-2016,9:32 PM,On Agreeing to the Amendment,None,Failed,8,234,0,3,123,58,1,6,0,0,0,0,131,292,1,9
213,R,114,H R 4909,18-May-2016,9:36 PM,On Agreeing to the Amendment,None,Failed,3,238,0,4,129,51,1,7,0,0,0,0,132,289,1,11
214,R,114,H R 4909,18-May-2016,9:39 PM,On Agreeing to the Amendment,None,Failed,39,203,0,3,2,180,0,6,0,0,0,0,41,383,0,9
215,R,114,H R 4909,18-May-2016,10:00 PM,On Motion to Recommit with Instructions,National Defense Authorization Act for Fiscal Year 2017,Failed,0,242,0,3,181,1,0,6,0,0,0,0,181,243,0,9
216,R,114,H R 4909,18-May-2016,10:06 PM,On Passage,National Defense Authorization Act for Fiscal Year 2017,Passed,237,5,0,3,40,142,0,6,0,0,0,0,277,147,0,9
217,R,114,H R 4974,19-May-2016,10:56 AM,On Agreeing to the Amendment,None,Failed,28,214,0,3,24,158,0,6,0,0,0,0,52,372,0,9
218,R,114,H R 4974,19-May-2016,11:00 AM,On Agreeing to the Amendment,None,Failed,30,211,0,4,21,160,0,7,0,0,0,0,51,371,0,11
219,R,114,H R 4974,19-May-2016,11:03 AM,On Agreeing to the Amendment,None,Failed,31,207,0,7,25,156,0,7,0,0,0,0,56,363,0,14
220,R,114,H R 4974,19-May-2016,11:06 AM,On Agreeing to the Amendment,None,Failed,31,210,0,4,33,150,0,5,0,0,0,0,64,360,0,9
221,R,114,H R 4974,19-May-2016,11:09 AM,On Agreeing to the Amendment,None,Agreed to,57,184,0,4,176,5,0,7,0,0,0,0,233,189,0,11
222,R,114,H R 4974,19-May-2016,11:12 AM,On Agreeing to the Amendment,None,Agreed to,217,22,0,6,2,180,0,6,0,0,0,0,219,202,0,12
223,R,114,H R 4974,19-May-2016,11:18 AM,On Agreeing to the Amendment,None,Agreed to,84,158,0,3,181,1,1,5,0,0,0,0,265,159,1,8
224,R,114,H R 4974,19-May-2016,11:21 AM,On Agreeing to the Amendment,None,Failed,200,42,0,3,0,183,0,5,0,0,0,0,200,225,0,8
225,R,114,H R 4974,19-May-2016,11:24 AM,On Agreeing to the Amendment,None,Failed,209,33,0,3,0,183,0,5,0,0,0,0,209,216,0,8
226,R,114,H R 4974,19-May-2016,11:32 AM,On Agreeing to the Amendment,None,Failed,29,213,0,3,183,0,0,5,0,0,0,0,212,213,0,8
227,R,114,H R 4974,19-May-2016,11:57 AM,On engrossment and third reading,"Making appropriations for military construction, the Department of Veterans Affairs and related agencies for the fiscal year ending September 30, 2017, and for other purposes.",Passed,241,0,0,4,0,183,0,5,0,0,0,0,241,183,0,9
228,R,114,H R 4974,19-May-2016,12:09 PM,On Passage,"Making appropriations for military construction, the Department of Veterans Affairs and related agencies for the fiscal year ending September 30, 2017, and for other purposes.",Passed,238,4,0,3,57,125,0,6,0,0,0,0,295,129,0,9
229,R,114,H R 4889,23-May-2016,6:54 PM,"On Motion to Suspend the Rules and Pass, as Amended",Kelsey Smith Act,Failed,176,50,0,19,53,108,0,27,0,0,0,0,229,158,0,46
230,R,114,H R 3998,23-May-2016,7:04 PM,"On Motion to Suspend the Rules and Pass, as Amended",Securing Access to Networks in Disasters Act,Passed,227,2,0,16,162,0,0,26,0,0,0,0,389,2,0,42
231,R,114,H RES 743,24-May-2016,2:16 PM,On Ordering the Previous Question,"Providing for consideration of the bill (H.R. 5055) making appropriations for energy and water development and related agencies for the fiscal year ending September 30, 2017, and for other purposes",Passed,233,0,0,12,0,174,0,14,0,0,0,0,233,174,0,26
232,R,114,H RES 743,24-May-2016,2:24 PM,On Agreeing to the Resolution,"Providing for consideration of the bill (H.R. 5055) making appropriations for energy and water development and related agencies for the fiscal year ending September 30, 2017, and for other purposes",Passed,234,0,0,11,3,171,0,14,0,0,0,0,237,171,0,25
233,R,114,H RES 742,24-May-2016,2:31 PM,On Ordering the Previous Question,"Providing for consideration of the Senate amendment to the bill (H.R. 2576) to modernize the Toxic Substances Control Act, and for other purposes, and providing for consideration of the bill (H.R. 897) Reducing Regulatory Burdens Act, and for other purposes",Passed,234,0,0,11,0,175,0,13,0,0,0,0,234,175,0,24
234,R,114,H RES 742,24-May-2016,2:37 PM,On Agreeing to the Resolution,"Providing for consideration of the Senate amendment to the bill (H.R. 2576) to modernize the Toxic Substances Control Act, and for other purposes, and providing for consideration of the bill (H.R. 897) Reducing Regulatory Burdens Act, and for other purposes",Passed,234,0,0,11,4,171,0,13,0,0,0,0,238,171,0,24
235,R,114,H R 5077,24-May-2016,2:43 PM,"On Motion to Suspend the Rules and Pass, as Amended",Intelligence Authorization Act for Fiscal Year 2017,Passed,222,11,0,12,149,24,1,14,0,0,0,0,371,35,1,26
236,R,114,H R 897,24-May-2016,5:03 PM,On Motion to Recommit with Instructions,Zika Vector Control Act,Failed,3,231,0,11,179,1,0,8,0,0,0,0,182,232,0,19
237,R,114,H R 897,24-May-2016,5:09 PM,On Passage,Zika Vector Control Act,Passed,235,0,0,10,23,156,0,9,0,0,0,0,258,156,0,19
238,R,114,H R 2576,24-May-2016,5:16 PM,On Concurring in the Senate Amendment with an Amendment,Frank R. Lautenberg Chemical Safety for the 21st Century Act,Passed,232,3,0,10,171,9,0,8,0,0,0,0,403,12,0,18
239,R,114,H RES 744,25-May-2016,1:36 PM,On Ordering the Previous Question,"Providing for consideration of S. 2012, the Energy Policy Modernization Act of 2016; and providing for consideration of H.R. 5233, Clarifying Congressional Intent in Providing for DC Home Rule Act of 2016",Passed,237,0,0,8,2,176,0,10,0,0,0,0,239,176,0,18
240,R,114,H RES 744,25-May-2016,1:42 PM,On Agreeing to the Resolution,"Providing for consideration of S. 2012, the Energy Policy Modernization Act of 2016; and providing for consideration of H.R. 5233, Clarifying Congressional Intent in Providing for DC Home Rule Act of 2016",Passed,240,0,0,5,2,171,0,15,0,0,0,0,242,171,0,20
241,R,114,H R 5055,25-May-2016,1:48 PM,On Agreeing to the Amendment,None,Failed,79,161,0,5,64,114,0,10,0,0,0,0,143,275,0,15
242,R,114,H R 5055,25-May-2016,1:52 PM,On Agreeing to the Amendment,None,Failed,0,240,0,5,169,7,0,12,0,0,0,0,169,247,0,17
243,R,114,H R 5055,25-May-2016,1:57 PM,On Agreeing to the Amendment,None,Failed,182,59,0,4,0,177,0,11,0,0,0,0,182,236,0,15
244,R,114,H R 5055,25-May-2016,2:01 PM,On Agreeing to the Amendment,None,Failed,80,161,0,4,0,178,0,10,0,0,0,0,80,339,0,14
245,R,114,H R 5055,25-May-2016,2:05 PM,On Agreeing to the Amendment,None,Failed,12,228,0,5,155,23,0,10,0,0,0,0,167,251,0,15
246,R,114,H R 5055,25-May-2016,2:10 PM,On Agreeing to the Amendment,None,Failed,47,194,0,4,97,81,0,10,0,0,0,0,144,275,0,14
247,R,114,H R 5233,25-May-2016,5:11 PM,On Motion to Recommit with Instructions,Clarifying Congressional Intent in Providing for DC Home Rule Act of 2016,Failed,0,239,0,6,179,0,0,9,0,0,0,0,179,239,0,15
248,R,114,H R 5233,25-May-2016,5:17 PM,On Passage,Clarifying Congressional Intent in Providing for DC Home Rule Act of 2016,Passed,238,0,0,7,2,179,0,7,0,0,0,0,240,179,0,14
249,R,114,S 2012,25-May-2016,5:23 PM,On Motion to Commit with Instructions,Energy Policy Modernization Act of 2016,Failed,0,238,0,7,178,1,0,9,0,0,0,0,178,239,0,16
250,R,114,S 2012,25-May-2016,5:31 PM,On Passage,Energy Policy Modernization Act of 2016,Passed,233,6,0,6,8,172,0,8,0,0,0,0,241,178,0,14
251,R,114,H R 5055,25-May-2016,10:28 PM,On Agreeing to the Amendment,None,Failed,158,80,0,7,0,180,0,8,0,0,0,0,158,260,0,15
252,R,114,H R 5055,25-May-2016,10:33 PM,On Agreeing to the Amendment,None,Failed,1,237,0,7,173,8,0,7,0,0,0,0,174,245,0,14
253,R,114,H R 5055,25-May-2016,10:36 PM,On Agreeing to the Amendment,None,Failed,9,228,0,8,180,0,0,8,0,0,0,0,189,228,0,16
254,R,114,H R 5055,25-May-2016,10:39 PM,On Agreeing to the Amendment,None,Failed,0,238,0,7,126,55,0,7,0,0,0,0,126,293,0,14
255,R,114,H R 5055,25-May-2016,10:43 PM,On Agreeing to the Amendment,None,Agreed to,227,11,0,7,0,181,0,7,0,0,0,0,227,192,0,14
256,R,114,H R 5055,25-May-2016,10:46 PM,On Agreeing to the Amendment,None,Agreed to,230,7,0,8,0,181,0,7,0,0,0,0,230,188,0,15
257,R,114,H R 5055,25-May-2016,10:49 PM,On Agreeing to the Amendment,None,Failed,103,135,0,7,103,78,0,7,0,0,0,0,206,213,0,14
258,R,114,H R 5055,25-May-2016,10:53 PM,"On agreeing to the amendment, as amended",None,Agreed to,43,195,0,7,180,0,0,8,0,0,0,0,223,195,0,15
259,R,114,H R 5055,25-May-2016,10:56 PM,On Agreeing to the Amendment,None,Agreed to,231,7,0,7,2,179,0,7,0,0,0,0,233,186,0,14
260,R,114,H R 5055,25-May-2016,10:59 PM,On Agreeing to the Amendment,None,Failed,156,80,0,9,2,178,0,8,0,0,0,0,158,258,0,17
261,R,114,H R 5055,25-May-2016,11:02 PM,On Agreeing to the Amendment,None,Failed,116,122,0,7,3,178,0,7,0,0,0,0,119,300,0,14
262,R,114,H R 5055,25-May-2016,11:06 PM,On Agreeing to the Amendment,None,Failed,127,111,0,7,1,180,0,7,0,0,0,0,128,291,0,14
263,R,114,H R 5055,25-May-2016,11:09 PM,On Agreeing to the Amendment,None,Agreed to,237,1,0,7,14,167,0,7,0,0,0,0,251,168,0,14
264,R,114,S 2012,25-May-2016,11:16 PM,On Motion to Instruct Conferees,Energy Policy Modernization Act of 2016,Failed,25,211,0,9,180,1,0,7,0,0,0,0,205,212,0,16
265,R,114,H R 5055,26-May-2016,11:03 AM,On Motion to Recommit with Instructions,Energy and Water Appropriations FY 2017,Failed,0,235,0,10,178,1,0,9,0,0,0,0,178,236,0,19
266,R,114,H R 5055,26-May-2016,11:12 AM,On Passage,Energy and Water Appropriations FY 2017,Failed,106,130,0,9,6,175,0,7,0,0,0,0,112,305,0,16
267,R,114,H RES 751,26-May-2016,11:18 AM,On Ordering the Previous Question,"Relating to consideration of the Senate amendment to the bill (H.R. 2577) making appropriations for the Departments of Transportation, and Housing and Urban Development, and related agencies for the fiscal year ending September 30, 2016, and for other purposes",Passed,236,0,0,9,0,180,0,8,0,0,0,0,236,180,0,17
268,R,114,H RES 751,26-May-2016,11:25 AM,On Agreeing to the Resolution,"Relating to consideration of the Senate amendment to the bill (H.R. 2577) making appropriations for the Departments of Transportation, and Housing and Urban Development, and related agencies for the fiscal year ending September 30, 2016, and for other purposes",Passed,232,2,0,11,1,178,0,9,0,0,0,0,233,180,0,20
269,R,114,H CON RES 129,7-Jun-2016,6:52 PM,"On Motion to Suspend the Rules and Agree, as Amended","Expressing support for the goal of ensuring that all Holocaust victims live with dignity, comfort, and security in their remaining years, and urging the Federal Republic of Germany to reaffirm its commitment to through a financial commitment to address the unique health and welfare needs of vulnerable Holocaust victims",Passed,222,0,0,23,141,0,0,47,0,0,0,0,363,0,0,70
270,R,114,H R 4906,7-Jun-2016,7:00 PM,On Motion to Suspend the Rules and Pass,"To amend title 5, United States Code, to clarify the eligibility of employees of a land management agency in a time-limited appointment to compete for a permanent appointment at any Federal agency, and for other purposes",Passed,222,0,0,23,141,0,0,47,0,0,0,0,363,0,0,70
271,R,114,H R 4904,7-Jun-2016,7:07 PM,On Motion to Suspend the Rules and Pass,Making Electronic Government Accountable By Yielding Tangible Efficiencies Act of 2016,Passed,224,0,0,21,142,0,0,46,0,0,0,0,366,0,0,67
272,R,114,H R 1815,7-Jun-2016,7:13 PM,"On Motion to Suspend the Rules and Pass, as Amended",Eastern Nevada Land Implementation Improvement Act,Passed,217,7,0,21,143,0,0,45,0,0,0,0,360,7,0,66
273,R,114,H RES 767,8-Jun-2016,1:57 PM,On Ordering the Previous Question,"Providing for consideration of H.R. 4775, the Ozone Standards Implementation Act of 2016; providing for consideration of H. Con. Res. 89, expressing the sense of Congress that a carbon tax would be detrimental to the United States economy; and providing for consideration of H. Con. Res. 112",Passed,230,0,0,15,0,163,0,25,0,0,0,0,230,163,0,40
274,R,114,H RES 767,8-Jun-2016,2:03 PM,On Agreeing to the Resolution,"Providing for consideration of H.R. 4775, the Ozone Standards Implementation Act of 2016; providing for consideration of H. Con. Res. 89, expressing the sense of Congress that a carbon tax would be detrimental to the United States economy; and providing for consideration of H. Con. Res. 112",Passed,234,0,0,11,1,163,0,24,0,0,0,0,235,163,0,35
275,R,114,H R 3826,8-Jun-2016,2:11 PM,"On Motion to Suspend the Rules and Pass, as Amended",Mount Hood Cooper Spur Land Exchange Clarification Act,Passed,234,2,0,9,167,0,0,21,0,0,0,0,401,2,0,30
276,R,114,H R 4775,8-Jun-2016,4:32 PM,On Agreeing to the Amendment,None,Agreed to,234,0,0,11,2,170,0,16,0,0,0,0,236,170,0,27
277,R,114,H R 4775,8-Jun-2016,4:36 PM,On Agreeing to the Amendment,None,Failed,2,229,0,14,169,6,0,13,0,0,0,0,171,235,0,27
278,R,114,H R 4775,8-Jun-2016,4:40 PM,On Agreeing to the Amendment,None,Failed,2,234,0,9,167,8,0,13,0,0,0,0,169,242,0,22
279,R,114,H R 4775,8-Jun-2016,4:44 PM,On Agreeing to the Amendment,None,Failed,0,237,0,8,160,14,0,14,0,0,0,0,160,251,0,22
280,R,114,H R 4775,8-Jun-2016,4:47 PM,On Agreeing to the Amendment,None,Failed,1,234,0,10,170,5,0,13,0,0,0,0,171,239,0,23
281,R,114,H R 4775,8-Jun-2016,5:07 PM,On Motion to Recommit with Instructions,Ozone Standards Implementation Act of 2016,Failed,2,235,0,8,171,4,0,13,0,0,0,0,173,239,0,21
282,R,114,H R 4775,8-Jun-2016,5:14 PM,On Passage,Ozone Standards Implementation Act of 2016,Passed,227,10,0,8,7,167,0,14,0,0,0,0,234,177,0,22
283,R,114,H RES 771,9-Jun-2016,1:50 PM,On Consideration of the Resolution,"Providing for consideration of the bill (H.R. 5325) making appropriations for the Legislative Branch for the fiscal year ending in September 30, 2017, and for other purposes",Passed,231,1,0,13,0,169,0,19,0,0,0,0,231,170,0,32
284,R,114,H RES 770,9-Jun-2016,3:15 PM,On Agreeing to the Resolution,"Providing for consideration of the bill (H.R. 5278) to establish an Oversight Board to assist the Government of Puerto Rico, including instrumentalities, in managing its public finances, and for other purposes",Passed,238,1,0,6,3,177,0,8,0,0,0,0,241,178,0,14
285,R,114,H RES 771,9-Jun-2016,3:33 PM,On Ordering the Previous Question,"Providing for consideration of the bill (H.R. 5325) making appropriations for the Legislative Branch for the fiscal year ending in September 30, 2017, and for other purposes",Passed,240,0,0,6,1,181,0,6,0,0,0,0,241,181,0,12
286,R,114,H RES 771,9-Jun-2016,3:40 PM,On Agreeing to the Resolution,"Providing for consideration of the bill (H.R. 5325) making appropriations for the Legislative Branch for the fiscal year ending in September 30, 2017, and for other purposes",Passed,236,3,0,7,1,179,0,8,0,0,0,0,237,182,0,15
287,R,114,H R 5278,9-Jun-2016,6:11 PM,On Agreeing to the Amendment,None,Failed,15,225,0,6,181,0,0,7,0,0,0,0,196,225,0,13
288,R,114,H R 5278,9-Jun-2016,6:20 PM,On Passage,"Puerto Rico Oversight, Management, and Economic Stability Act (PROMESA)",Passed,139,103,0,5,158,24,0,6,0,0,0,0,297,127,0,11
289,R,114,H R 5325,10-Jun-2016,12:08 PM,On Agreeing to the Amendment,None,Failed,0,232,0,14,157,9,0,22,0,0,0,0,157,241,0,36
290,R,114,H R 5325,10-Jun-2016,12:12 PM,On Agreeing to the Amendment,None,Failed,161,73,0,12,4,164,0,20,0,0,0,0,165,237,0,32
291,R,114,H R 5325,10-Jun-2016,12:16 PM,On Agreeing to the Amendment,None,Failed,15,219,0,12,164,4,0,20,0,0,0,0,179,223,0,32
292,R,114,H R 5325,10-Jun-2016,12:20 PM,On Agreeing to the Amendment,None,Failed,134,102,0,10,3,168,0,17,0,0,0,0,137,270,0,27
293,R,114,H R 5325,10-Jun-2016,12:37 PM,On Motion to Recommit with Instructions,"Making appropriations for the Legislative Branch for the fiscal year ending September 30, 2017, and for other purposes",Failed,0,237,0,9,170,0,0,18,0,0,0,0,170,237,0,27
294,R,114,H R 5325,10-Jun-2016,12:44 PM,On Passage,"Making appropriations for the Legislative Branch for the fiscal year ending September 30, 2017, and for other purposes",Passed,223,14,0,9,10,161,0,17,0,0,0,0,233,175,0,26
295,R,114,H CON RES 89,10-Jun-2016,12:50 PM,On Agreeing to the Resolution,Expressing the sense of Congress that a carbon tax would be detrimental to the United States economy,Passed,231,0,1,14,6,163,1,18,0,0,0,0,237,163,2,32
296,R,114,H CON RES 112,10-Jun-2016,12:58 PM,On Agreeing to the Resolution,Expressing the sense of Congress opposing the President’s proposed $10 tax on every barrel of oil,Passed,230,1,0,15,23,143,2,20,0,0,0,0,253,144,2,35
297,R,114,H R 4939,13-Jun-2016,6:53 PM,"On Motion to Suspend the Rules and Pass, as Amended",United States-Caribbean Strategic Engagement Act of 2016,Passed,215,6,0,25,171,0,0,17,0,0,0,0,386,6,0,42
298,R,114,H R 5312,13-Jun-2016,7:02 PM,"On Motion to Suspend the Rules and Pass, as Amended",Networking and Information Technology Research and Development Modernization Act,Passed,215,6,0,25,170,1,0,17,0,0,0,0,385,7,0,42
299,R,114,H RES 778,14-Jun-2016,1:37 PM,On Ordering the Previous Question,"Providing for consideration of the bill (H.R. 5053) Preventing IRS Abuse and Protecting Free Speech Act; and providing for consideration of the bill (H.R. 5293) making appropriations for the Department of Defense for the fiscal year ending September 30, 2017, and for other purposes",Passed,235,0,0,11,1,171,0,16,0,0,0,0,236,171,0,27
300,R,114,H RES 778,14-Jun-2016,1:44 PM,On Agreeing to the Resolution,"Providing for consideration of the bill (H.R. 5053) Preventing IRS Abuse and Protecting Free Speech Act; and providing for consideration of the bill (H.R. 5293) making appropriations for the Department of Defense for the fiscal year ending September 30, 2017, and for other purposes",Passed,239,1,0,6,0,178,0,10,0,0,0,0,239,179,0,16
301,R,114,H R 5049,14-Jun-2016,1:51 PM,"On Motion to Suspend the Rules and Pass, as Amended",NSF Major Research Facility Reform Act of 2016,Passed,232,9,0,5,180,0,0,8,0,0,0,0,412,9,0,13
302,R,114,H R 5053,14-Jun-2016,4:22 PM,On Motion to Recommit with Instructions,Preventing IRS Abuse and Protecting Free Speech Act,Failed,4,236,0,6,176,2,0,10,0,0,0,0,180,238,0,16
303,R,114,H R 5053,14-Jun-2016,4:30 PM,On Passage,Preventing IRS Abuse and Protecting Free Speech Act,Passed,239,1,0,6,1,181,0,6,0,0,0,0,240,182,0,12
304,R,114,H RES 783,15-Jun-2016,2:20 PM,On Ordering the Previous Question,"Providing for further consideration of the bill (H.R. 5293) making appropriations for the Department of Defense for the fiscal year ending September 30, 2017, and for other purposes",Passed,238,0,0,8,1,183,0,4,0,0,0,0,239,183,0,12
305,R,114,H RES 783,15-Jun-2016,2:31 PM,On Agreeing to the Resolution,"Providing for further consideration of the bill (H.R. 5293) making appropriations for the Department of Defense for the fiscal year ending September 30, 2017, and for other purposes",Passed,240,1,0,5,0,184,0,4,0,0,0,0,240,185,0,9
306,R,114,H R 5293,16-Jun-2016,11:58 AM,On Agreeing to the Amendment,None,Failed,151,89,0,6,54,127,0,7,0,0,0,0,205,216,0,13
307,R,114,H R 5293,16-Jun-2016,12:02 PM,On Agreeing to the Amendment,None,Failed,0,239,0,7,172,9,0,7,0,0,0,0,172,248,0,14
308,R,114,H R 5293,16-Jun-2016,12:06 PM,On Agreeing to the Amendment,None,Failed,134,106,0,6,43,137,0,8,0,0,0,0,177,243,0,14
309,R,114,H R 5293,16-Jun-2016,12:09 PM,On Agreeing to the Amendment,None,Failed,5,235,0,6,154,26,0,8,0,0,0,0,159,261,0,14
310,R,114,H R 5293,16-Jun-2016,12:13 PM,On Agreeing to the Amendment,None,Failed,30,210,0,6,127,53,0,8,0,0,0,0,157,263,0,14
311,R,114,H R 5293,16-Jun-2016,12:17 PM,On Agreeing to the Amendment,None,Agreed to,102,138,0,6,166,15,0,7,0,0,0,0,268,153,0,13
312,R,114,H R 5293,16-Jun-2016,12:20 PM,On Agreeing to the Amendment,None,Failed,147,93,0,6,44,137,0,7,0,0,0,0,191,230,0,13
313,R,114,H R 5293,16-Jun-2016,12:24 PM,On Agreeing to the Amendment,None,Failed,119,120,0,7,36,145,0,7,0,0,0,0,155,265,0,14
314,R,114,H R 5293,16-Jun-2016,12:27 PM,On Agreeing to the Amendment,None,Agreed to,216,24,0,6,0,181,0,7,0,0,0,0,216,205,0,13
315,R,114,H R 5293,16-Jun-2016,12:31 PM,On Agreeing to the Amendment,None,Agreed to,220,20,0,6,3,178,0,7,0,0,0,0,223,198,0,13
316,R,114,H R 5293,16-Jun-2016,12:34 PM,On Agreeing to the Amendment,None,Agreed to,220,20,0,6,1,180,0,7,0,0,0,0,221,200,0,13
317,R,114,H R 5293,16-Jun-2016,12:37 PM,On Agreeing to the Amendment,None,Failed,210,30,0,6,0,181,0,7,0,0,0,0,210,211,0,13
318,R,114,H R 5293,16-Jun-2016,12:40 PM,On Agreeing to the Amendment,None,Failed,207,33,0,6,0,181,0,7,0,0,0,0,207,214,0,13
319,R,114,H R 5293,16-Jun-2016,12:43 PM,On Agreeing to the Amendment,None,Agreed to,235,4,0,7,10,171,0,7,0,0,0,0,245,175,0,14
320,R,114,H R 5293,16-Jun-2016,12:46 PM,On Agreeing to the Amendment,None,Failed,26,214,0,6,22,158,0,8,0,0,0,0,48,372,0,14
321,R,114,H R 5293,16-Jun-2016,12:49 PM,On Agreeing to the Amendment,None,Failed,72,168,0,6,126,54,0,8,0,0,0,0,198,222,0,14
322,R,114,H R 5293,16-Jun-2016,12:52 PM,On Agreeing to the Amendment,None,Agreed to,221,19,0,6,0,178,0,10,0,0,0,0,221,197,0,16
323,R,114,H R 5293,16-Jun-2016,12:55 PM,On Agreeing to the Amendment,None,Failed,30,208,0,8,82,98,0,8,0,0,0,0,112,306,0,16
324,R,114,H R 5293,16-Jun-2016,12:59 PM,On Agreeing to the Amendment,None,Agreed to,219,21,0,6,7,173,0,8,0,0,0,0,226,194,0,14
325,R,114,H R 5293,16-Jun-2016,1:02 PM,On Agreeing to the Amendment,None,Failed,75,165,0,6,9,171,0,8,0,0,0,0,84,336,0,14
326,R,114,H R 5293,16-Jun-2016,1:05 PM,On Agreeing to the Amendment,None,Agreed to,165,74,0,7,53,127,0,8,0,0,0,0,218,201,0,15
327,R,114,H R 5293,16-Jun-2016,1:08 PM,On Agreeing to the Amendment,None,Failed,40,200,0,6,164,16,0,8,0,0,0,0,204,216,0,14
328,R,114,H R 5293,16-Jun-2016,1:11 PM,On Agreeing to the Amendment,None,Failed,56,183,0,7,79,100,0,9,0,0,0,0,135,283,0,16
329,R,114,H R 5293,16-Jun-2016,1:14 PM,On Agreeing to the Amendment,None,Failed,17,223,0,6,118,62,0,8,0,0,0,0,135,285,0,14
330,R,114,H R 5293,16-Jun-2016,1:17 PM,On Agreeing to the Amendment,None,Failed,17,223,0,6,129,51,0,8,0,0,0,0,146,274,0,14
331,R,114,H R 5293,16-Jun-2016,1:20 PM,On Agreeing to the Amendment,None,Failed,15,225,0,6,54,126,0,8,0,0,0,0,69,351,0,14
332,R,114,H R 5293,16-Jun-2016,1:27 PM,On Passage,"Making appropriations for the Department of Defense for the fiscal year ending September 30, 2017, and for other purposes",Passed,234,6,0,6,48,132,0,8,0,0,0,0,282,138,0,14
333,R,114,H R 5471,16-Jun-2016,1:38 PM,On Motion to Suspend the Rules and Pass,Countering Terrorist Radicalization Act,Passed,237,3,0,6,165,12,0,11,0,0,0,0,402,15,0,17
334,R,114,H R 5525,21-Jun-2016,6:51 PM,On Motion to Suspend the Rules and Pass,End Taxpayer Funded Cell Phones Act of 2016,Failed,206,7,0,33,1,136,0,51,0,0,0,0,207,143,0,84
335,R,114,H R 5388,21-Jun-2016,7:00 PM,On Motion to Suspend the Rules and Pass,Support for Rapid Innovation Act 2016,Passed,211,4,0,31,140,0,0,48,0,0,0,0,351,4,0,79
336,R,114,H R 5389,21-Jun-2016,7:08 PM,On Motion to Suspend the Rules and Pass,Leveraging Emerging Technologies Act of 2016,Passed,207,8,0,31,140,0,0,48,0,0,0,0,347,8,0,79
337,R,114,H J RES 88,22-Jun-2016,10:21 PM,On Ordering the Previous Question,Disapproving the rule submitted by the Department of Labor relating to the definition of the term “Fiduciary”,Passed,229,0,0,17,0,175,2,11,0,0,0,0,229,175,2,28
338,R,114,H J RES 88,22-Jun-2016,10:30 PM,"On passage, the objections of the President to the contrary notwithstanding",Disapproving the rule submitted by the Department of Labor relating to the definition of the term “Fiduciary”,Failed,239,0,0,7,0,180,0,8,0,0,0,0,239,180,0,15
339,R,114,MOTION,23-Jun-2016,1:17 AM,On Motion To Fix Next Convening Time,None,Passed,234,0,0,12,0,166,0,22,0,0,0,0,234,166,0,34
340,R,114,ADJOURN,23-Jun-2016,1:33 AM,On Motion to Adjourn,None,Passed,234,1,0,11,0,172,0,16,0,0,0,0,234,173,0,27
341,R,114,H RES 797,23-Jun-2016,2:53 AM,On Agreeing to the Resolution,None,Passed,232,1,0,13,0,175,0,13,0,0,0,0,232,176,0,26
342,R,114,H R 2577,23-Jun-2016,3:10 AM,On Agreeing to the Conference Report,"Making appropriations for the Department of Transportation, and Housing and Urban Development, and related agencies for the fiscal year ending September 30, 2016",Passed,233,2,0,11,6,169,0,13,0,0,0,0,239,171,0,24
343,R,114,H RES 796,5-Jul-2016,6:55 PM,On Ordering the Previous Question,"Providing for consideration of the bill (H.R. 4768) Separation of Powers Restoration Act; providing for proceedings during the period from June 23, 2016, through July 4, 2016; and providing for consideration of motions to suspend the rules",Passed,231,0,0,15,1,168,0,18,0,0,0,0,232,168,0,33
344,R,114,H RES 796,5-Jul-2016,7:02 PM,On Agreeing to the Resolution,"Providing for consideration of the bill (H.R. 4768) Separation of Powers Restoration Act; providing for proceedings during the period from June 23, 2016, through July 4, 2016; and providing for consideration of motions to suspend the rules",Passed,230,0,0,16,0,168,0,19,0,0,0,0,230,168,0,35
345,R,114,H RES 793,5-Jul-2016,7:09 PM,On Ordering the Previous Question,Providing for consideration of the bill (H.R. 1270) to amend the Internal Revenue Code of 1986 to repeal the amendments made by the Patient Protection and Affordable Care Act which disqualify expenses for over-the-counter drugs under health savings accounts and health flexible spending arrangements,Passed,230,0,0,16,1,168,0,18,0,0,0,0,231,168,0,34
346,R,114,H RES 793,5-Jul-2016,7:14 PM,On Agreeing to the Resolution,Providing for consideration of the bill (H.R. 1270) to amend the Internal Revenue Code of 1986 to repeal the amendments made by the Patient Protection and Affordable Care Act which disqualify expenses for over-the-counter drugs under health savings accounts and health flexible spending arrangements,Passed,225,0,0,21,1,168,0,18,0,0,0,0,226,168,0,39
347,R,114,H RES 794,5-Jul-2016,7:20 PM,On Ordering the Previous Question,"Providing for consideration of the bill (H.R. 5485) making appropriations for financial services and general government for the fiscal year ending September 30, 2017, and for other purposes",Passed,228,1,0,17,1,168,0,18,0,0,0,0,229,169,0,35
348,R,114,H RES 794,5-Jul-2016,7:27 PM,On Agreeing to the Resolution,"Providing for consideration of the bill (H.R. 5485) making appropriations for financial services and general government for the fiscal year ending September 30, 2017, and for other purposes",Passed,227,3,0,16,0,169,0,18,0,0,0,0,227,172,0,34
349,R,114,H R 4854,5-Jul-2016,7:33 PM,"On Motion to Suspend the Rules and Pass, as Amended",Supporting America’s Innovators Act of 2016,Passed,227,2,0,17,161,7,0,19,0,0,0,0,388,9,0,36
350,R,114,H R 4855,5-Jul-2016,7:41 PM,"On Motion to Suspend the Rules and Pass, as Amended",Fix Crowdfunding Act,Passed,230,0,0,16,164,4,0,19,0,0,0,0,394,4,0,35
351,R,114,H R 1270,6-Jul-2016,3:43 PM,On Passage,Restoring Access to Medication Act of 2015,Passed,233,0,0,13,10,164,0,13,0,0,0,0,243,164,0,26
352,R,114,H RES 803,6-Jul-2016,3:51 PM,On Ordering the Previous Question,"Providing for consideration of H.R. 4361, Federal Information Systems Safeguards Act of 2016",Passed,241,0,0,5,2,180,0,5,0,0,0,0,243,180,0,10
353,R,114,H RES 803,6-Jul-2016,3:58 PM,On Agreeing to the Resolution,"Providing for consideration of H.R. 4361, Federal Information Systems Safeguards Act of 2016",Passed,238,1,0,7,2,181,0,4,0,0,0,0,240,182,0,11
354,R,114,S 1252,6-Jul-2016,4:05 PM,On Motion to Suspend the Rules and Pass,Global Food Security Act of 2016.,Passed,186,53,0,7,183,0,0,4,0,0,0,0,369,53,0,11
355,R,114,H R 2646,6-Jul-2016,4:15 PM,"On Motion to Suspend the Rules and Pass, as Amended",Helping Families in Mental Health Crisis Act of 2016,Passed,239,2,0,5,183,0,0,4,0,0,0,0,422,2,0,9
356,R,114,H R 5485,6-Jul-2016,7:11 PM,On Sustaining the Ruling of the Chair,"Making appropriations for financial services and general government for fiscal year ending September 30, 2017, and for other purposes",Passed,220,1,0,25,0,167,0,20,0,0,0,0,220,168,0,45
357,R,114,H R 5485,6-Jul-2016,10:31 PM,On Agreeing to the Amendment,None,Failed,0,238,0,8,173,7,0,7,0,0,0,0,173,245,0,15
358,R,114,H R 5485,6-Jul-2016,10:36 PM,On Agreeing to the Amendment,None,Failed,165,73,0,8,1,181,0,5,0,0,0,0,166,254,0,13
359,R,114,H R 5485,6-Jul-2016,10:40 PM,On Agreeing to the Amendment,None,Failed,1,238,0,7,182,1,0,4,0,0,0,0,183,239,0,11
360,R,114,H R 5485,6-Jul-2016,10:43 PM,On Agreeing to the Amendment,None,Failed,3,234,0,9,178,2,0,7,0,0,0,0,181,236,0,16
361,R,114,H R 5485,6-Jul-2016,10:47 PM,On Agreeing to the Amendments,None,Failed,0,239,0,7,179,4,0,4,0,0,0,0,179,243,0,11
362,R,114,H R 5485,6-Jul-2016,10:51 PM,On Agreeing to the Amendment,None,Failed,1,237,0,8,182,1,0,4,0,0,0,0,183,238,0,12
363,R,114,H R 5485,6-Jul-2016,10:55 PM,On Agreeing to the Amendment,None,Failed,38,201,0,7,90,93,0,4,0,0,0,0,128,294,0,11
364,R,114,H R 5485,6-Jul-2016,10:58 PM,On Agreeing to the Amendment,None,Failed,1,238,0,7,176,7,0,4,0,0,0,0,177,245,0,11
365,R,114,H R 5485,6-Jul-2016,11:01 PM,On Agreeing to the Amendment,None,Failed,3,236,0,7,183,0,0,4,0,0,0,0,186,236,0,11
366,R,114,H R 5485,6-Jul-2016,11:04 PM,On Agreeing to the Amendment,None,Failed,2,236,0,8,180,2,0,5,0,0,0,0,182,238,0,13
367,R,114,H R 5485,6-Jul-2016,11:08 PM,On Agreeing to the Amendment,None,Failed,1,238,0,7,166,17,0,4,0,0,0,0,167,255,0,11
368,R,114,H R 5485,6-Jul-2016,11:10 PM,On Agreeing to the Amendment,None,Failed,2,236,0,8,160,19,0,8,0,0,0,0,162,255,0,16
369,R,114,H R 5485,6-Jul-2016,11:13 PM,On Agreeing to the Amendment,None,Failed,6,233,0,7,176,7,0,4,0,0,0,0,182,240,0,11
370,R,114,H R 5485,6-Jul-2016,11:16 PM,On Agreeing to the Amendment,None,Failed,1,236,0,9,181,2,0,4,0,0,0,0,182,238,0,13
371,R,114,H R 5485,6-Jul-2016,11:19 PM,On Agreeing to the Amendment,None,Agreed to,234,3,0,9,1,182,0,4,0,0,0,0,235,185,0,13
372,R,114,H R 5485,6-Jul-2016,11:22 PM,On Agreeing to the Amendment,None,Agreed to,230,6,0,10,2,181,0,4,0,0,0,0,232,187,0,14
373,R,114,H R 4361,6-Jul-2016,11:28 PM,On Agreeing to the Amendment,None,Failed,1,238,0,7,182,1,0,4,0,0,0,0,183,239,0,11
374,R,114,H R 4361,6-Jul-2016,11:31 PM,On Agreeing to the Amendment,None,Failed,0,239,0,7,179,4,0,4,0,0,0,0,179,243,0,11
375,R,114,H R 4361,6-Jul-2016,11:57 PM,On Motion to Table the Appeal of the Ruling of the Chair,Federal Information Systems Safeguards Act,Passed,239,0,0,7,1,182,0,4,0,0,0,0,240,182,0,11
376,R,114,H R 4361,7-Jul-2016,12:03 AM,On Passage,Federal Information Systems Safeguards Act,Passed,237,2,0,7,4,179,0,4,0,0,0,0,241,181,0,11
377,R,114,H R 5485,7-Jul-2016,5:11 PM,On Agreeing to the Amendment,None,Failed,181,61,0,4,1,180,0,6,0,0,0,0,182,241,0,10
378,R,114,H R 5485,7-Jul-2016,5:15 PM,On Agreeing to the Amendment,None,Failed,197,43,0,6,0,181,0,6,0,0,0,0,197,224,0,12
379,R,114,H R 5485,7-Jul-2016,5:18 PM,On Agreeing to the Amendment,None,Agreed to,215,24,0,7,2,179,0,6,0,0,0,0,217,203,0,13
380,R,114,H R 5485,7-Jul-2016,5:21 PM,On Agreeing to the Amendment,None,Agreed to,240,2,0,4,3,178,0,6,0,0,0,0,243,180,0,10
381,R,114,H R 5485,7-Jul-2016,5:24 PM,On Agreeing to the Amendment,None,Agreed to,238,2,0,6,1,180,0,6,0,0,0,0,239,182,0,12
382,R,114,H R 5485,7-Jul-2016,5:27 PM,On Agreeing to the Amendment,None,Agreed to,235,6,0,5,1,176,0,10,0,0,0,0,236,182,0,15
383,R,114,H R 5485,7-Jul-2016,5:30 PM,On Agreeing to the Amendment,None,Agreed to,241,0,1,4,19,162,0,6,0,0,0,0,260,162,1,10
384,R,114,H R 5485,7-Jul-2016,5:34 PM,On Agreeing to the Amendment,None,Agreed to,235,7,0,4,1,181,0,5,0,0,0,0,236,188,0,9
385,R,114,H R 5485,7-Jul-2016,5:37 PM,On Agreeing to the Amendment,None,Agreed to,236,4,0,6,0,181,0,6,0,0,0,0,236,185,0,12
386,R,114,H R 5485,7-Jul-2016,5:41 PM,On Agreeing to the Amendment,None,Failed,192,50,0,4,0,182,0,5,0,0,0,0,192,232,0,9
387,R,114,H RES 809,7-Jul-2016,5:49 PM,On Ordering the Previous Question,"Providing for consideration of the conference report to accompany S. 524, to authorize the Attorney General to award grants to address the national epidemics of prescription opiod abuse and heroin use; and for other purposes.",Passed,242,0,0,4,2,179,0,6,0,0,0,0,244,179,0,10
388,R,114,H RES 809,7-Jul-2016,5:55 PM,On Agreeing to the Resolution,"Providing for consideration of the conference report to accompany S. 524, to authorize the Attorney General to award grants to address the national epidemics of prescription opiod abuse and heroin use; and for other purposes.",Passed,239,3,0,4,4,174,0,9,0,0,0,0,243,177,0,13
389,R,114,H R 5485,7-Jul-2016,8:23 PM,On Agreeing to the Amendment,None,Agreed to,235,0,0,11,0,179,0,8,0,0,0,0,235,179,0,19
390,R,114,H R 5485,7-Jul-2016,8:27 PM,On Agreeing to the Amendment,None,Agreed to,221,14,0,11,2,178,0,7,0,0,0,0,223,192,0,18
391,R,114,H R 5485,7-Jul-2016,8:31 PM,On Agreeing to the Amendment,None,Agreed to,238,0,0,8,2,179,0,6,0,0,0,0,240,179,0,14
392,R,114,H R 5485,7-Jul-2016,8:34 PM,On Agreeing to the Amendment,None,Agreed to,230,12,0,4,0,181,0,6,0,0,0,0,230,193,0,10
393,R,114,H R 5485,7-Jul-2016,8:38 PM,On Agreeing to the Amendment,None,Failed,25,217,0,4,106,75,0,6,0,0,0,0,131,292,0,10
394,R,114,H R 5485,7-Jul-2016,8:42 PM,On Agreeing to the Amendment,None,Failed,11,231,0,4,178,1,0,8,0,0,0,0,189,232,0,12
395,R,114,H R 5485,7-Jul-2016,8:47 PM,On Agreeing to the Amendment,None,Agreed to,228,14,0,4,181,0,0,6,0,0,0,0,409,14,0,10
396,R,114,H R 5485,7-Jul-2016,8:50 PM,On Agreeing to the Amendment,None,Agreed to,241,0,0,5,1,179,0,7,0,0,0,0,242,179,0,12
397,R,114,H R 5485,7-Jul-2016,9:09 PM,On Motion to Recommit with Instructions,"Making appropriations for financial services and general government for fiscal year ending September 30, 2017, and for other purposes",Failed,2,240,0,4,181,1,0,5,0,0,0,0,183,241,0,9
398,R,114,H R 5485,7-Jul-2016,9:15 PM,On Passage,"Making appropriations for financial services and general government for fiscal year ending September 30, 2017, and for other purposes",Passed,235,7,0,4,4,178,0,5,0,0,0,0,239,185,0,9
399,R,114,S 524,8-Jul-2016,11:57 AM,On Agreeing to the Conference Report,Comprehensive Addiction and Recovery Act of 2016,Passed,233,5,0,8,174,0,0,13,0,0,0,0,407,5,0,21
400,R,114,S 2943,8-Jul-2016,12:08 PM,On Closing Portions of the Conference,National Defense Authorization Act for Fiscal Year 2017,Passed,232,3,0,11,165,11,0,11,0,0,0,0,397,14,0,22
401,R,114,H R 5602,11-Jul-2016,6:53 PM,On Motion to Suspend the Rules and Pass,"To amend title 31, United States Code, to authorize the Secretary of the Treasury to include all funds when issuing certain geographic targeting orders, and for other purposes",Passed,187,46,0,13,169,1,0,17,0,0,0,0,356,47,0,30
402,R,114,H R 5607,11-Jul-2016,7:01 PM,"On Motion to Suspend the Rules and Pass, as Amended",Enhancing Treasury’s Anti-Terror Tools Act,Passed,191,43,0,12,171,2,0,14,0,0,0,0,362,45,0,26
403,R,114,H R 5606,11-Jul-2016,7:08 PM,On Motion to Suspend the Rules and Pass,Anti-terrorism Information Sharing Is Strength Act,Failed,147,86,0,13,82,91,0,14,0,0,0,0,229,177,0,27
404,R,114,ADJOURN,12-Jul-2016,12:44 PM,On Motion to Adjourn,None,Failed,0,220,0,26,0,157,1,29,0,0,0,0,0,377,1,55
405,R,114,ADJOURN,12-Jul-2016,1:43 PM,On Motion to Adjourn,None,Failed,0,208,0,38,0,154,1,32,0,0,0,0,0,362,1,70
406,R,114,H RES 820,12-Jul-2016,3:10 PM,On Ordering the Previous Question,"Providing for consideration of H.R. 5538, making appropriations for the Department of the Interior, environment, and related agencies for the fiscal year ending September 30, 2017, and for other purposes; providing for proceedings during the period from July 15, 2016, through September 5, 2016; and for other purposes",Passed,235,0,0,11,1,174,0,12,0,0,0,0,236,174,0,23
407,R,114,H RES 820,12-Jul-2016,3:23 PM,On Agreeing to the Resolution,"Providing for consideration of H.R. 5538, making appropriations for the Department of the Interior, environment, and related agencies for the fiscal year ending September 30, 2017, and for other purposes; providing for proceedings during the period from July 15, 2016, through September 5, 2016; and for other purposes",Passed,236,3,0,7,1,176,0,10,0,0,0,0,237,179,0,17
408,R,114,H RES 819,12-Jul-2016,3:30 PM,On Ordering the Previous Question,"Providing for consideration of H.R. 4992, the United States Financial System Protection Act of 2016; H.R. 5119, the No 2H2O from Iran Act; and H.R. 5631, the Iran Accountability Act of 2016",Passed,240,0,0,6,1,174,0,12,0,0,0,0,241,174,0,18
409,R,114,H RES 819,12-Jul-2016,3:36 PM,On Agreeing to the Resolution,"Providing for consideration of H.R. 4992, the United States Financial System Protection Act of 2016; H.R. 5119, the No 2H2O from Iran Act; and H.R. 5631, the Iran Accountability Act of 2016",Passed,237,0,0,9,0,172,0,15,0,0,0,0,237,172,0,24
410,R,114,H R 5658,12-Jul-2016,3:42 PM,On Motion to Suspend the Rules and Pass,TALENT Act of 2016,Passed,232,8,0,6,177,0,0,10,0,0,0,0,409,8,0,16
411,R,114,H R 4768,12-Jul-2016,3:48 PM,On Agreeing to the Amendment,None,Failed,19,221,0,6,175,2,0,10,0,0,0,0,194,223,0,16
412,R,114,H R 4768,12-Jul-2016,3:52 PM,On Agreeing to the Amendment,None,Failed,0,240,0,6,174,3,0,10,0,0,0,0,174,243,0,16
413,R,114,H R 4768,12-Jul-2016,3:56 PM,On Agreeing to the Amendment,None,Failed,1,239,0,6,173,4,0,10,0,0,0,0,174,243,0,16
414,R,114,H R 4768,12-Jul-2016,4:00 PM,On Agreeing to the Amendment,None,Failed,6,233,0,7,175,2,0,10,0,0,0,0,181,235,0,17
415,R,114,H R 4768,12-Jul-2016,4:18 PM,On Motion to Recommit with Instructions,Separation of Powers Restoration Act,Failed,0,235,0,11,169,1,0,17,0,0,0,0,169,236,0,28
416,R,114,H R 4768,12-Jul-2016,4:30 PM,On Passage,Separation of Powers Restoration Act,Passed,239,0,0,7,1,171,0,15,0,0,0,0,240,171,0,22
417,R,114,H R 5538,12-Jul-2016,10:29 PM,On Agreeing to the Amendment,None,Failed,16,223,0,7,181,2,0,4,0,0,0,0,197,225,0,11
418,R,114,H R 5538,12-Jul-2016,10:33 PM,On Agreeing to the Amendment,None,Failed,9,232,0,5,174,9,0,4,0,0,0,0,183,241,0,9
419,R,114,H R 5538,12-Jul-2016,10:36 PM,On Agreeing to the Amendment,None,Failed,0,241,0,5,173,10,0,4,0,0,0,0,173,251,0,9
420,R,114,H R 5538,12-Jul-2016,10:39 PM,On Agreeing to the Amendment,None,Failed,16,225,0,5,127,57,0,3,0,0,0,0,143,282,0,8
421,R,114,H R 5538,12-Jul-2016,10:42 PM,On Agreeing to the Amendment,None,Failed,10,231,0,5,180,4,0,3,0,0,0,0,190,235,0,8
422,R,114,H R 5538,12-Jul-2016,10:45 PM,On Agreeing to the Amendment,None,Failed,7,234,0,5,177,6,0,4,0,0,0,0,184,240,0,9
423,R,114,H R 5538,12-Jul-2016,10:49 PM,On Agreeing to the Amendment,None,Failed,10,229,0,7,176,8,0,3,0,0,0,0,186,237,0,10
424,R,114,H R 5538,12-Jul-2016,10:52 PM,On Agreeing to the Amendment,None,Failed,4,237,0,5,177,7,0,3,0,0,0,0,181,244,0,8
425,R,114,H R 5538,12-Jul-2016,10:55 PM,On Agreeing to the Amendment,None,Failed,208,33,0,5,0,184,0,3,0,0,0,0,208,217,0,8
426,R,114,H R 5538,12-Jul-2016,10:58 PM,On Agreeing to the Amendment,None,Failed,174,67,0,5,1,183,0,3,0,0,0,0,175,250,0,8
427,R,114,H R 5538,12-Jul-2016,11:02 PM,On Agreeing to the Amendment,None,Agreed to,35,207,0,4,184,0,0,3,0,0,0,0,219,207,0,7
428,R,114,H R 5538,12-Jul-2016,11:05 PM,On Agreeing to the Amendment,None,Failed,1,241,0,4,169,15,0,3,0,0,0,0,170,256,0,7
429,R,114,H R 5538,12-Jul-2016,11:08 PM,On Agreeing to the Amendment,None,Failed,13,229,0,4,182,2,0,3,0,0,0,0,195,231,0,7
430,R,114,H R 5538,12-Jul-2016,11:11 PM,On Agreeing to the Amendment,None,Failed,6,236,0,4,184,0,0,3,0,0,0,0,190,236,0,7
431,R,114,H R 5538,12-Jul-2016,11:14 PM,On Agreeing to the Amendment,None,Failed,5,237,0,4,177,7,0,3,0,0,0,0,182,244,0,7
432,R,114,H R 5538,12-Jul-2016,11:17 PM,On Agreeing to the Amendment,None,Failed,5,237,0,4,180,4,0,3,0,0,0,0,185,241,0,7
433,R,114,H R 5538,13-Jul-2016,2:07 PM,On Agreeing to the Amendment,None,Failed,1,241,0,4,176,8,0,3,0,0,0,0,177,249,0,7
434,R,114,H R 5538,13-Jul-2016,2:11 PM,On Agreeing to the Amendment,None,Failed,8,235,0,3,179,5,0,3,0,0,0,0,187,240,0,6
435,R,114,H R 5538,13-Jul-2016,2:16 PM,On Agreeing to the Amendment,None,Failed,6,238,0,2,177,8,0,2,0,0,0,0,183,246,0,4
436,R,114,H R 5538,13-Jul-2016,2:20 PM,On Agreeing to the Amendments,None,Failed,0,244,0,2,181,4,0,2,0,0,0,0,181,248,0,4
437,R,114,H R 5538,13-Jul-2016,2:23 PM,On Agreeing to the Amendment,None,Failed,19,223,0,4,183,2,0,2,0,0,0,0,202,225,0,6
438,R,114,H R 5538,13-Jul-2016,2:27 PM,On Agreeing to the Amendment,None,Failed,169,75,0,2,2,183,0,2,0,0,0,0,171,258,0,4
439,R,114,H RES 822,13-Jul-2016,2:35 PM,On Ordering the Previous Question,"Providing for consideration of the Senate amendment to the House amendment to S. 764, a bill to reauthorize and amend the National Sea Grant College Program Act; providing for consideration of S. 304, the Motor Vehicle Safety Whistleblower Act; waiving a requirement of clause 6(a) of rule XIII",Passed,244,0,0,2,1,183,0,3,0,0,0,0,245,183,0,5
440,R,114,H RES 822,13-Jul-2016,2:43 PM,On Agreeing to the Resolution,"Providing for consideration of the Senate amendment to the House amendment to S. 764, a bill to reauthorize and amend the National Sea Grant College Program Act; providing for consideration of S. 304, the Motor Vehicle Safety Whistleblower Act; waiving a requirement of clause 6(a) of rule XIII",Passed,241,2,0,3,1,183,0,3,0,0,0,0,242,185,0,6
441,R,114,H R 5119,13-Jul-2016,5:31 PM,On Passage,No 2H20 from Iran Act,Passed,239,2,0,5,10,174,0,3,0,0,0,0,249,176,0,8
442,R,114,S 304,13-Jul-2016,5:41 PM,On Motion to Recommit with Instructions,Motor Vehicle Safety Whistleblower Act,Failed,0,242,0,4,182,2,0,3,0,0,0,0,182,244,0,7
443,R,114,S 304,13-Jul-2016,5:48 PM,On Passage,Motor Vehicle Safety Whistleblower Act,Passed,242,1,0,3,3,181,0,3,0,0,0,0,245,182,0,6
444,R,114,H R 5538,13-Jul-2016,5:53 PM,On Agreeing to the Amendment,None,Agreed to,224,20,0,2,10,175,0,2,0,0,0,0,234,195,0,4
445,R,114,H R 5538,13-Jul-2016,5:56 PM,On Agreeing to the Amendment,None,Agreed to,236,6,0,4,1,183,0,3,0,0,0,0,237,189,0,7
446,R,114,H R 5538,13-Jul-2016,6:00 PM,On Agreeing to the Amendment,None,Agreed to,227,16,0,3,4,181,0,2,0,0,0,0,231,197,0,5
447,R,114,H R 5538,13-Jul-2016,6:02 PM,On Agreeing to the Amendment,None,Failed,22,221,0,3,163,22,0,2,0,0,0,0,185,243,0,5
448,R,114,H R 5538,13-Jul-2016,6:05 PM,On Agreeing to the Amendment,None,Failed,188,54,0,4,0,184,0,3,0,0,0,0,188,238,0,7
449,R,114,H R 5538,13-Jul-2016,6:09 PM,On Agreeing to the Amendment,None,Agreed to,233,10,0,3,5,180,0,2,0,0,0,0,238,190,0,5
450,R,114,H R 5538,13-Jul-2016,6:11 PM,On Agreeing to the Amendment,None,Agreed to,226,16,0,4,2,183,0,2,0,0,0,0,228,199,0,6
451,R,114,H R 5538,13-Jul-2016,6:14 PM,On Agreeing to the Amendment,None,Failed,24,219,0,3,173,12,0,2,0,0,0,0,197,231,0,5
452,R,114,H R 5538,13-Jul-2016,6:17 PM,On Agreeing to the Amendment,None,Agreed to,218,21,0,7,5,180,0,2,0,0,0,0,223,201,0,9
453,R,114,H R 5538,13-Jul-2016,9:41 PM,On Agreeing to the Amendment,None,Failed,194,46,0,6,1,177,0,9,0,0,0,0,195,223,0,15
454,R,114,H R 5538,13-Jul-2016,9:44 PM,On Agreeing to the Amendment,None,Agreed to,215,26,0,5,4,177,0,6,0,0,0,0,219,203,0,11
455,R,114,H R 5538,13-Jul-2016,9:47 PM,On Agreeing to the Amendment,None,Failed,161,79,0,6,0,183,0,4,0,0,0,0,161,262,0,10
456,R,114,H R 5538,13-Jul-2016,9:50 PM,On Agreeing to the Amendment,None,Failed,186,56,0,4,2,183,0,2,0,0,0,0,188,239,0,6
457,R,114,H R 5538,13-Jul-2016,9:53 PM,On Agreeing to the Amendment,None,Agreed to,231,12,0,3,0,185,0,2,0,0,0,0,231,197,0,5
458,R,114,H R 5538,13-Jul-2016,9:57 PM,On Agreeing to the Amendment,None,Failed,170,72,0,4,0,185,0,2,0,0,0,0,170,257,0,6
459,R,114,H R 5538,13-Jul-2016,10:00 PM,On Agreeing to the Amendment,None,Agreed to,225,18,0,3,1,184,0,2,0,0,0,0,226,202,0,5
460,R,114,H R 5538,13-Jul-2016,10:03 PM,On Agreeing to the Amendment,None,Agreed to,231,12,0,3,6,179,0,2,0,0,0,0,237,191,0,5
461,R,114,H R 5538,13-Jul-2016,10:07 PM,On Agreeing to the Amendment,None,Agreed to,235,8,0,3,7,177,0,3,0,0,0,0,242,185,0,6
462,R,114,H R 5538,13-Jul-2016,10:10 PM,On Agreeing to the Amendment,None,Agreed to,225,18,0,3,0,184,0,3,0,0,0,0,225,202,0,6
463,R,114,H R 5538,13-Jul-2016,10:13 PM,On Agreeing to the Amendment,None,Failed,13,230,0,3,180,5,0,2,0,0,0,0,193,235,0,5
464,R,114,H R 5538,13-Jul-2016,10:18 PM,On Agreeing to the Amendment,None,Failed,12,231,0,3,182,3,0,2,0,0,0,0,194,234,0,5
465,R,114,H R 5538,13-Jul-2016,10:22 PM,On Agreeing to the Amendment,None,Failed,15,228,0,3,177,8,0,2,0,0,0,0,192,236,0,5
466,R,114,S 764,14-Jul-2016,12:56 PM,On Motion to Concur in the Senate Amendment to the House Amendment,"An Act to reauthorize and amend the National Sea Grant College Program Act, and for other purposes",Passed,205,36,0,5,101,81,0,5,0,0,0,0,306,117,0,10
467,R,114,H R 5631,14-Jul-2016,1:03 PM,On Passage,Iran Accountability Act of 2016,Passed,238,4,0,4,8,175,0,4,0,0,0,0,246,179,0,8
468,R,114,H R 5538,14-Jul-2016,1:10 PM,On Agreeing to the Amendment,None,Failed,4,237,0,5,174,9,0,4,0,0,0,0,178,246,0,9
469,R,114,H R 5538,14-Jul-2016,1:13 PM,On Agreeing to the Amendment,None,Failed,4,239,0,3,168,15,0,4,0,0,0,0,172,254,0,7
470,R,114,H R 5538,14-Jul-2016,1:17 PM,On Agreeing to the Amendment,None,Failed,11,232,0,3,183,1,0,3,0,0,0,0,194,233,0,6
471,R,114,H R 5538,14-Jul-2016,1:20 PM,On Agreeing to the Amendment,None,Failed,11,230,0,5,181,3,0,3,0,0,0,0,192,233,0,8
472,R,114,H R 5538,14-Jul-2016,1:23 PM,On Agreeing to the Amendment,None,Failed,10,233,0,3,181,3,0,3,0,0,0,0,191,236,0,6
473,R,114,H R 5538,14-Jul-2016,1:27 PM,On Agreeing to the Amendment,None,Failed,6,237,0,3,182,2,0,3,0,0,0,0,188,239,0,6
474,R,114,H R 5538,14-Jul-2016,1:30 PM,On Agreeing to the Amendment,None,Failed,8,235,0,3,176,6,0,5,0,0,0,0,184,241,0,8
475,R,114,H R 5538,14-Jul-2016,1:35 PM,On Agreeing to the Amendment,None,Failed,16,227,0,3,179,5,0,3,0,0,0,0,195,232,0,6
476,R,114,H R 5538,14-Jul-2016,1:41 PM,On Agreeing to the Amendment,None,Failed,33,210,0,3,180,4,0,3,0,0,0,0,213,214,0,6
477,R,114,H R 5538,14-Jul-2016,1:50 PM,On Passage,"Making appropriations for the Department of the Interior, environment, and related agencies for the fiscal year ending September 30, 2017, and for other purposes",Passed,228,15,0,3,3,181,0,3,0,0,0,0,231,196,0,6
478,R,114,H R 4992,14-Jul-2016,1:57 PM,On Passage,"To codify regulations relating to transfers of funds involving Iran, and for other purposes",Passed,240,3,0,3,6,178,0,3,0,0,0,0,246,181,0,6
479,R,114,H R 5578,6-Sep-2016,6:51 PM,On Motion to Suspend the Rules and Pass,Survivors’ Bill of Rights Act of 2016,Passed,230,0,0,15,169,0,0,17,0,0,0,0,399,0,0,32
480,R,114,H R 3881,6-Sep-2016,7:03 PM,"On Motion to Suspend the Rules and Pass, as Amended",Cooperative Managment of Mineral Rights Act of 2016,Passed,229,0,0,16,166,3,0,17,0,0,0,0,395,3,0,33
481,R,114,H RES 843,7-Sep-2016,1:46 PM,On Ordering the Previous Question,"Providing for consideration of H. R. 5063, the Stop Settlement Slush Funds Act of 2016",Passed,230,0,0,15,1,177,0,8,0,0,0,0,231,177,0,23
482,R,114,H RES 843,7-Sep-2016,1:55 PM,On Agreeing to the Resolution,"Providing for consideration of H. R. 5063, the Stop Settlement Slush Funds Act of 2016",Passed,231,0,0,14,0,178,0,8,0,0,0,0,231,178,0,22
483,R,114,H R 5063,7-Sep-2016,3:58 PM,On Agreeing to the Amendment,None,Failed,2,230,0,13,176,4,0,6,0,0,0,0,178,234,0,19
484,R,114,H R 5063,7-Sep-2016,4:03 PM,On Agreeing to the Amendment,None,Failed,2,230,0,13,173,6,0,7,0,0,0,0,175,236,0,20
485,R,114,H R 5063,7-Sep-2016,4:08 PM,On Agreeing to the Amendment,None,Failed,2,232,0,11,176,3,0,7,0,0,0,0,178,235,0,18
486,R,114,H R 5063,7-Sep-2016,4:12 PM,On Agreeing to the Amendment,None,Failed,154,83,0,8,1,179,0,6,0,0,0,0,155,262,0,14
487,R,114,H R 5063,7-Sep-2016,4:27 PM,On Motion to Recommit with Instructions,Stop Settlement Slush Funds Act of 2016,Failed,3,232,0,10,178,2,0,6,0,0,0,0,181,234,0,16
488,R,114,H R 5063,7-Sep-2016,4:35 PM,On Passage,Stop Settlement Slush Funds Act of 2016,Passed,236,0,0,9,5,174,0,7,0,0,0,0,241,174,0,16
489,R,114,H RES 844,8-Sep-2016,2:05 PM,On Ordering the Previous Question,"Providing for consideration of H.R. 2357, Accelerating Access to Capital Act of 2015; and providing for consideration of H.R. 5424, Investment Advisers Modernization Act of 2016",Passed,237,0,0,8,1,180,0,5,0,0,0,0,238,180,0,13
490,R,114,H RES 844,8-Sep-2016,2:12 PM,On Agreeing to the Resolution,"Providing for consideration of H.R. 2357, Accelerating Access to Capital Act of 2015; and providing for consideration of H.R. 5424, Investment Advisers Modernization Act of 2016",Passed,236,0,0,9,1,181,0,4,0,0,0,0,237,181,0,13
491,R,114,H RES 660,8-Sep-2016,2:19 PM,On Motion to Suspend the Rules and Agree,Expressing the sense of the House of Representatives to support the territorial intergrity of Georgia,Passed,228,6,0,11,182,0,0,4,0,0,0,0,410,6,0,15
492,R,114,H R 2357,8-Sep-2016,4:08 PM,On Motion to Recommit with Instructions,Accelerating Access to Capital Act of 2016,Failed,0,233,0,12,180,0,0,6,0,0,0,0,180,233,0,18
493,R,114,H R 2357,8-Sep-2016,4:16 PM,On Passage,Accelerating Access to Capital Act of 2016,Passed,234,1,0,10,2,177,0,7,0,0,0,0,236,178,0,17
494,R,114,H R 5424,9-Sep-2016,12:03 PM,On Motion to Recommit with Instructions,Investment Advisers Modernization Act of 2016,Failed,0,231,0,14,176,1,0,9,0,0,0,0,176,232,0,23
495,R,114,H R 5424,9-Sep-2016,12:09 PM,On Passage,Investment Advisers Modernization Act of 2016,Passed,226,3,0,16,35,142,0,9,0,0,0,0,261,145,0,25
496,R,114,H RES 847,12-Sep-2016,6:53 PM,On Motion to Suspend the Rules and Agree,Expressing the sense of the House of Representatives about a national strategy for the Internet of Things to promote economic growth and consumer empowerment,Passed,222,4,1,18,145,0,0,41,0,0,0,0,367,4,1,59
497,R,114,H RES 835,12-Sep-2016,7:04 PM,On Motion to Suspend the Rules and Agree,Expressing the sense of the House of Representatives that the United States should adopt a national policy for technology to promote consumers’ access to financial tools and online commerce to promote economic growth and consumer empowerment,Passed,221,4,1,19,164,0,0,22,0,0,0,0,385,4,1,41
498,R,114,H RES 859,13-Sep-2016,2:19 PM,On Ordering the Previous Question,"Providing for consideration of H.R. 5620, the VA Accountability First and Appeals Modernization Act of 2016",Passed,237,0,0,8,0,170,0,16,0,0,0,0,237,170,0,24
499,R,114,H RES 859,13-Sep-2016,2:26 PM,On Agreeing to the Resolution,"Providing for consideration of H.R. 5620, the VA Accountability First and Appeals Modernization Act of 2016",Passed,238,0,0,7,3,169,0,14,0,0,0,0,241,169,0,21
500,R,114,H RES 858,13-Sep-2016,2:32 PM,On Ordering the Previous Question,"Providing for consideration of H.R. 3590, to amend the Internal Revenue Code of 1986 to repeal the increase in the income threshold used in determining the deduction for medical care",Passed,237,0,0,8,0,171,0,15,0,0,0,0,237,171,0,23
501,R,114,H RES 858,13-Sep-2016,2:38 PM,On Agreeing to the Resolution,"Providing for consideration of H.R. 3590, to amend the Internal Revenue Code of 1986 to repeal the increase in the income threshold used in determining the deduction for medical care",Passed,238,0,0,7,1,169,0,16,0,0,0,0,239,169,0,23
502,R,114,H R 3590,13-Sep-2016,4:48 PM,On Passage,Halt Tax Increases on the Middle Class and Seniors Act,Passed,236,2,0,7,25,145,0,16,0,0,0,0,261,147,0,23
503,R,114,H R 5587,13-Sep-2016,4:55 PM,"On Motion to Suspend the Rules and Pass, as Amended",Strengthening Career and Technical Education for the 21st Century Act,Passed,234,5,0,6,171,0,0,15,0,0,0,0,405,5,0,21
504,R,114,H RES 729,13-Sep-2016,5:03 PM,On Motion to Suspend the Rules and Agree,"Expressing support for the expeditious consideration and finalization of a new, robust, and long-term Memorandum of Understanding on military assistance to Israel between the United States Government and the Government of Israel",Passed,234,4,0,7,171,0,0,15,0,0,0,0,405,4,0,22
505,R,114,H RES 863,14-Sep-2016,2:03 PM,On Ordering the Previous Question,"Providing for consideration of the bill (H.R. 5351) to prohibit the transfer of any individual detained at United States Naval Station, Guantanamo Bay, Cuba, and providing for consideration of the bill (H.R. 5226) Regulatory Integrity Act",Passed,231,0,0,14,1,172,0,13,0,0,0,0,232,172,0,27
506,R,114,H RES 863,14-Sep-2016,2:10 PM,On Agreeing to the Resolution,"Providing for consideration of the bill (H.R. 5351) to prohibit the transfer of any individual detained at United States Naval Station, Guantanamo Bay, Cuba, and providing for consideration of the bill (H.R. 5226) Regulatory Integrity Act",Passed,238,0,0,7,0,171,0,15,0,0,0,0,238,171,0,22
507,R,114,JOURNAL,14-Sep-2016,2:16 PM,On Approving the Journal,None,Passed,159,75,1,10,93,70,1,22,0,0,0,0,252,145,2,32
508,R,114,H R 5226,14-Sep-2016,4:54 PM,On Agreeing to the Amendment,None,Agreed to,228,0,0,17,13,154,0,19,0,0,0,0,241,154,0,36
509,R,114,H R 5226,14-Sep-2016,5:15 PM,On Motion to Recommit with Instructions,Regulatory Integrity Act of 2016,Failed,2,238,0,5,183,0,0,3,0,0,0,0,185,238,0,8
510,R,114,H R 5226,14-Sep-2016,5:21 PM,On Passage,Regulatory Integrity Act of 2016,Passed,240,0,0,5,10,171,0,5,0,0,0,0,250,171,0,10
511,R,114,H R 5620,14-Sep-2016,5:27 PM,On Agreeing to the Amendment,None,Failed,0,240,0,5,173,10,0,3,0,0,0,0,173,250,0,8
512,R,114,H R 5620,14-Sep-2016,5:30 PM,On Agreeing to the Amendment,None,Failed,1,238,0,6,183,2,0,1,0,0,0,0,184,240,0,7
513,R,114,H R 5620,14-Sep-2016,5:34 PM,On Agreeing to the Amendment,None,Failed,1,235,0,9,182,1,0,3,0,0,0,0,183,236,0,12
514,R,114,H R 5620,14-Sep-2016,5:38 PM,On Agreeing to the Amendment,None,Agreed to,241,0,0,4,185,0,0,1,0,0,0,0,426,0,0,5
515,R,114,H R 5620,14-Sep-2016,5:42 PM,On Agreeing to the Amendment,None,Agreed to,238,1,0,6,183,0,0,3,0,0,0,0,421,1,0,9
516,R,114,H R 5620,14-Sep-2016,5:45 PM,On Agreeing to the Amendment,None,Agreed to,239,0,0,6,182,0,0,4,0,0,0,0,421,0,0,10
517,R,114,H R 5620,14-Sep-2016,5:48 PM,On Agreeing to the Amendment,None,Agreed to,240,1,0,4,183,0,0,3,0,0,0,0,423,1,0,7
518,R,114,H R 5620,14-Sep-2016,6:04 PM,On Motion to Recommit with Instructions,VA Accountability First and Appeals Modernization Act,Failed,0,239,0,6,185,0,0,1,0,0,0,0,185,239,0,7
519,R,114,H R 5620,14-Sep-2016,6:11 PM,On Passage,VA Accountability First and Appeals Modernization Act,Passed,241,0,0,4,69,116,0,1,0,0,0,0,310,116,0,5
520,R,114,H R 5351,15-Sep-2016,10:35 AM,On Passage,"To prohibit the transfer of any individual detained at United States Naval Station, Guantanamo Bay, Cuba",Passed,232,4,0,9,12,170,0,4,0,0,0,0,244,174,0,13
521,R,114,H R 670,20-Sep-2016,6:53 PM,"On Motion to Suspend the Rules and Pass, as Amended",Special Needs Trust Fairness and Medicaid Improvement Act,Passed,212,22,0,11,171,0,0,15,0,0,0,0,383,22,0,26
522,R,114,H R 5785,20-Sep-2016,6:59 PM,On Motion to Suspend the Rules and Pass,"To amend title 5, United States Code, to provide for an annuity supplement for certain air traffic controllers",Passed,228,4,0,13,171,0,0,15,0,0,0,0,399,4,0,28
523,R,114,H R 5690,20-Sep-2016,7:11 PM,On Motion to Suspend the Rules and Pass,GAO Access and Oversight Act,Passed,234,0,0,11,170,0,0,16,0,0,0,0,404,0,0,27
524,R,114,H RES 875,21-Sep-2016,2:13 PM,On Ordering the Previous Question,"Providing for consideration of H.R. 3438, to Require Evaluation Before Implementing Executive Wishlists Act of 2015; and providing for consideration of H.R. 5719, the Empowering Employees Through Stock Ownership Act",Passed,236,0,0,9,1,171,0,14,0,0,0,0,237,171,0,23
525,R,114,H RES 875,21-Sep-2016,2:20 PM,On Agreeing to the Resolution,"Providing for consideration of H.R. 3438, to Require Evaluation Before Implementing Executive Wishlists Act of 2015; and providing for consideration of H.R. 5719, the Empowering Employees Through Stock Ownership Act",Passed,238,2,0,5,1,179,0,6,0,0,0,0,239,181,0,11
526,R,114,H RES 876,21-Sep-2016,2:26 PM,On Ordering the Previous Question,"Providing for consideration of H.R. 5461, the Iranian Leadership Asset Transparency Act",Passed,242,0,0,3,0,181,0,5,0,0,0,0,242,181,0,8
527,R,114,H RES 876,21-Sep-2016,2:33 PM,On Agreeing to the Resolution,"Providing for consideration of H.R. 5461, the Iranian Leadership Asset Transparency Act",Passed,241,0,0,4,6,174,0,6,0,0,0,0,247,174,0,10
528,R,114,H R 3957,21-Sep-2016,2:39 PM,"On Motion to Suspend the Rules and Pass, as Amended",Emergency Citrus Disease Response Act of 2016,Passed,224,15,0,6,176,5,0,5,0,0,0,0,400,20,0,11
529,R,114,H R 5659,21-Sep-2016,2:45 PM,"On Motion to Suspend the Rules and Pass, as Amended",Expanding Seniors Receiving Dialysis Choice Act of 2016,Passed,242,0,0,3,181,0,0,5,0,0,0,0,423,0,0,8
530,R,114,H R 5713,21-Sep-2016,2:52 PM,"On Motion to Suspend the Rules and Pass, as Amended",Sustaining Healthcare Integrity and Fair Treatment Act of 2016,Passed,239,3,0,3,181,0,0,5,0,0,0,0,420,3,0,8
531,R,114,H R 5613,21-Sep-2016,2:58 PM,"On Motion to Suspend the Rules and Pass, as Amended",Continuing Access to Hospitals Act of 2016,Passed,240,0,0,5,180,0,0,6,0,0,0,0,420,0,0,11
532,R,114,H R 3438,21-Sep-2016,5:42 PM,On Agreeing to the Amendment,None,Failed,8,231,0,6,181,1,0,4,0,0,0,0,189,232,0,10
533,R,114,H R 3438,21-Sep-2016,5:46 PM,On Agreeing to the Amendment,None,Failed,6,235,0,4,178,2,0,6,0,0,0,0,184,237,0,10
534,R,114,H R 3438,21-Sep-2016,6:04 PM,On Motion to Recommit with Instructions,REVIEW Act of 2016,Failed,0,239,0,6,182,1,0,3,0,0,0,0,182,240,0,9
535,R,114,H R 3438,21-Sep-2016,6:11 PM,On Passage,REVIEW Act of 2016,Passed,240,1,0,4,4,179,0,3,0,0,0,0,244,180,0,7
536,R,114,H R 5461,21-Sep-2016,6:18 PM,On Passage,Iranian Leadership Asset Transparency Act,Passed,240,2,0,3,42,141,0,3,0,0,0,0,282,143,0,6
537,R,114,H R 5859,21-Sep-2016,6:26 PM,"On Motion to Suspend the Rules and Pass, as Amended",Community Counter-terrorism Preparedness Act,Passed,212,30,0,3,183,0,0,3,0,0,0,0,395,30,0,6
538,R,114,H R 6007,21-Sep-2016,6:32 PM,On Motion to Suspend the Rules and Pass,"To amend title 49, United States Code, to include consideration of certain impacts on commercial space launch and reentry activities in a navigable airspace analysis, and for other purposes",Passed,242,0,0,3,183,0,0,3,0,0,0,0,425,0,0,6
539,R,114,H R 5977,21-Sep-2016,6:39 PM,On Motion to Suspend the Rules and Pass,"To direct the Secretary of Transportation to provide to the appropriate committees of Congress advance notice of certain announcements, and for other purposes",Passed,241,1,0,3,183,0,0,3,0,0,0,0,424,1,0,6
540,R,114,H R 6014,21-Sep-2016,6:45 PM,"On Motion to Suspend the Rules and Pass, as Amended",To allow the Administrator of the Federal Aviation Administration to enter into reimbursable agreements for certain airport projects,Passed,242,0,0,3,183,0,0,3,0,0,0,0,425,0,0,6
541,R,114,H R 5147,21-Sep-2016,6:51 PM,"On Motion to Suspend the Rules and Pass, as Amended",Bathrooms Accessible in Every Situation (BABIES) Act,Passed,208,34,0,3,181,0,0,5,0,0,0,0,389,34,0,8
542,R,114,H RES 879,22-Sep-2016,4:48 PM,On Ordering the Previous Question,"Providing for consideration of H.R. 5931, Prohibiting Future Ransom Payments to Iran Act",Passed,236,0,0,9,0,175,0,11,0,0,0,0,236,175,0,20
543,R,114,H RES 879,22-Sep-2016,4:56 PM,On Agreeing to the Resolution,"Providing for consideration of H.R. 5931, Prohibiting Future Ransom Payments to Iran Act",Passed,235,2,0,8,1,176,0,9,0,0,0,0,236,178,0,17
544,R,114,H R 5719,22-Sep-2016,5:02 PM,On Passage,Empowering Employees through Stock Ownership Act,Passed,232,1,0,12,55,123,0,8,0,0,0,0,287,124,0,20
545,R,114,H R 5320,22-Sep-2016,5:10 PM,"On Motion to Suspend the Rules and Pass, as Amended",Social Security Must Avert Identity Loss Act of 2016,Passed,237,0,0,8,177,0,0,9,0,0,0,0,414,0,0,17
546,R,114,H R 5946,22-Sep-2016,5:17 PM,"On Motion to Suspend the Rules and Pass, as Amended",United States Appreciation for Olympians and Paralympians Act of 2016,Passed,238,0,0,7,177,1,0,8,0,0,0,0,415,1,0,15
547,R,114,H R 2285,22-Sep-2016,5:23 PM,"On Motion to Suspend the Rules and Pass, as Amended",Prevent Trafficking in Cultural Property Act,Passed,237,0,0,8,178,0,0,8,0,0,0,0,415,0,0,16
548,R,114,H R 5523,22-Sep-2016,5:30 PM,"On Motion to Suspend the Rules and Pass, as Amended",Clyde-Hirsch-Sowers RESPECT Act,Passed,238,0,0,7,177,0,0,9,0,0,0,0,415,0,0,16
549,R,114,H R 5625,22-Sep-2016,5:37 PM,"On Motion to Suspend the Rules and Pass, as Amended",Modernizing Government Travel Act,Passed,238,0,0,7,177,0,0,9,0,0,0,0,415,0,0,16
550,R,114,S 1550,22-Sep-2016,5:43 PM,"On Motion to Suspend the Rules and Pass, as Amended",Program Management Improvement Accountability Act,Passed,227,11,0,7,177,0,0,9,0,0,0,0,404,11,0,16
551,R,114,H R 4419,22-Sep-2016,5:49 PM,"On Motion to Suspend the Rules and Pass, as Amended",District of Columbia Judicial Financial Transparency Act,Passed,238,0,0,7,176,0,0,10,0,0,0,0,414,0,0,17
552,R,114,H R 5963,22-Sep-2016,5:55 PM,"On Motion to Suspend the Rules and Pass, as Amended",To reauthorize and improve the Juvenile Justice and Delinquency Prevention Act,Passed,207,29,0,9,175,0,0,11,0,0,0,0,382,29,0,20
553,R,114,H R 5931,22-Sep-2016,9:11 PM,On Agreeing to the Amendment,None,Failed,5,232,0,8,171,6,0,9,0,0,0,0,176,238,0,17
554,R,114,H R 5931,22-Sep-2016,9:19 PM,On Passage,"To provide for the prohibition on cash payments to the Government of Iran, and for other purposes",Passed,238,1,0,6,16,162,0,8,0,0,0,0,254,163,0,14
555,R,114,H R 5037,22-Sep-2016,9:26 PM,"On Motion to Suspend the Rules and Pass, as Amended",District of Columbia Courts and Public Defender Service Voluntary Separation Incentive Payments Act,Passed,236,1,0,8,177,0,0,9,0,0,0,0,413,1,0,17
556,R,114,H R 5798,22-Sep-2016,9:32 PM,On Motion to Suspend the Rules and Pass,"To designate the facility of the United States Postal Service located at 1101 Davis Street in Evanston, Illinois, as the “Abner J. Mikva Post Office Building”",Passed,216,22,1,6,176,0,0,10,0,0,0,0,392,22,1,16
557,R,114,H R 3537,26-Sep-2016,6:52 PM,"On Motion to Suspend the Rules and Pass, as Amended",Dangerous Synthetic Drug Control Act,Passed,192,20,0,33,66,81,0,39,0,0,0,0,258,101,0,72
558,R,114,H R 5392,26-Sep-2016,7:00 PM,On Motion to Suspend the Rules and Pass,No Veterans Crisis Line Call Should Go Unanswered Act,Passed,211,0,0,34,146,0,0,40,0,0,0,0,357,0,0,74
559,R,114,H RES 893,27-Sep-2016,2:22 PM,On Ordering the Previous Question,"Providing for consideration of H.R. 954, the CO-OP Consumer Protection Act of 2016",Passed,242,0,0,3,2,176,0,8,0,0,0,0,244,176,0,11
560,R,114,H RES 893,27-Sep-2016,2:30 PM,On Agreeing to the Resolution,"Providing for consideration of H.R. 954, the CO-OP Consumer Protection Act of 2016",Passed,243,0,0,2,0,177,0,9,0,0,0,0,243,177,0,11
561,R,114,H RES 892,27-Sep-2016,2:37 PM,On Ordering the Previous Question,"Providing for consideration of H.R. 5303, the Water Resources Development Act of 2016; providing for consideration of motions to suspend the rules; and waiving a requirement of clause 6(a) of rule XIII with respect to consideration of certain resolutions reported from the Committee on Rules",Passed,243,0,0,2,0,178,0,8,0,0,0,0,243,178,0,10
562,R,114,H RES 892,27-Sep-2016,2:44 PM,On Agreeing to the Resolution,"Providing for consideration of H.R. 5303, the Water Resources Development Act of 2016; providing for consideration of motions to suspend the rules; and waiving a requirement of clause 6(a) of rule XIII with respect to consideration of certain resolutions reported from the Committee on Rules",Passed,241,2,0,2,0,178,0,8,0,0,0,0,241,180,0,10
563,R,114,H R 954,27-Sep-2016,4:45 PM,On Passage,CO-OP Consumer Protection Act of 2016,Passed,242,0,0,3,16,165,0,5,0,0,0,0,258,165,0,8
564,R,114,S 2040,28-Sep-2016,3:01 PM,"On Passage, The Objections of the President to the Contrary Notwithstanding",Justice Against Sponsors of Terrorism Act,Passed,225,18,0,2,123,59,1,3,0,0,0,0,348,77,1,5
565,R,114,H RES 897,28-Sep-2016,3:08 PM,On Ordering the Previous Question,"Providing for consideration of H.R. 5303, the Water Resources Development Act of 2016; and for consideration of H.R. 6094, Regulatory Relief for Small Businesses, Schools, and Nonprofits Act; providing for proceedings during the period from September 29, 2016, through November 11, 2016",Passed,242,0,0,3,0,183,0,3,0,0,0,0,242,183,0,6
566,R,114,H RES 897,28-Sep-2016,3:20 PM,On Agreeing to the Resolution,"Providing for consideration of H.R. 5303, the Water Resources Development Act of 2016; and for consideration of H.R. 6094, Regulatory Relief for Small Businesses, Schools, and Nonprofits Act; providing for proceedings during the period from September 29, 2016, through November 11, 2016",Passed,233,9,0,3,1,182,0,3,0,0,0,0,234,191,0,6
567,R,114,S 3283,28-Sep-2016,3:27 PM,On Motion to Suspend the Rules and Pass,"To designate the community-based outpatient clinic of the Department of Veterans Affairs in Pueblo, Colorado, as the “PFC James Dunn VA Clinic”",Passed,240,0,1,4,183,0,0,3,0,0,0,0,423,0,1,7
568,R,114,H R 5303,28-Sep-2016,3:33 PM,On Agreeing to the Amendment,None,Failed,190,51,0,4,0,182,0,4,0,0,0,0,190,233,0,8
569,R,114,H R 5303,28-Sep-2016,5:44 PM,On Agreeing to the Amendment,None,Agreed to,224,18,0,3,183,0,0,3,0,0,0,0,407,18,0,6
570,R,114,H R 5303,28-Sep-2016,5:55 PM,On Agreeing to the Amendment,None,Agreed to,101,141,1,2,183,0,0,3,0,0,0,0,284,141,1,5
571,R,114,H R 5303,28-Sep-2016,6:12 PM,On Motion to Recommit with Instructions,Water Resources Development Act,Failed,2,242,0,1,179,1,0,6,0,0,0,0,181,243,0,7
572,R,114,H R 5303,28-Sep-2016,6:20 PM,On Passage,Water Resources Development Act,Passed,223,21,0,1,176,4,0,6,0,0,0,0,399,25,0,7
573,R,114,H R 5325,28-Sep-2016,9:56 PM,On Agreeing to the Senate Amendment,"Making appropriations for the Legislative Branch for the fiscal year ending September 30, 2017, and for other purposes",Passed,170,75,0,1,172,10,0,4,0,0,0,0,342,85,0,5
574,R,114,H R 6094,28-Sep-2016,10:14 PM,On Passage,"Regulatory Relief for Small Businesses, Schools, and Nonprofits Act",Passed,241,0,0,4,5,177,0,4,0,0,0,0,246,177,0,8
575,R,114,H R 985,14-Nov-2016,6:51 PM,"On Motion to Suspend the Rules and Pass, as Amended","Concrete Masonry Products Research, Education, and Promotion Act of 2015",Passed,188,37,0,20,167,1,0,18,0,0,0,0,355,38,0,38
576,R,114,H R 2669,14-Nov-2016,7:20 PM,"On Motion to Suspend the Rules and Pass, as Amended",Anti-Spoofing Act of 2016,Passed,219,5,0,22,163,0,0,25,0,0,0,0,382,5,0,47
577,R,114,H R 6297,15-Nov-2016,5:07 PM,On Motion to Suspend the Rules and Pass,Iran Sanctions Extension Act,Passed,236,1,0,9,183,0,0,5,0,0,0,0,419,1,0,14
578,R,114,H RES 780,15-Nov-2016,5:15 PM,"On Motion to Suspend the Rules and Agree, as Amended",Urging respect for the constitution of the Democratic Republic of the Congo in the democratic transition of power in 2016,Passed,234,3,0,9,182,0,0,6,0,0,0,0,416,3,0,15
579,R,114,H RES 921,16-Nov-2016,5:35 PM,On Ordering the Previous Question,Consideration of the bill (H.R. 5711) to prohibit the Secretary of the Treasury from authorizing certain transactions by a U.S. financial institution in connection with the export or re-export of a commerical passenger aircraft to the Islamic Republic of Iran; consideration of (H.R. 5982) Midnight Rules Relief Act,Passed,231,0,0,15,0,181,0,7,0,0,0,0,231,181,0,22
580,R,114,H RES 921,16-Nov-2016,5:42 PM,On Agreeing to the Resolution,Consideration of the bill (H.R. 5711) to prohibit the Secretary of the Treasury from authorizing certain transactions by a U.S. financial institution in connection with the export or re-export of a commerical passenger aircraft to the Islamic Republic of Iran; consideration of (H.R. 5982) Midnight Rules Relief Act,Passed,231,0,0,15,0,181,0,7,0,0,0,0,231,181,0,22
581,R,114,H R 5982,17-Nov-2016,11:13 AM,On Agreeing to the Amendment,None,Failed,0,233,0,13,180,0,0,8,0,0,0,0,180,233,0,21
582,R,114,H R 5982,17-Nov-2016,11:20 AM,On Agreeing to the Amendment,None,Failed,0,236,0,10,179,2,0,7,0,0,0,0,179,238,0,17
583,R,114,H R 5982,17-Nov-2016,11:24 AM,On Agreeing to the Amendment,None,Failed,0,236,0,10,180,1,0,7,0,0,0,0,180,237,0,17
584,R,114,H R 5982,17-Nov-2016,11:43 AM,On Motion to Recommit with Instructions,Midnight Rules Relief Act of 2016,Failed,0,237,0,9,181,2,0,5,0,0,0,0,181,239,0,14
585,R,114,H R 5982,17-Nov-2016,11:49 AM,On Passage,Midnight Rules Relief Act of 2016,Passed,237,0,0,9,3,179,0,6,0,0,0,0,240,179,0,15
586,R,114,H R 5711,17-Nov-2016,11:55 AM,On Motion to Recommit with Instructions,To prohibit the Secretary of the Treasury from authorizing certain transactions by a U.S. financial institution in connection with the export or re-export of a commerical passenger aircraft to the Islamic Republic of Iran,Failed,0,235,0,11,181,0,0,7,0,0,0,0,181,235,0,18
587,R,114,H R 5711,17-Nov-2016,12:01 PM,On Passage,To prohibit the Secretary of the Treasury from authorizing certain transactions by a U.S. financial institution in connection with the export or re-export of a commerical passenger aircraft to the Islamic Republic of Iran,Passed,235,0,0,11,8,174,0,6,0,0,0,0,243,174,0,17
588,R,114,H R 5422,29-Nov-2016,6:53 PM,On Motion to Suspend the Rules and Pass,"To ensure funding for the National Human Trafficking Hotline, and for other purposes",Passed,223,0,0,23,176,0,0,12,0,0,0,0,399,0,0,35
589,R,114,H R 4757,29-Nov-2016,7:01 PM,"On Motion to Suspend the Rules and Pass, as Amended","To amend title 38, United States Code, to expand the eligiblity for headstones, markers, and medallions furnished by the Secretary of Veterans Affairs for deceased individuals who were awarded the Medal of Honor and are buried in private cemeteries",Passed,225,0,0,21,176,0,0,12,0,0,0,0,401,0,0,33
590,R,114,H RES 934,30-Nov-2016,1:33 PM,On Agreeing to the Resolution,"Providing for consideration of the Senate amendment to H.R. 34, the Tsunami Warning, Education, and Research Act of 2015; and providing for consideration of H.R. 6392, the Systemic Risk Designation Improvement Act of 2016",Passed,229,0,0,17,1,180,0,7,0,0,0,0,230,180,0,24
591,R,114,H R 5047,30-Nov-2016,1:40 PM,On Motion to Suspend the Rules and Pass,"To direct the Secretary of Veterans Affairs and the Secretary of Labor to provide information to veterans and members of the Armed Forces about articulation agreements between institutions of higher learning, and for other purposes",Passed,233,0,0,13,178,3,0,7,0,0,0,0,411,3,0,20
592,R,114,H R 34,30-Nov-2016,6:38 PM,On Concurring in the Senate Amendment with an Amendment,"Tsunami Warning, Education, and Research Act of 2015",Passed,218,20,0,8,174,6,0,8,0,0,0,0,392,26,0,16
593,R,114,H R 6393,30-Nov-2016,6:47 PM,On Motion to Suspend the Rules and Pass,Intelligence Authorization Act for Fiscal Year 2017,Passed,232,6,0,8,158,24,0,6,0,0,0,0,390,30,0,14
594,R,114,H RES 933,1-Dec-2016,5:35 PM,On Ordering the Previous Question,Providing amounts for further expenses of the Committee on Energy and Commerce in the One Hundred Fourteenth Congress,Passed,233,0,0,13,2,177,0,9,0,0,0,0,235,177,0,22
595,R,114,H RES 933,1-Dec-2016,5:43 PM,On Agreeing to the Resolution,Providing amounts for further expenses of the Committee on Energy and Commerce in the One Hundred Fourteenth Congress,Passed,232,2,0,12,2,179,0,7,0,0,0,0,234,181,0,19
596,R,114,H RES 937,1-Dec-2016,5:50 PM,On Ordering the Previous Question,"Providing for consideration of the conference report to accompany the bill (S. 2943) the National Defense Authorization Act for Fiscal Year 2017, and for other purposes",Passed,235,0,0,11,0,180,0,8,0,0,0,0,235,180,0,19
597,R,114,H RES 937,1-Dec-2016,5:57 PM,On Agreeing to the Resolution,"Providing for consideration of the conference report to accompany the bill (S. 2943) the National Defense Authorization Act for Fiscal Year 2017, and for other purposes",Passed,235,0,0,11,42,139,0,7,0,0,0,0,277,139,0,18
598,R,114,H R 6392,1-Dec-2016,6:05 PM,On Motion to Recommit with Instructions,Systemic Risk Designation Improvement Act,Failed,0,233,0,13,178,3,0,7,0,0,0,0,178,236,0,20
599,R,114,H R 6392,1-Dec-2016,6:15 PM,On Passage,Systemic Risk Designation Improvement Act,Passed,234,0,0,12,20,161,0,7,0,0,0,0,254,161,0,19
600,R,114,S 2943,2-Dec-2016,11:37 AM,On Agreeing to the Conference Report,National Defense Authorization Act for Fiscal Year 2017,Passed,230,4,0,12,145,30,0,13,0,0,0,0,375,34,0,25
601,R,114,H R 5015,5-Dec-2016,6:52 PM,"On Motion to Suspend the Rules and Pass, as Amended",Combat-Injured Veterans Tax Fairness Act,Passed,223,0,0,23,169,0,0,18,0,0,0,0,392,0,0,41
602,R,114,H R 6427,5-Dec-2016,7:02 PM,On Motion to Suspend the Rules and Pass,Creating Financial Prosperity for Businesses and Investors Act,Passed,222,0,0,24,169,2,0,16,0,0,0,0,391,2,0,40
603,R,114,S 1635,5-Dec-2016,7:10 PM,"On Motion to Suspend the Rules and Pass, as Amended","Department of State Authorities Act, Fiscal Year 2017",Passed,205,16,0,25,169,0,0,18,0,0,0,0,374,16,0,43
604,R,114,H R 6394,6-Dec-2016,4:30 PM,On Motion to Suspend the Rules and Pass,Improving Broadband Access for Veterans Act of 2016,Passed,233,4,0,9,178,0,0,9,0,0,0,0,411,4,0,18
605,R,114,H RES 939,6-Dec-2016,4:38 PM,On Motion to Suspend the Rules and Agree,Expressing the sense of the House of Representatives that all students should have access to the digital tools necessary to further their education and compete in the 21st century economy,Passed,235,1,0,10,179,0,0,8,0,0,0,0,414,1,0,18
606,R,114,H R 6416,6-Dec-2016,4:46 PM,On Motion to Suspend the Rules and Pass,Jeff Miller and Richard Blumenthal Veterans Health Care and Benefits Improvement Act of 2016,Passed,239,0,0,7,180,0,0,7,0,0,0,0,419,0,0,14
607,R,114,H RES 828,6-Dec-2016,5:19 PM,On Motion to Table,Raising a question of the privileges of the House,Failed,2,235,0,9,178,0,0,9,0,0,0,0,180,235,0,18
608,R,114,H RES 828,6-Dec-2016,5:40 PM,On Motion to Refer,Raising a question of the privileges of the House,Passed,166,72,0,8,176,0,0,11,0,0,0,0,342,72,0,19
609,R,114,H RES 944,7-Dec-2016,1:49 PM,On Ordering the Previous Question,"Providing for consideration of the bill (H.R. 5143) Transparent Insurance Standards Act; providing for proceedings during the period from December 9, 2016, through January 3, 2017; and providing for consideration of motions to suspend the rules",Passed,231,0,0,15,0,178,0,9,0,0,0,0,231,178,0,24
610,R,114,H RES 944,7-Dec-2016,1:57 PM,On Agreeing to the Resolution,"Providing for consideration of the bill (H.R. 5143) Transparent Insurance Standards Act; providing for proceedings during the period from December 9, 2016, through January 3, 2017; and providing for consideration of motions to suspend the rules",Passed,230,2,0,14,2,178,0,7,0,0,0,0,232,180,0,21
611,R,114,H R 1219,7-Dec-2016,2:05 PM,"On Motion to Suspend the Rules and Pass, as Amended",Arbuckle Project Maintenance Complex and District Office Conveyance Act of 2016,Passed,232,1,0,13,180,0,0,7,0,0,0,0,412,1,0,20
612,R,114,S 3028,7-Dec-2016,2:13 PM,On Motion to Suspend the Rules and Pass,Daniel J. Evans Olympic National Park Wilderness Act,Passed,223,7,2,14,178,1,0,8,0,0,0,0,401,8,2,22
613,R,114,H R 5143,7-Dec-2016,5:05 PM,On Passage,"To provide greater transparency and congressional oversight of international insurance standards setting processes, and for other purposes",Passed,235,0,0,11,4,170,0,13,0,0,0,0,239,170,0,24
614,R,114,H R 6076,7-Dec-2016,5:13 PM,"On Motion to Suspend the Rules and Pass, as Amended","To require the Administrator of the National Aeronautics and Space Administration to establish a program for the medical monitoring, diagnosis, and treatment of astronauts, and for other purposes",Passed,236,0,0,10,177,0,0,10,0,0,0,0,413,0,0,20
615,R,114,S 2971,7-Dec-2016,5:19 PM,"On Motion to Suspend the Rules and Pass, as Amended",National Urban Search and Rescue Response System Act,Passed,229,7,0,10,176,0,0,11,0,0,0,0,405,7,0,21
616,R,114,H R 5790,7-Dec-2016,5:26 PM,"On Motion to Suspend the Rules and Pass, as Amended",Federal Bureau of Investigation Whistleblower Protection Enhancement Act,Passed,233,0,0,13,171,0,0,16,0,0,0,0,404,0,0,29
617,R,114,H RES 949,8-Dec-2016,10:31 AM,On Ordering the Previous Question,"Providing for consideration of the Senate amendment to the bill (H.R. 2028) making appropriations for energy and water development and related agencies for the fiscal year ending September 30, 2016, and for other purposes, and providing for consideration of the bill (S. 612) to designate the Federal building",Passed,233,1,0,12,1,180,0,6,0,0,0,0,234,181,0,18
618,R,114,H RES 949,8-Dec-2016,10:42 AM,On Agreeing to the Resolution,"Providing for consideration of the Senate amendment to the bill (H.R. 2028) making appropriations for energy and water development and related agencies for the fiscal year ending September 30, 2016, and for other purposes, and providing for consideration of the bill (S. 612) to designate the Federal building",Passed,234,0,0,12,1,180,0,6,0,0,0,0,235,180,0,18
619,R,114,H R 4919,8-Dec-2016,10:50 AM,"On Motion to Suspend the Rules and Pass, as Amended","To amend the Violent Crime Control and Law Enforcement Act of 1994, to reauthorize the Missing Alzheimer’s Disease and Patient Alert Program, and to promote initiatives that will reduce the risk of injury and death relating to the wandering characteristics of some children with autism",Passed,167,65,0,14,179,1,0,7,0,0,0,0,346,66,0,21
620,R,114,H R 2028,8-Dec-2016,2:03 PM,On Concurring in the Senate Amendment with an Amendment,"Further Continuing and Security Assistance Appropriations Act, 2017",Passed,208,33,0,5,118,63,0,6,0,0,0,0,326,96,0,11
621,R,114,S 612,8-Dec-2016,2:10 PM,On Motion to Recommit with Instructions,"To designate the Federal building and United States courthouse located at 1300 Victoria Street in Laredo, Texas, as the “George P. Kazen Federal Building and United States Courthouse”",Failed,3,235,0,8,181,1,0,5,0,0,0,0,184,236,0,13
622,R,114,S 612,8-Dec-2016,2:19 PM,On Passage,"To designate the Federal building and United States courthouse located at 1300 Victoria Street in Laredo, Texas, as the “George P. Kazen Federal Building and United States Courthouse”",Passed,222,17,0,7,138,44,0,5,0,0,0,0,360,61,0,12
