Roll Call,Majority,Congress Num,Legislation Number,Date,Time,Question,Description,Result,Republican Yes,Republican No,Republican Present,Republican Not Voting,Democrat Yes,Democrat No,Democrat Present,Democrat Not Voting,Independent Yes,Independent No,Independent Present,Independent Not Voting,Total Yes,Total No,Total Present,Total Not Voting
1,R,115,QUORUM,3-Jan-2017,12:35 PM,Call by States,None,Passed,0,0,241,0,0,0,193,1,0,0,0,0,0,0,434,1
2,null,null,null,null,null,null,null,null,null,null,null,null,null,null,null,null,null,null,null,null,null
3,R,115,H RES 5,3-Jan-2017,3:04 PM,Table Motion to Refer,Adopting rules for the One Hundred Fifteenth Congress,Passed,228,0,0,12,0,184,0,9,0,0,0,0,228,184,0,21
4,R,115,H RES 5,3-Jan-2017,4:58 PM,On Ordering the Previous Question,Adopting rules for the One Hundred Fifteenth Congress,Passed,237,0,0,3,0,193,0,0,0,0,0,0,237,193,0,3
5,R,115,H RES 5,3-Jan-2017,5:16 PM,Motion to Commit,Adopting rules for the One Hundred Fifteenth Congress,Failed,0,236,0,4,193,0,0,0,0,0,0,0,193,236,0,4
6,R,115,H RES 5,3-Jan-2017,5:34 PM,On Agreeing to the Resolution,Adopting rules for the One Hundred Fifteenth Congress,Passed,234,3,0,3,0,190,0,3,0,0,0,0,234,193,0,6
7,R,115,H R 21,4-Jan-2017,4:38 PM,On Motion to Recommit with Instructions,Midnight Rules Relief Act of 2017,Failed,0,235,0,5,183,1,0,9,0,0,0,0,183,236,0,14
8,R,115,H R 21,4-Jan-2017,4:48 PM,On Passage,Midnight Rules Relief Act of 2017,Passed,234,0,0,6,4,184,0,5,0,0,0,0,238,184,0,11
9,R,115,H RES 22,5-Jan-2017,2:12 PM,On Ordering the Previous Question,"Providing for consideration of the bill (H.R. 26) Regulations from the Executive in Need of Scrutiny Act, and providing for consideration of the resolution (H.Res. 11) objecting to United Nations Security Council Resolution 2334 as an obstacle to Israeli-Palestinian peace, and for other purposes",Passed,234,1,0,5,1,187,0,5,0,0,0,0,235,188,0,10
10,R,115,H RES 22,5-Jan-2017,2:30 PM,On Agreeing to the Resolution,"Providing for consideration of the bill (H.R. 26) Regulations from the Executive in Need of Scrutiny Act, and providing for consideration of the resolution (H.Res. 11) objecting to United Nations Security Council Resolution 2334 as an obstacle to Israeli-Palestinian peace, and for other purposes",Passed,231,1,0,8,0,186,0,7,0,0,0,0,231,187,0,15
11,R,115,H RES 11,5-Jan-2017,7:05 PM,On Agreeing to the Resolution,"Objecting to United Nations Security Council Resolution 2334 as an obstacle to Israeli-Palestinian peace, and for other purposes",Passed,233,4,0,3,109,76,4,4,0,0,0,0,342,80,4,7
12,R,115,H R 26,5-Jan-2017,7:14 PM,On Agreeing to the Amendment,None,Agreed to,234,0,0,6,1,185,0,7,0,0,0,0,235,185,0,13
13,R,115,H R 26,5-Jan-2017,7:18 PM,On Agreeing to the Amendment,None,Failed,5,229,0,6,188,1,0,4,0,0,0,0,193,230,0,10
14,R,115,H R 26,5-Jan-2017,7:21 PM,On Agreeing to the Amendment,None,Failed,2,232,0,6,188,1,0,4,0,0,0,0,190,233,0,10
15,R,115,H R 26,5-Jan-2017,7:25 PM,On Agreeing to the Amendment,None,Failed,0,231,0,9,186,1,0,6,0,0,0,0,186,232,0,15
16,R,115,H R 26,5-Jan-2017,7:28 PM,On Agreeing to the Amendment,None,Failed,3,231,0,6,189,0,0,4,0,0,0,0,192,231,0,10
17,R,115,H R 26,5-Jan-2017,7:32 PM,On Agreeing to the Amendment,None,Failed,0,234,0,6,190,0,0,3,0,0,0,0,190,234,0,9
18,R,115,H R 26,5-Jan-2017,7:36 PM,On Agreeing to the Amendment,None,Failed,5,230,0,5,189,1,0,3,0,0,0,0,194,231,0,8
19,R,115,H R 26,5-Jan-2017,7:40 PM,On Agreeing to the Amendment,None,Failed,0,235,0,5,190,0,0,3,0,0,0,0,190,235,0,8
20,R,115,H R 26,5-Jan-2017,7:44 PM,On Agreeing to the Amendment,None,Failed,3,232,0,5,190,0,0,3,0,0,0,0,193,232,0,8
21,R,115,H R 26,5-Jan-2017,7:48 PM,On Agreeing to the Amendment,None,Agreed to,230,4,0,6,0,189,0,4,0,0,0,0,230,193,0,10
22,R,115,H R 26,5-Jan-2017,8:05 PM,On Motion to Recommit with Instructions,Regulations from the Executive in Need of Scrutiny Act of 2017,Failed,0,235,0,5,190,0,0,3,0,0,0,0,190,235,0,8
23,R,115,H R 26,5-Jan-2017,8:11 PM,On Passage,Regulations from the Executive in Need of Scrutiny Act of 2017,Passed,235,0,0,5,2,187,0,4,0,0,0,0,237,187,0,9
24,R,115,H R 315,9-Jan-2017,6:53 PM,On Motion to Suspend the Rules and Pass,Improving Access to Maternity Care Act,Passed,227,0,0,13,178,0,0,15,0,0,0,0,405,0,0,28
25,R,115,H R 304,9-Jan-2017,7:03 PM,On Motion to Suspend the Rules and Pass,Protecting Patient Access to Emergency Medications Act of 2017,Passed,225,0,0,15,179,0,0,14,0,0,0,0,404,0,0,29
26,R,115,H RES 33,10-Jan-2017,1:46 PM,On Ordering the Previous Question,Providing for consideration of the bill (H.R. 5) Regulatory Accountability Act of 2017 and providing for consideration of the bill (H.R. 79) to clarify the definition of general solicitation under Federal securities law,Passed,233,0,0,7,1,179,0,14,0,0,0,0,234,179,0,21
27,R,115,H RES 33,10-Jan-2017,1:57 PM,On Agreeing to the Resolution,Providing for consideration of the bill (H.R. 5) Regulatory Accountability Act of 2017 and providing for consideration of the bill (H.R. 79) to clarify the definition of general solicitation under Federal securities law,Passed,233,0,0,7,0,183,0,11,0,0,0,0,233,183,0,18
28,R,115,JOURNAL,10-Jan-2017,2:05 PM,On Approving the Journal,None,Passed,155,77,1,7,93,85,2,14,0,0,0,0,248,162,3,21
29,R,115,H R 79,10-Jan-2017,5:42 PM,On Agreeing to the Amendment,None,Failed,1,234,0,5,166,15,0,13,0,0,0,0,167,249,0,18
30,R,115,H R 79,10-Jan-2017,5:47 PM,On Agreeing to the Amendment,None,Failed,0,236,0,4,163,17,0,14,0,0,0,0,163,253,0,18
31,R,115,H R 79,10-Jan-2017,5:57 PM,On Passage,Helping Angels Lead Our Startups (HALOS) Act,Passed,236,0,0,4,108,73,0,13,0,0,0,0,344,73,0,17
32,R,115,H RES 40,11-Jan-2017,1:32 PM,On Ordering the Previous Question,"Providing for consideration of H.R. 78, the SEC Regulatory Accountability Act; H.R. 238, the Commodity End-User Relief Act; and for other purposes",Passed,232,0,0,8,0,168,0,26,0,0,0,0,232,168,0,34
33,R,115,H RES 40,11-Jan-2017,1:39 PM,On Agreeing to the Resolution,"Providing for consideration of H.R. 78, the SEC Regulatory Accountability Act; H.R. 238, the Commodity End-User Relief Act; and for other purposes",Passed,232,1,0,7,1,169,0,24,0,0,0,0,233,170,0,31
34,R,115,H R 39,11-Jan-2017,1:46 PM,On Motion to Suspend the Rules and Pass,Tested Ability to Leverage Exceptional National Talent Act,Passed,217,17,0,6,169,0,0,25,0,0,0,0,386,17,0,31
35,R,115,H R 5,11-Jan-2017,5:49 PM,On Agreeing to the Amendment,None,Agreed to,234,0,0,6,3,185,0,6,0,0,0,0,237,185,0,12
36,R,115,H R 5,11-Jan-2017,5:55 PM,On Agreeing to the Amendment,None,Agreed to,226,7,0,7,34,154,0,6,0,0,0,0,260,161,0,13
37,R,115,H R 5,11-Jan-2017,5:59 PM,On Agreeing to the Amendment,None,Failed,2,229,0,9,187,2,0,5,0,0,0,0,189,231,0,14
38,R,115,H R 5,11-Jan-2017,6:02 PM,On Agreeing to the Amendment,None,Failed,1,232,0,7,189,0,0,5,0,0,0,0,190,232,0,12
39,R,115,H R 5,11-Jan-2017,6:06 PM,On Agreeing to the Amendment,None,Failed,0,233,0,7,188,1,0,5,0,0,0,0,188,234,0,12
40,R,115,H R 5,11-Jan-2017,6:11 PM,On Agreeing to the Amendment,None,Failed,2,232,0,6,188,1,0,5,0,0,0,0,190,233,0,11
41,R,115,H R 5,11-Jan-2017,6:16 PM,On Agreeing to the Amendment,None,Failed,7,226,0,7,188,1,0,5,0,0,0,0,195,227,0,12
42,R,115,H R 5,11-Jan-2017,6:20 PM,On Agreeing to the Amendment,None,Failed,0,234,0,6,188,1,0,5,0,0,0,0,188,235,0,11
43,R,115,H R 5,11-Jan-2017,6:24 PM,On Agreeing to the Amendment,None,Failed,0,233,0,7,185,3,0,6,0,0,0,0,185,236,0,13
44,R,115,H R 5,11-Jan-2017,6:39 PM,On Motion to Recommit with Instructions,Regulatory Accountability Act of 2017,Failed,0,233,0,7,190,0,0,4,0,0,0,0,190,233,0,11
45,R,115,H R 5,11-Jan-2017,6:46 PM,On Passage,Regulatory Accountability Act of 2017,Passed,233,0,0,7,5,183,0,6,0,0,0,0,238,183,0,13
46,R,115,H R 78,12-Jan-2017,4:35 PM,On Agreeing to the Amendment,None,Failed,1,233,0,6,191,0,0,3,0,0,0,0,192,233,0,9
47,R,115,H R 78,12-Jan-2017,4:40 PM,On Agreeing to the Amendment,None,Failed,1,230,0,9,190,2,0,2,0,0,0,0,191,232,0,11
48,R,115,H R 78,12-Jan-2017,4:46 PM,On Agreeing to the Amendment,None,Failed,2,233,0,5,192,0,0,2,0,0,0,0,194,233,0,7
49,R,115,H R 78,12-Jan-2017,4:50 PM,On Agreeing to the Amendment,None,Failed,4,231,0,5,192,0,0,2,0,0,0,0,196,231,0,7
50,R,115,H R 78,12-Jan-2017,5:06 PM,On Motion to Recommit with Instructions,SEC Regulatory Accountability Act,Failed,3,232,0,5,192,0,0,2,0,0,0,0,195,232,0,7
51,R,115,H R 78,12-Jan-2017,5:12 PM,On Passage,SEC Regulatory Accountability Act,Passed,234,1,0,5,9,183,0,2,0,0,0,0,243,184,0,7
52,R,115,H R 238,12-Jan-2017,5:17 PM,On Agreeing to the Amendment,None,Agreed to,234,1,0,5,2,190,0,2,0,0,0,0,236,191,0,7
53,R,115,H R 238,12-Jan-2017,5:34 PM,On Motion to Recommit with Instructions,Commodity End-User Relief Act,Failed,0,235,0,5,190,0,0,4,0,0,0,0,190,235,0,9
54,R,115,H R 238,12-Jan-2017,5:40 PM,On Passage,Commodity End-User Relief Act,Passed,232,1,0,7,7,181,0,6,0,0,0,0,239,182,0,13
55,R,115,H RES 48,13-Jan-2017,10:47 AM,On Ordering the Previous Question,"Providing for consideration of S.Con.Res 3, setting forth the congressional budget for the United States Government for fiscal year 2017 and for other purposes; and S. 84, to provide for an exception to a limitation against appointment of persons as Secretary of Defense within 7 years of relief from active duty",Passed,234,0,0,6,0,179,0,15,0,0,0,0,234,179,0,21
56,R,115,H RES 48,13-Jan-2017,10:53 AM,On Agreeing to the Resolution,"Providing for consideration of S.Con.Res 3, setting forth the congressional budget for the United States Government for fiscal year 2017 and for other purposes; and S. 84, to provide for an exception to a limitation against appointment of persons as Secretary of Defense within 7 years of relief from active duty",Passed,235,0,0,5,0,188,0,6,0,0,0,0,235,188,0,11
57,R,115,S CON RES 3,13-Jan-2017,3:24 PM,On Agreeing to the Amendment,None,Failed,0,235,0,5,149,37,0,8,0,0,0,0,149,272,0,13
58,R,115,S CON RES 3,13-Jan-2017,3:31 PM,On Agreeing to the Resolution,Setting forth the congressional budget for the United States Government for fiscal year 2017 and setting forth the appropriate budgetary levels for fiscal years 2018 through 2026,Passed,227,9,0,5,0,189,0,5,0,0,0,0,227,198,0,10
59,R,115,S 84,13-Jan-2017,3:37 PM,On Passage,To provide for an exception to a limitation against appointment of persons as Secretary of Defense within seven years of relief from active duty as a regular commissioned officer of the Armed Forces,Passed,232,1,0,7,36,150,1,7,0,0,0,0,268,151,1,14
60,R,115,H R 423,23-Jan-2017,6:51 PM,On Motion to Suspend the Rules and Pass,Anti-Spoofing Act,Passed,224,5,0,11,174,0,0,20,0,0,0,0,398,5,0,31
61,R,115,H R 582,23-Jan-2017,7:04 PM,On Motion to Suspend the Rules and Pass,Kari’s Law Act,Passed,229,0,0,11,179,0,0,15,0,0,0,0,408,0,0,26
62,R,115,H RES 55,24-Jan-2017,2:04 PM,On Ordering the Previous Question,Providing for consideration of the bill (H.R. 7) to prohibit taxpayer funded abortions,Passed,233,0,0,6,0,187,0,6,0,0,0,0,233,187,0,12
63,R,115,H RES 55,24-Jan-2017,2:11 PM,On Agreeing to the Resolution,Providing for consideration of the bill (H.R. 7) to prohibit taxpayer funded abortions,Passed,234,0,0,5,2,183,0,8,0,0,0,0,236,183,0,13
64,R,115,H R 7,24-Jan-2017,4:40 PM,On Motion to Recommit with Instructions,To prohibit taxpayer funded abortions,Failed,0,235,0,4,187,0,0,6,0,0,0,0,187,235,0,10
65,R,115,H R 7,24-Jan-2017,4:48 PM,On Passage,To prohibit taxpayer funded abortions,Passed,235,0,0,4,3,183,0,7,0,0,0,0,238,183,0,11
66,R,115,H R 374,30-Jan-2017,6:50 PM,On Motion to Suspend the Rules and Pass,To remove the sunset provision of section 203 of Public Law 105-384 and for other purposes,Passed,228,0,0,11,160,0,0,33,0,0,0,0,388,0,0,44
67,R,115,H R 538,30-Jan-2017,7:00 PM,"On Motion to Suspend the Rules and Pass, as Amended",Ocmulgee Mounds National Historical Park Boundary Revision Act of 2017,Passed,219,8,0,12,177,0,0,16,0,0,0,0,396,8,0,28
68,R,115,H RES 70,31-Jan-2017,5:18 PM,On Ordering the Previous Question,"Providing for consideration of H.J. Res. 38, disapproving the rule submitted by the Department of the Interior known as the Stream Protection Rule",Passed,235,0,0,4,1,183,0,9,0,0,0,0,236,183,0,13
69,R,115,H RES 70,31-Jan-2017,5:25 PM,On Agreeing to the Resolution,"Providing for consideration of H.J. Res. 38, disapproving the rule submitted by the Department of the Interior known as the Stream Protection Rule",Passed,236,0,0,3,0,186,0,7,0,0,0,0,236,186,0,10
70,R,115,H RES 71,1-Feb-2017,1:46 PM,On Ordering the Previous Question,"Providing for consideration of (H.J.Res. 41) disapproval of a rule submitted by the SEC relating to “Disclosure of Payments by Resource Extraction Issuers”, and consideration of (H.J.Res. 40) disapproval of the rule submitted by the SSA relating to Implementation of the NICS Improvement Amendments Act of 2007",Passed,231,0,0,8,0,191,0,2,0,0,0,0,231,191,0,10
71,R,115,H RES 71,1-Feb-2017,1:52 PM,On Agreeing to the Resolution,"Providing for consideration of (H.J.Res. 41) disapproval of a rule submitted by the SEC relating to “Disclosure of Payments by Resource Extraction Issuers”, and consideration of (H.J.Res. 40) disapproval of the rule submitted by the SSA relating to Implementation of the NICS Improvement Amendments Act of 2007",Passed,231,0,0,8,0,191,0,2,0,0,0,0,231,191,0,10
72,R,115,H J RES 41,1-Feb-2017,4:43 PM,On Passage,"Providing for congressional disapproval under chapter 8 of title 5, United States Code, of a rule submitted by the Securities and Exchange Commission relating to “Disclosure of Payments by Resource Extraction Issuers”",Passed,230,4,0,5,5,183,0,5,0,0,0,0,235,187,0,10
73,R,115,H J RES 38,1-Feb-2017,4:50 PM,On Passage,Disapproving the rule submitted by the Department of the Interior known as the Stream Protection Rule,Passed,224,9,0,6,4,185,0,4,0,0,0,0,228,194,0,10
74,R,115,H RES 74,2-Feb-2017,1:28 PM,On Ordering the Previous Question,"Providing for consideration of H.J. Res. 36, congressional disapproval under chapter 8 of title 5, U.S.C., of the final rule of the BLM relating to Waste Prevention; and providing for consideration of H.J. Res. 37, disapproving the rule submitted by DOD, GSA, and NASA, relating to the Federal Acquisition Regulation",Passed,230,0,0,9,0,188,0,5,0,0,0,0,230,188,0,14
75,R,115,H RES 74,2-Feb-2017,1:36 PM,On Agreeing to the Resolution,"Providing for consideration of H.J. Res. 36, congressional disapproval under chapter 8 of title 5, U.S.C., of the final rule of the BLM relating to Waste Prevention; and providing for consideration of H.J. Res. 37, disapproving the rule submitted by DOD, GSA, and NASA, relating to the Federal Acquisition Regulation",Passed,232,0,0,7,0,190,0,3,0,0,0,0,232,190,0,10
76,R,115,H J RES 37,2-Feb-2017,3:56 PM,On Passage,"Disapproving the rule submitted by the Department of Defense, the General Services Administration, and the National Aeronautics and Space Administration relating to the Federal Acquisition Regulation",Passed,233,1,0,5,3,186,0,4,0,0,0,0,236,187,0,9
77,R,115,H J RES 40,2-Feb-2017,4:07 PM,On Passage,"Providing for congressional disapproval under chapter 8 of title 5, United States Code, of the rule submitted by the Social Security Administration relating to Implementation of the NICS Improvement Amendments Act of 2007",Passed,229,2,0,8,6,178,0,9,0,0,0,0,235,180,0,17
78,R,115,H J RES 36,3-Feb-2017,10:34 AM,On Passage,"Providing for congressional disapproval under chapter 8 of title 5, United States Code, of the final rule of the Bureau of Land Management relating to “Waste Prevention, Production Subject to Royalties, and Resource Conservation”",Passed,218,11,0,10,3,180,0,10,0,0,0,0,221,191,0,20
79,R,115,H R 689,6-Feb-2017,6:51 PM,On Motion to Suspend the Rules and Pass,Bolts Ditch Access and Use Act,Passed,230,1,0,8,179,0,0,14,0,0,0,0,409,1,0,22
80,R,115,H R 337,6-Feb-2017,6:58 PM,On Motion to Suspend the Rules and Pass,Black Hills National Cemetery Boundary Expansion Act,Passed,230,0,0,9,177,0,0,16,0,0,0,0,407,0,0,25
81,R,115,H RES 91,7-Feb-2017,1:36 PM,On Ordering the Previous Question,"Providing for consideration of H.J.Res 44, H.J.Res. 57, and H.J.Res 58.",Passed,234,0,0,5,0,187,0,6,0,0,0,0,234,187,0,11
82,R,115,H RES 91,7-Feb-2017,1:43 PM,On Agreeing to the Resolution,"Providing for consideration of H.J.Res 44, H.J.Res. 57, and H.J.Res 58.",Passed,233,0,0,6,0,186,0,7,0,0,0,0,233,186,0,13
83,R,115,H J RES 44,7-Feb-2017,4:57 PM,On Passage,"Disapproving the rule submitted by the Department of the Interior relating to Bureau of Land Management regulations that establish the procedures used to prepare, revise, or amend land use plans pursuant to the Federal Land Policy and Management Act of 1976",Passed,230,4,0,5,4,182,0,7,0,0,0,0,234,186,0,12
84,R,115,H J RES 57,7-Feb-2017,5:03 PM,On Passage,"Providing for congressional disapproval under chapter 8 of title 5, United States Code, of the rule submitted by the Department of Education relating to accountability and State plans under the Elementary and Secondary Education Act of 1965",Passed,234,1,0,4,0,189,0,4,0,0,0,0,234,190,0,8
85,R,115,H J RES 58,7-Feb-2017,5:10 PM,On Passage,"Providing for congressional disapproval under chapter 8 of title 5, United States Code, of the rule submitted by the Department of Education relating to teacher preparation issues",Passed,235,0,0,4,5,181,0,7,0,0,0,0,240,181,0,11
86,R,115,H R 244,13-Feb-2017,6:54 PM,"On Motion to Suspend the Rules and Pass, as Amended",HIRE Vets Act,Passed,229,1,0,8,180,0,0,13,0,0,0,0,409,1,0,21
87,R,115,H R 974,13-Feb-2017,7:11 PM,On Motion to Suspend the Rules and Pass,BRAVE Act,Passed,227,0,0,11,180,0,0,13,0,0,0,0,407,0,0,24
88,R,115,H RES 99,14-Feb-2017,2:40 PM,On Ordering the Previous Question,"Providing for consideration of H.R. 428, the Red River Gradient Boundary Survey Act and H.J.Res. 42, disapproving the rule submitted by the Department of Labor relating to drug testing of unemployment compensation applications",Passed,225,0,0,13,0,189,0,4,0,0,0,0,225,189,0,17
89,R,115,H RES 99,14-Feb-2017,2:46 PM,On Agreeing to the Resolution,"Providing for consideration of H.R. 428, the Red River Gradient Boundary Survey Act and H.J.Res. 42, disapproving the rule submitted by the Department of Labor relating to drug testing of unemployment compensation applications",Passed,225,0,0,13,0,187,0,6,0,0,0,0,225,187,0,19
90,R,115,H RES 116,14-Feb-2017,2:53 PM,On Ordering the Previous Question,Providing for consideration of H.J.Res. 66 and H.J.Res. 67,Passed,227,0,0,11,0,188,0,5,0,0,0,0,227,188,0,16
91,R,115,H RES 116,14-Feb-2017,3:01 PM,On Agreeing to the Resolution,Providing for consideration of H.J.Res. 66 and H.J.Res. 67,Passed,227,0,0,11,0,188,0,5,0,0,0,0,227,188,0,16
92,R,115,H R 428,14-Feb-2017,4:38 PM,On Passage,Red River Gradient Boundary Survey Act,Passed,235,0,0,3,15,171,0,7,0,0,0,0,250,171,0,10
93,R,115,H RES 123,15-Feb-2017,1:18 PM,On Ordering the Previous Question,"Providing for consideration of H.J. Res. 43 and H.J. Res. 69, and providing for proceedings during the period from February 17, 2017, through February 24, 2017",Passed,233,0,0,5,0,190,0,3,0,0,0,0,233,190,0,8
94,R,115,H RES 123,15-Feb-2017,1:25 PM,On Agreeing to the Resolution,"Providing for consideration of H.J. Res. 43 and H.J. Res. 69, and providing for proceedings during the period from February 17, 2017, through February 24, 2017",Passed,233,0,0,5,0,188,0,5,0,0,0,0,233,188,0,10
95,R,115,H J RES 67,15-Feb-2017,4:53 PM,On Passage,Disapproving the rule submitted by the Department of Labor relating to savings arrangements established by qualified State political subdivisions for non-governmental employees.,Passed,233,1,0,4,1,190,0,2,0,0,0,0,234,191,0,6
96,R,115,H J RES 66,15-Feb-2017,5:02 PM,On Passage,Disapproving the rule submitted by the Department of Labor relating to savings arrangements established by States for non-governmental employees.,Passed,230,3,0,5,1,190,0,2,0,0,0,0,231,193,0,7
97,R,115,H J RES 42,15-Feb-2017,5:10 PM,On Passage,Disapproving the rule submitted by the Department of Labor relating to drug testing of unemployment compensation applicants,Passed,232,1,0,5,4,188,0,1,0,0,0,0,236,189,0,6
98,R,115,H J RES 69,16-Feb-2017,3:16 PM,On Passage,"Providing for congressional disapproval under chapter 8 of title 5, United States Code, of the final rule of the Department of the Interior relating to “Non-Subsistence Take of Wildlife, and Public Participation and Closure Procedures, on National Wildlife Refuges in Alaska”",Passed,220,10,0,7,5,183,0,5,0,0,0,0,225,193,0,12
99,R,115,H J RES 43,16-Feb-2017,3:27 PM,On Passage,"Providing for congressional disapproval under chapter 8 of title 5, United States Code, of the final rule submitted by Secretary of Health and Human Services relating to compliance with title X requirements by project recipients in selecting subrecipients",Passed,228,2,0,7,2,186,0,5,0,0,0,0,230,188,0,12
100,R,115,H R 699,27-Feb-2017,6:52 PM,On Motion to Suspend the Rules and Pass,Mount Hood Cooper Spur Land Exchange Clarification Act,Passed,230,1,0,6,185,0,0,8,0,0,0,0,415,1,0,14
101,R,115,MOTION,27-Feb-2017,7:27 PM,Table Appeal of the Ruling of the Chair,None,Passed,229,0,2,6,0,185,0,8,0,0,0,0,229,185,2,14
102,R,115,H R 863,27-Feb-2017,7:34 PM,On Motion to Suspend the Rules and Pass,"To facilitate the addition of park administration at the Coltsville National Historical Park, and for other purposes",Passed,185,42,0,10,184,0,0,9,0,0,0,0,369,42,0,19
103,R,115,H RES 150,28-Feb-2017,2:11 PM,On Ordering the Previous Question,"Providing for consideration of the bill (H.R. 998) SCRUB Act, and providing for consideration of (H.J.Res. 83) disapproving the rule submitted by the Department of Labor relating to “Clarification of Employer’s Continuing Obligation to Make and Maintain an Accurate Record of Each Recordable Injury and Illness”",Passed,224,0,0,13,0,191,0,2,0,0,0,0,224,191,0,15
104,R,115,H RES 150,28-Feb-2017,2:18 PM,On Agreeing to the Resolution,"Providing for consideration of the bill (H.R. 998) SCRUB Act, and providing for consideration of (H.J.Res. 83) disapproving the rule submitted by the Department of Labor relating to “Clarification of Employer’s Continuing Obligation to Make and Maintain an Accurate Record of Each Recordable Injury and Illness”",Passed,224,0,0,13,1,188,0,4,0,0,0,0,225,188,0,17
105,R,115,H R 998,28-Feb-2017,4:11 PM,On Agreeing to the Amendment,None,Agreed to,156,75,0,6,192,0,0,1,0,0,0,0,348,75,0,7
106,R,115,H R 998,28-Feb-2017,4:14 PM,On Agreeing to the Amendment,None,Failed,0,232,0,5,181,11,0,1,0,0,0,0,181,243,0,6
107,R,115,H R 998,28-Feb-2017,4:18 PM,On Agreeing to the Amendment,None,Failed,1,231,0,5,188,3,0,2,0,0,0,0,189,234,0,7
108,R,115,H R 998,28-Feb-2017,4:22 PM,On Agreeing to the Amendment,None,Failed,2,229,0,6,190,1,0,2,0,0,0,0,192,230,0,8
109,R,115,H R 998,1-Mar-2017,2:19 PM,On Agreeing to the Amendment,None,Failed,0,234,0,2,191,1,0,1,0,0,0,0,191,235,0,3
110,R,115,H R 998,1-Mar-2017,2:27 PM,On Agreeing to the Amendment,None,Failed,1,229,0,6,188,2,0,3,0,0,0,0,189,231,0,9
111,R,115,H R 998,1-Mar-2017,2:32 PM,On Agreeing to the Amendment,None,Failed,6,229,0,1,191,0,0,2,0,0,0,0,197,229,0,3
112,R,115,H R 998,1-Mar-2017,2:36 PM,On Agreeing to the Amendment,None,Failed,4,231,0,1,190,0,0,3,0,0,0,0,194,231,0,4
113,R,115,H R 998,1-Mar-2017,3:00 PM,On Motion to Recommit with Instructions,SCRUB Act,Failed,0,235,0,1,190,0,0,3,0,0,0,0,190,235,0,4
114,R,115,H R 998,1-Mar-2017,3:07 PM,On Passage,SCRUB Act,Passed,229,5,0,2,11,180,0,2,0,0,0,0,240,185,0,4
115,R,115,H RES 156,1-Mar-2017,3:13 PM,On Ordering the Previous Question,"Providing for consideration of H.R. 1004, the Regulatory Integrity Act of 2017; and H.R. 1009, the OIRA Insight, Reform, and Accountability Act",Passed,233,0,0,3,0,189,0,4,0,0,0,0,233,189,0,7
116,R,115,H RES 156,1-Mar-2017,3:20 PM,On Agreeing to the Resolution,"Providing for consideration of H.R. 1004, the Regulatory Integrity Act of 2017; and H.R. 1009, the OIRA Insight, Reform, and Accountability Act",Passed,233,0,0,3,1,180,0,12,0,0,0,0,234,180,0,15
117,R,115,H R 1009,1-Mar-2017,5:48 PM,On Agreeing to the Amendment,None,Agreed to,232,0,0,4,33,158,0,2,0,0,0,0,265,158,0,6
118,R,115,H R 1009,1-Mar-2017,5:53 PM,On Agreeing to the Amendment,None,Failed,1,232,0,3,187,2,0,4,0,0,0,0,188,234,0,7
119,R,115,H R 1009,1-Mar-2017,6:11 PM,On Motion to Recommit with Instructions,"OIRA Insight, Reform, and Accountability Act",Failed,1,234,0,1,192,0,0,1,0,0,0,0,193,234,0,2
120,R,115,H R 1009,1-Mar-2017,6:18 PM,On Passage,"OIRA Insight, Reform, and Accountability Act",Passed,234,0,0,2,7,184,0,2,0,0,0,0,241,184,0,4
121,R,115,H J RES 83,1-Mar-2017,6:25 PM,On Passage,Disapproving the rule submitted by the Department of Labor relating to “Clarification of Employer’s Continuing Obligation to Make and Maintain an Accurate Record of Each Recordable Injury and Illness”,Passed,227,6,0,3,4,185,0,4,0,0,0,0,231,191,0,7
122,R,115,H R 1004,2-Mar-2017,10:38 AM,On Agreeing to the Amendment,None,Failed,0,231,0,5,180,3,0,10,0,0,0,0,180,234,0,15
123,R,115,H R 1004,2-Mar-2017,10:43 AM,On Agreeing to the Amendment,None,Agreed to,224,1,0,11,39,144,0,10,0,0,0,0,263,145,0,21
124,R,115,H R 1004,2-Mar-2017,10:50 AM,On Agreeing to the Amendment,None,Failed,5,227,0,4,184,5,0,4,0,0,0,0,189,232,0,8
125,R,115,H R 1004,2-Mar-2017,11:07 AM,On Motion to Recommit with Instructions,Regulatory Integrity Act,Failed,1,231,0,4,188,1,0,4,0,0,0,0,189,232,0,8
126,R,115,H R 1004,2-Mar-2017,11:14 AM,On Passage,Regulatory Integrity Act,Passed,231,1,0,4,15,175,0,3,0,0,0,0,246,176,0,7
127,R,115,H R 1362,7-Mar-2017,6:56 PM,On Motion to Suspend the Rules and Pass,"To name the Department of Veterans Affairs community-based outpatient clinic in Pago Pago, American Samoa, the Faleomavaega Eni Fa’aua’a Hunkin VA Clinic",Passed,226,2,0,8,185,0,0,8,0,0,0,0,411,2,0,16
128,R,115,MOTION,7-Mar-2017,7:29 PM,Table Appeal of the Ruling of the Chair,None,Passed,226,1,1,8,1,185,0,7,0,0,0,0,227,186,1,15
129,R,115,H RES 175,8-Mar-2017,2:36 PM,On Ordering the Previous Question,"Providing for consideration of the bill (H.R. 725) to amend title 28, United States Code, to prevent fraudulent joinder",Passed,230,1,0,5,0,183,0,10,0,0,0,0,230,184,0,15
130,R,115,H RES 175,8-Mar-2017,2:44 PM,On Agreeing to the Resolution,"Providing for consideration of the bill (H.R. 725) to amend title 28, United States Code, to prevent fraudulent joinder",Passed,234,0,0,2,1,185,0,7,0,0,0,0,235,185,0,9
131,R,115,H RES 174,8-Mar-2017,2:51 PM,On Ordering the Previous Question,"Providing for consideration of the bill (H.R. 1301) making appropriations for the Department of Defense for the fiscal year ending September 30, 2017, and for other purposes",Passed,232,1,0,3,0,188,0,5,0,0,0,0,232,189,0,8
132,R,115,ADJOURN,8-Mar-2017,3:09 PM,On Motion to Adjourn,None,Failed,0,234,1,1,127,61,0,5,0,0,0,0,127,295,1,6
133,R,115,H RES 174,8-Mar-2017,3:16 PM,On Agreeing to the Resolution,"Providing for consideration of the bill (H.R. 1301) making appropriations for the Department of Defense for the fiscal year ending September 30, 2017, and for other purposes",Passed,228,3,0,5,5,182,0,6,0,0,0,0,233,185,0,11
134,R,115,ADJOURN,8-Mar-2017,3:33 PM,On Motion to Adjourn,None,Failed,0,220,0,16,107,57,0,29,0,0,0,0,107,277,0,45
135,R,115,ADJOURN,8-Mar-2017,4:56 PM,On Motion to Adjourn,None,Failed,1,226,0,9,113,64,0,16,0,0,0,0,114,290,0,25
136,R,115,H R 1301,8-Mar-2017,5:19 PM,On Passage,"Making appropriations for the Department of Defense for the fiscal year ending September 30, 2017, and for other purposes",Passed,230,5,0,1,141,43,0,9,0,0,0,0,371,48,0,10
137,R,115,ADJOURN,8-Mar-2017,5:45 PM,On Motion to Adjourn,None,Passed,205,23,0,8,109,75,0,9,0,0,0,0,314,98,0,17
138,R,115,H RES 180,9-Mar-2017,2:42 PM,On Ordering the Previous Question,"Providing for consideration of H.R. 720, the Lawsuit Abuse Reduction Act of 2017; and providing for consideration of H.R. 985, the Fairness in Class Action Litigation Act of 2017",Passed,233,0,0,3,0,186,0,7,0,0,0,0,233,186,0,10
139,R,115,H RES 180,9-Mar-2017,2:51 PM,On Agreeing to the Resolution,"Providing for consideration of H.R. 720, the Lawsuit Abuse Reduction Act of 2017; and providing for consideration of H.R. 985, the Fairness in Class Action Litigation Act of 2017",Passed,233,0,0,3,0,184,0,9,0,0,0,0,233,184,0,12
140,R,115,H R 985,9-Mar-2017,6:07 PM,On Agreeing to the Amendment,None,Failed,4,227,0,5,178,0,0,15,0,0,0,0,182,227,0,20
141,R,115,H R 985,9-Mar-2017,6:11 PM,On Agreeing to the Amendment,None,Failed,6,227,0,3,183,1,0,9,0,0,0,0,189,228,0,12
142,R,115,H R 985,9-Mar-2017,6:15 PM,On Agreeing to the Amendment,None,Failed,5,230,0,1,187,0,0,6,0,0,0,0,192,230,0,7
143,R,115,H R 985,9-Mar-2017,6:18 PM,On Agreeing to the Amendment,None,Failed,4,230,0,2,186,0,0,7,0,0,0,0,190,230,0,9
144,R,115,H R 985,9-Mar-2017,6:21 PM,On Agreeing to the Amendment,None,Failed,5,230,0,1,186,0,0,7,0,0,0,0,191,230,0,8
145,R,115,H R 985,9-Mar-2017,6:25 PM,On Agreeing to the Amendment,None,Failed,6,229,0,1,187,0,0,6,0,0,0,0,193,229,0,7
146,R,115,H R 985,9-Mar-2017,6:28 PM,On Agreeing to the Amendment,None,Failed,6,228,0,2,187,0,0,6,0,0,0,0,193,228,0,8
147,R,115,H R 985,9-Mar-2017,6:46 PM,On Motion to Recommit with Instructions,Fairness in Class Action Litigation Act,Failed,1,234,0,1,187,0,0,6,0,0,0,0,188,234,0,7
148,R,115,H R 985,9-Mar-2017,6:52 PM,On Passage,Fairness in Class Action Litigation Act,Passed,220,14,1,1,0,187,0,6,0,0,0,0,220,201,1,7
149,R,115,H R 725,9-Mar-2017,6:59 PM,On Agreeing to the Amendment,None,Failed,3,232,0,1,186,1,0,6,0,0,0,0,189,233,0,7
150,R,115,H R 725,9-Mar-2017,7:02 PM,On Agreeing to the Amendment,None,Failed,5,229,0,2,182,0,0,11,0,0,0,0,187,229,0,13
151,R,115,H R 725,9-Mar-2017,7:14 PM,On Motion to Recommit with Instructions,Innocent Party Protection Act,Failed,1,233,0,2,186,0,0,7,0,0,0,0,187,233,0,9
152,R,115,H R 725,9-Mar-2017,7:19 PM,On Passage,Innocent Party Protection Act,Passed,224,10,0,2,0,184,0,9,0,0,0,0,224,194,0,11
153,R,115,H R 720,10-Mar-2017,10:49 AM,On Agreeing to the Amendment,None,Failed,3,224,0,9,178,1,0,14,0,0,0,0,181,225,0,23
154,R,115,H R 720,10-Mar-2017,10:53 AM,On Agreeing to the Amendment,None,Failed,4,224,0,8,181,1,0,11,0,0,0,0,185,225,0,19
155,R,115,H R 720,10-Mar-2017,10:58 AM,On Agreeing to the Amendment,None,Failed,5,227,0,4,185,0,0,8,0,0,0,0,190,227,0,12
156,R,115,H R 720,10-Mar-2017,11:02 AM,On Agreeing to the Amendment,None,Failed,4,229,0,3,185,0,0,8,0,0,0,0,189,229,0,11
157,R,115,H R 720,10-Mar-2017,11:18 AM,On Motion to Recommit with Instructions,Lawsuit Abuse Reduction Act,Failed,0,232,0,4,186,0,0,7,0,0,0,0,186,232,0,11
158,R,115,H R 720,10-Mar-2017,11:29 AM,On Passage,Lawsuit Abuse Reduction Act,Passed,227,5,0,4,3,183,0,7,0,0,0,0,230,188,0,11
159,R,115,H R 132,15-Mar-2017,6:57 PM,On Motion to Suspend the Rules and Pass,Arbuckle Project Maintenance Complex and District Office Conveyance Act of 2017,Passed,226,1,0,9,181,0,0,12,0,0,0,0,407,1,0,21
160,R,115,H R 648,15-Mar-2017,7:03 PM,On Motion to Suspend the Rules and Pass,To authorize the Secretary of the Interior to amend the Definite Plan Report for the Seedskadee Project to enable the use of the active capacity of the Fontenelle Reservoir,Passed,227,0,0,9,181,0,0,12,0,0,0,0,408,0,0,21
161,R,115,MOTION,15-Mar-2017,7:47 PM,Table Appeal of the Ruling of the Chair,None,Passed,223,1,1,11,0,182,0,11,0,0,0,0,223,183,1,22
162,R,115,H RES 198,16-Mar-2017,1:58 PM,On Ordering the Previous Question,"Providing for consideration of H.R. 1259, the VA Accountability First Act of 2017; H.R. 1367, to improve the authority of the Secretary of Veterans Affairs to hire and retain physicians and other employees of the Department of Veterans Affairs; and H.R. 1181, theVeterans 2nd Amendment Protection Act",Passed,227,1,0,8,0,184,0,9,0,0,0,0,227,185,0,17
163,R,115,H RES 198,16-Mar-2017,2:06 PM,On Agreeing to the Resolution,"Providing for consideration of H.R. 1259, the VA Accountability First Act of 2017; H.R. 1367, to improve the authority of the Secretary of Veterans Affairs to hire and retain physicians and other employees of the Department of Veterans Affairs; and H.R. 1181, theVeterans 2nd Amendment Protection Act",Passed,229,0,0,7,0,187,0,6,0,0,0,0,229,187,0,13
164,R,115,JOURNAL,16-Mar-2017,2:13 PM,On Approving the Journal,None,Passed,153,74,0,9,90,91,1,11,0,0,0,0,243,165,1,20
165,R,115,H R 1259,16-Mar-2017,5:29 PM,On Agreeing to the Amendment,None,Failed,7,223,0,6,187,0,0,6,0,0,0,0,194,223,0,12
166,R,115,H R 1259,16-Mar-2017,5:33 PM,On Agreeing to the Amendment,None,Failed,0,229,0,7,183,3,0,7,0,0,0,0,183,232,0,14
167,R,115,H R 1259,16-Mar-2017,5:51 PM,On Motion to Recommit with Instructions,VA Accountability First Act,Failed,2,229,0,5,187,0,0,6,0,0,0,0,189,229,0,11
168,R,115,H R 1259,16-Mar-2017,5:58 PM,On Passage,VA Accountability First Act,Passed,227,3,0,6,10,175,0,8,0,0,0,0,237,178,0,14
169,R,115,H R 1181,16-Mar-2017,6:05 PM,On Passage,Veterans 2nd Amendment Protection Act,Passed,228,2,0,6,12,173,0,8,0,0,0,0,240,175,0,14
170,R,115,H R 1367,17-Mar-2017,11:28 AM,On Agreeing to the Amendment,None,Agreed to,225,8,0,3,175,0,0,18,0,0,0,0,400,8,0,21
171,R,115,H R 1367,17-Mar-2017,11:36 AM,On Passage,"To improve the authority of the Secretary of Veterans Affairs to hire and retain physicians and other employees of the Department of Veterans Affairs, and for other purposes",Passed,232,0,0,4,180,0,0,13,0,0,0,0,412,0,0,17
172,R,115,JOURNAL,17-Mar-2017,11:44 AM,On Approving the Journal,None,Passed,137,76,1,22,109,67,1,16,0,0,0,0,246,143,2,38
173,R,115,H R 1294,20-Mar-2017,6:51 PM,On Motion to Suspend the Rules and Pass,Reducing DHS Acquisition Cost Growth Act,Passed,227,0,0,9,181,0,0,12,0,0,0,0,408,0,0,21
174,R,115,H R 1249,20-Mar-2017,7:06 PM,"On Motion to Suspend the Rules and Pass, as Amended",DHS Multiyear Acquisition Strategy Act of 2017,Passed,228,0,0,8,181,0,0,12,0,0,0,0,409,0,0,20
175,R,115,H R 1252,20-Mar-2017,7:13 PM,"On Motion to Suspend the Rules and Pass, as Amended",DHS Acquisition Authorities Act of 2017,Passed,225,1,0,10,182,0,0,11,0,0,0,0,407,1,0,21
176,R,115,H RES 209,21-Mar-2017,1:35 PM,On Ordering the Previous Question,Providing for consideration of the bill (H.R. 372) to restore the application of the Federal antitrust laws to the business of health insurance to protect competition and consumers.,Passed,231,1,0,4,0,184,0,9,0,0,0,0,231,185,0,13
177,R,115,H RES 209,21-Mar-2017,1:42 PM,On Agreeing to the Resolution,Providing for consideration of the bill (H.R. 372) to restore the application of the Federal antitrust laws to the business of health insurance to protect competition and consumers.,Passed,233,0,0,3,1,182,0,10,0,0,0,0,234,182,0,13
178,R,115,H R 1353,21-Mar-2017,1:49 PM,On Motion to Suspend the Rules and Pass,Transparency in Technological Acquisitions Act of 2017,Passed,233,0,0,3,181,2,0,10,0,0,0,0,414,2,0,13
179,R,115,H RES 210,21-Mar-2017,4:37 PM,On Ordering the Previous Question,Providing for consideration of the bill (H.R. 1101) to amend title I of the Employee Retirement Income Security Act of 1974 to improve access and choice for entrepreneurs with small businesses with respect to medical care for their employees,Passed,233,0,0,3,0,186,0,7,0,0,0,0,233,186,0,10
180,R,115,H RES 210,21-Mar-2017,4:45 PM,On Agreeing to the Resolution,Providing for consideration of the bill (H.R. 1101) to amend title I of the Employee Retirement Income Security Act of 1974 to improve access and choice for entrepreneurs with small businesses with respect to medical care for their employees,Passed,233,0,0,3,0,186,0,7,0,0,0,0,233,186,0,10
181,R,115,H R 1297,21-Mar-2017,4:55 PM,On Motion to Suspend the Rules and Pass,Quadrennial Homeland Security Review Technical Corrections Act of 2017,Passed,232,0,0,4,183,0,0,10,0,0,0,0,415,0,0,14
182,R,115,MOTION,22-Mar-2017,1:36 PM,Table Appeal of the Ruling of the Chair,None,Passed,230,1,1,4,0,188,0,5,0,0,0,0,230,189,1,9
183,R,115,H R 372,22-Mar-2017,1:45 PM,On Motion to Recommit with Instructions,Competitive Health Insurance Reform Act of 2017,Failed,2,233,0,1,187,0,0,6,0,0,0,0,189,233,0,7
184,R,115,H R 372,22-Mar-2017,1:52 PM,On Passage,Competitive Health Insurance Reform Act of 2017,Passed,235,0,0,1,181,7,0,5,0,0,0,0,416,7,0,6
185,R,115,H R 1101,22-Mar-2017,3:30 PM,On Motion to Recommit with Instructions,Small Business Health Fairness Act,Failed,2,233,0,1,177,0,0,16,0,0,0,0,179,233,0,17
186,R,115,H R 1101,22-Mar-2017,3:39 PM,On Passage,Small Business Health Fairness Act,Passed,232,0,0,4,4,175,0,14,0,0,0,0,236,175,0,18
187,R,115,H R 1238,22-Mar-2017,3:47 PM,On Motion to Suspend the Rules and Pass,Securing our Agriculture and Food Act,Passed,229,6,0,1,177,0,0,16,0,0,0,0,406,6,0,17
188,R,115,H RES 221,23-Mar-2017,8:44 PM,On Ordering the Previous Question,"Waiving a requirement of clause 6(a) of rule XIII with respect to consideration of certain resolutions reported from the Committee on Rules, and providing for consideration of motions to suspend the rules",Passed,233,0,0,3,0,185,0,8,0,0,0,0,233,185,0,11
189,R,115,H RES 221,23-Mar-2017,8:51 PM,On Agreeing to the Resolution,"Waiving a requirement of clause 6(a) of rule XIII with respect to consideration of certain resolutions reported from the Committee on Rules, and providing for consideration of motions to suspend the rules",Passed,227,4,0,5,0,185,0,8,0,0,0,0,227,189,0,13
190,R,115,JOURNAL,23-Mar-2017,9:01 PM,On Approving the Journal,None,Passed,132,91,1,12,70,106,3,14,0,0,0,0,202,197,4,26
191,R,115,H RES 228,24-Mar-2017,10:54 AM,On Ordering the Previous Question,"Providing for consideration of H.R. 1628, the American Health Care Act of 2017",Passed,236,0,0,0,0,186,0,7,0,0,0,0,236,186,0,7
192,R,115,H RES 228,24-Mar-2017,11:02 AM,On Agreeing to the Resolution,"Providing for consideration of H.R. 1628, the American Health Care Act of 2017",Passed,230,6,0,0,0,188,0,5,0,0,0,0,230,194,0,5
193,R,115,H R 1365,24-Mar-2017,11:11 AM,"On Motion to Suspend the Rules and Pass, as Amended",Department of Homeland Security Acquisition Innovation Act,Passed,236,0,0,0,188,0,0,5,0,0,0,0,424,0,0,5
194,R,115,JOURNAL,24-Mar-2017,11:17 AM,On Approving the Journal,None,Passed,153,80,0,3,65,121,1,6,0,0,0,0,218,201,1,9
195,R,115,H R 1117,27-Mar-2017,6:53 PM,"On Motion to Suspend the Rules and Pass, as Amended",To require the Administrator of the Federal Emergency Management Agency to submit a report regarding certain plans regarding assistance to applicants and grantees during the response to an emergency or disaster,Passed,225,0,0,11,183,0,0,10,0,0,0,0,408,0,0,21
196,R,115,H R 654,27-Mar-2017,7:13 PM,"On Motion to Suspend the Rules and Pass, as Amended",Pacific Northwest Earthquake Preparedness Act,Passed,215,11,0,10,180,0,0,13,0,0,0,0,395,11,0,23
197,R,115,H RES 229,28-Mar-2017,3:25 PM,On Ordering the Previous Question,"Providing for consideration of the bill H.R. 1430, the Honest and Open New EPA Science Treatment Act of 2017",Passed,231,0,0,5,0,189,0,4,0,0,0,0,231,189,0,9
198,R,115,H RES 229,28-Mar-2017,3:32 PM,On Agreeing to the Resolution,"Providing for consideration of the bill H.R. 1430, the Honest and Open New EPA Science Treatment Act of 2017",Passed,230,0,0,6,1,185,0,7,0,0,0,0,231,185,0,13
199,R,115,H RES 230,28-Mar-2017,3:39 PM,On Ordering the Previous Question,"Providing for consideration of S.J.Res. 34, providing for congressional disapproval under chapter 8 of title 5, United States Code, of the rule submitted by the Federal Communications Commission relating to “Protecting the Privacy of Customers of Broadband and Other Telecommunications Services”.",Passed,231,0,0,5,1,184,0,8,0,0,0,0,232,184,0,13
200,R,115,H RES 230,28-Mar-2017,3:47 PM,On Agreeing to the Resolution,"Providing for consideration of S.J.Res. 34, providing for congressional disapproval under chapter 8 of title 5, United States Code, of the rule submitted by the Federal Communications Commission relating to “Protecting the Privacy of Customers of Broadband and Other Telecommunications Services”.",Passed,231,0,0,5,0,189,0,4,0,0,0,0,231,189,0,9
201,R,115,MOTION,28-Mar-2017,5:48 PM,Table Appeal of the Ruling of the Chair,None,Passed,228,1,1,6,0,189,1,3,0,0,0,0,228,190,2,9
202,R,115,S J RES 34,28-Mar-2017,5:56 PM,On Passage,"Providing for congressional disapproval under chapter 8 of title 5, United States Code, of the rule submitted by the Federal Communications Commission relating to “Protecting the Privacy of Customers of Broadband and Other Telecommunications Services”",Passed,215,15,0,6,0,190,0,3,0,0,0,0,215,205,0,9
203,R,115,H RES 233,29-Mar-2017,1:36 PM,On Ordering the Previous Question,"Providing for consideration of the bill (H.R. 1431) to amend the Environmental Research, Development, and Demonstration Authorization Act of 1978 to provide for Scientific Advisory Board member qualifications, public participation, and for other purposes",Passed,232,1,0,3,0,190,0,3,0,0,0,0,232,191,0,6
204,R,115,H RES 233,29-Mar-2017,1:43 PM,On Agreeing to the Resolution,"Providing for consideration of the bill (H.R. 1431) to amend the Environmental Research, Development, and Demonstration Authorization Act of 1978 to provide for Scientific Advisory Board member qualifications, public participation, and for other purposes",Passed,231,0,0,5,1,188,0,4,0,0,0,0,232,188,0,9
205,R,115,H R 1430,29-Mar-2017,4:45 PM,On Motion to Recommit with Instructions,Honest and Open New EPA Science Treatment Act,Failed,1,232,0,3,188,0,0,5,0,0,0,0,189,232,0,8
206,R,115,H R 1430,29-Mar-2017,4:54 PM,On Passage,Honest and Open New EPA Science Treatment Act,Passed,225,7,0,4,3,187,0,3,0,0,0,0,228,194,0,7
207,R,115,H R 1431,30-Mar-2017,10:29 AM,On Motion to Recommit with Instructions,EPA Science Advisory Board Reform Act of 2017,Failed,1,232,0,3,188,1,0,4,0,0,0,0,189,233,0,7
208,R,115,H R 1431,30-Mar-2017,10:40 AM,On Passage,EPA Science Advisory Board Reform Act of 2017,Passed,227,5,0,4,2,188,0,3,0,0,0,0,229,193,0,7
209,R,115,H RES 92,3-Apr-2017,6:52 PM,"On Motion to Suspend the Rules and Agree, as Amended","Condemning North Korea’s development of multiple intercontinental ballistic missiles, and for other purposes",Passed,219,3,0,14,179,0,0,14,0,0,0,0,398,3,0,28
210,R,115,H R 479,3-Apr-2017,7:15 PM,"On Motion to Suspend the Rules and Pass, as Amended",North Korea State Sponsor of Terrorism Designation Act of 2017,Passed,221,1,0,14,173,0,0,20,0,0,0,0,394,1,0,34
211,R,115,H RES 241,4-Apr-2017,2:03 PM,On Ordering the Previous Question,"Providing for consideration of H.R. 1304, the Self-Insurance Protection Act",Passed,232,0,0,4,0,188,0,5,0,0,0,0,232,188,0,9
212,R,115,H RES 241,4-Apr-2017,2:13 PM,On Agreeing to the Resolution,"Providing for consideration of H.R. 1304, the Self-Insurance Protection Act",Passed,232,0,0,4,2,184,0,7,0,0,0,0,234,184,0,11
213,R,115,H RES 240,4-Apr-2017,2:21 PM,On Ordering the Previous Question,"Providing for consideration of H.R. 1343, the Encouraging Employee Ownership Act of 2017",Passed,229,1,0,6,0,186,0,7,0,0,0,0,229,187,0,13
214,R,115,H RES 240,4-Apr-2017,2:30 PM,On Agreeing to the Resolution,"Providing for consideration of H.R. 1343, the Encouraging Employee Ownership Act of 2017",Passed,230,0,0,6,8,177,0,8,0,0,0,0,238,177,0,14
215,R,115,H R 1343,4-Apr-2017,4:44 PM,On Motion to Recommit with Instructions,Encouraging Employee Ownership Act,Failed,0,228,0,8,185,0,0,8,0,0,0,0,185,228,0,16
216,R,115,H R 1343,4-Apr-2017,4:57 PM,On Passage,Encouraging Employee Ownership Act,Passed,229,1,0,6,102,86,0,5,0,0,0,0,331,87,0,11
217,R,115,H RES 242,5-Apr-2017,1:58 PM,On Ordering the Previous Question,"Providing for consideration of H.R. 1219, Supporting America’s Innovators Act of 2017",Passed,231,1,0,4,0,181,0,12,0,0,0,0,231,182,0,16
218,R,115,H RES 242,5-Apr-2017,2:05 PM,On Agreeing to the Resolution,"Providing for consideration of H.R. 1219, Supporting America’s Innovators Act of 2017",Passed,234,0,0,2,6,181,0,6,0,0,0,0,240,181,0,8
219,R,115,MOTION,5-Apr-2017,3:45 PM,Table Appeal of the Ruling of the Chair,None,Passed,228,1,1,6,0,184,1,8,0,0,0,0,228,185,2,14
220,R,115,H R 1304,5-Apr-2017,3:57 PM,On Passage,Self-Insurance Protection Act,Passed,230,0,0,6,170,16,0,7,0,0,0,0,400,16,0,13
221,R,115,H R 1219,6-Apr-2017,10:31 AM,On Passage,Supporting America’s Innovators Act,Passed,232,1,0,3,185,2,0,6,0,0,0,0,417,3,0,9
222,R,115,H RES 187,25-Apr-2017,6:52 PM,"On Motion to Suspend the Rules and Agree, as Amended",Relating to efforts to respond to the famine in South Sudan,Passed,228,2,0,6,183,0,0,10,0,0,0,0,411,2,0,16
223,R,115,H R 876,25-Apr-2017,7:08 PM,"On Motion to Suspend the Rules and Pass, as Amended",Aviation Employee Screening and Security Enhancement Act of 2017,Passed,228,0,0,9,181,0,0,12,0,0,0,0,409,0,0,21
224,R,115,H RES 275,26-Apr-2017,1:45 PM,On Ordering the Previous Question,"Providing for consideration of the bill (H.R. 1695) to amend title 17, United States Code, to provide additional responsibilities for the Register of Copyrights, and for other purposes",Passed,234,1,0,2,0,190,0,3,0,0,0,0,234,191,0,5
225,R,115,H RES 275,26-Apr-2017,1:53 PM,On Agreeing to the Resolution,"Providing for consideration of the bill (H.R. 1695) to amend title 17, United States Code, to provide additional responsibilities for the Register of Copyrights, and for other purposes",Passed,232,0,0,5,5,186,0,2,0,0,0,0,237,186,0,7
226,R,115,H R 1695,26-Apr-2017,3:22 PM,On Agreeing to the Amendment,None,Agreed to,229,6,0,2,181,8,0,4,0,0,0,0,410,14,0,6
227,R,115,H R 1695,26-Apr-2017,3:32 PM,On Passage,Register of Copyrights Selection and Accountability Act,Passed,233,2,0,2,145,46,0,2,0,0,0,0,378,48,0,4
228,R,115,JOURNAL,26-Apr-2017,3:40 PM,On Approving the Journal,None,Passed,137,80,1,19,100,81,1,11,0,0,0,0,237,161,2,30
229,R,115,H RES 280,27-Apr-2017,1:59 PM,On Ordering the Previous Question,"Providing for consideration of H.R. 1694, the Fannie and Freddie Open Records Act of 2017; providing for consideration of motions to suspend the rules; and waiving a requirement of clause 6(a) of rule XIII with respect to consideration of certain resolutions reported from the Committee on Rules",Passed,230,1,0,6,0,192,0,1,0,0,0,0,230,193,0,7
230,R,115,H RES 280,27-Apr-2017,2:07 PM,On Agreeing to the Resolution,"Providing for consideration of H.R. 1694, the Fannie and Freddie Open Records Act of 2017; providing for consideration of motions to suspend the rules; and waiving a requirement of clause 6(a) of rule XIII with respect to consideration of certain resolutions reported from the Committee on Rules",Passed,223,3,0,11,3,189,0,1,0,0,0,0,226,192,0,12
231,R,115,S 496,27-Apr-2017,2:17 PM,On Motion to Suspend the Rules and Pass,To repeal the rule issued by the Federal Highway Administration and the Federal Transit Administration entitled “Metropolitan Planning Organization Coordination and Planning Area Reform”,Passed,229,0,0,8,188,3,0,2,0,0,0,0,417,3,0,10
232,R,115,H R 1694,27-Apr-2017,3:25 PM,On Agreeing to the Amendment,None,Agreed to,227,5,0,5,183,0,0,10,0,0,0,0,410,5,0,15
233,R,115,H R 1694,27-Apr-2017,3:35 PM,On Passage,Fannie and Freddie Open Records Act of 2017,Passed,234,0,0,3,191,0,0,2,0,0,0,0,425,0,0,5
234,R,115,JOURNAL,27-Apr-2017,3:43 PM,On Approving the Journal,None,Passed,147,83,0,7,102,80,2,9,0,0,0,0,249,163,2,16
235,R,115,H RES 289,28-Apr-2017,10:21 AM,On Agreeing to the Resolution,"Providing for consideration of the joint resolution (H.J. Res. 99) making further continuing appropriations for fiscal year 2017, and for other purposes",Passed,225,0,0,12,10,178,0,5,0,0,0,0,235,178,0,17
236,R,115,H J RES 99,28-Apr-2017,11:29 AM,On Passage,"Making further continuing appropriations for fiscal year 2017, and for other purposes",Passed,207,16,0,14,175,14,0,4,0,0,0,0,382,30,0,18
237,R,115,H R 910,1-May-2017,6:54 PM,"On Motion to Suspend the Rules and Pass, as Amended",Fair Access to Investment Research Act of 2017,Passed,224,0,0,13,181,2,0,10,0,0,0,0,405,2,0,23
238,R,115,H R 1312,1-May-2017,7:04 PM,"On Motion to Suspend the Rules and Pass, as Amended",Small Business Capital Formation Enhancement Act,Passed,223,0,0,14,183,0,0,10,0,0,0,0,406,0,0,24
239,R,115,H R 657,1-May-2017,7:11 PM,"On Motion to Suspend the Rules and Pass, as Amended",Follow the Rules Act,Passed,223,0,0,14,184,0,0,9,0,0,0,0,407,0,0,23
240,R,115,H RES 299,2-May-2017,2:29 PM,On Ordering the Previous Question,"Providing for consideration of H.R. 1180, Working Families Flexibility Act of 2017",Passed,233,1,0,3,0,189,0,4,0,0,0,0,233,190,0,7
241,R,115,H RES 299,2-May-2017,2:37 PM,On Agreeing to the Resolution,"Providing for consideration of H.R. 1180, Working Families Flexibility Act of 2017",Passed,231,2,0,4,0,191,0,2,0,0,0,0,231,193,0,6
242,R,115,H R 1679,2-May-2017,2:49 PM,On Motion to Suspend the Rules and Pass,"FEMA Accountability, Modernization and Transparency Act of 2017",Passed,230,0,0,7,189,0,0,4,0,0,0,0,419,0,0,11
243,R,115,H R 1180,2-May-2017,5:17 PM,On Motion to Recommit with Instructions,Working Families Flexibility Act of 2017,Failed,1,234,0,2,191,0,0,2,0,0,0,0,192,234,0,4
244,R,115,H R 1180,2-May-2017,5:25 PM,On Passage,Working Families Flexibility Act of 2017,Passed,229,6,0,2,0,191,0,2,0,0,0,0,229,197,0,4
245,R,115,JOURNAL,2-May-2017,5:34 PM,On Approving the Journal,None,Passed,142,87,1,7,95,89,2,7,0,0,0,0,237,176,3,14
246,R,115,H RES 305,3-May-2017,2:01 PM,On Ordering the Previous Question,"Providing for consideration of the Senate amendments to the bill (H.R. 244) to encourage effective, voluntary investments to recruit, employ, and retain men and women who have served in the United States military with annual Federal awards to employers recognizing such efforts, and for other purposes",Passed,231,1,0,5,0,191,0,2,0,0,0,0,231,192,0,7
247,R,115,H RES 305,3-May-2017,2:14 PM,On Agreeing to the Resolution,"Providing for consideration of the Senate amendments to the bill (H.R. 244) to encourage effective, voluntary investments to recruit, employ, and retain men and women who have served in the United States military with annual Federal awards to employers recognizing such efforts, and for other purposes",Passed,233,0,0,4,7,186,0,0,0,0,0,0,240,186,0,4
248,R,115,H R 1665,3-May-2017,2:22 PM,"On Motion to Suspend the Rules and Pass, as Amended",Disaster Declaration Improvement Act,Passed,233,0,0,4,192,0,0,1,0,0,0,0,425,0,0,5
249,R,115,H R 244,3-May-2017,4:19 PM,"On Motion to Concur in Senate Amendments Nos. 2 and 3, and in No. 1 with Amendment",HIRE Vets Act,Passed,131,103,0,4,178,15,0,0,0,0,0,0,309,118,0,4
250,R,115,H R 1678,3-May-2017,4:28 PM,"On Motion to Suspend the Rules and Pass, as Amended","To amend the Robert T. Stafford Disaster Relief and Emergency Assistance Act concerning the statute of limitations for actions to recover disaster or emergency assistance payments, and for other purposes",Passed,232,0,0,5,191,0,0,2,0,0,0,0,423,0,0,7
251,R,115,JOURNAL,3-May-2017,4:41 PM,On Approving the Journal,None,Passed,136,91,0,10,100,87,0,6,0,0,0,0,236,178,0,16
252,R,115,H RES 308,4-May-2017,10:55 AM,On Ordering the Previous Question,"Providing for consideration of H.R. 2192, to amend the Health Service Act to eliminate the non-application of certain State waiver provisions to Members of Congress and congressional staff; and providing for further consideration of H.R. 1628, the American Health Care Act of 2017",Passed,235,1,0,1,0,192,0,1,0,0,0,0,235,193,0,2
253,R,115,H RES 308,4-May-2017,11:03 AM,On Agreeing to the Resolution,"Providing for consideration of H.R. 2192, to amend the Health Service Act to eliminate the non-application of certain State waiver provisions to Members of Congress and congressional staff; and providing for further consideration of H.R. 1628, the American Health Care Act of 2017",Passed,235,1,0,1,0,191,0,2,0,0,0,0,235,192,0,3
254,R,115,JOURNAL,4-May-2017,11:10 AM,On Approving the Journal,None,Passed,166,66,1,4,67,120,1,5,0,0,0,0,233,186,2,9
255,R,115,H R 2192,4-May-2017,2:10 PM,On Passage,To amend the Public Health Service Act to eliminate the non-application of certain State waiver provisions to Members of Congress and congressional staff,Passed,237,0,0,1,192,0,0,1,0,0,0,0,429,0,0,2
256,R,115,H R 1628,4-May-2017,2:18 PM,On Passage,American Health Care Act,Passed,217,20,0,1,0,193,0,0,0,0,0,0,217,213,0,1
257,R,115,H R 1644,4-May-2017,2:29 PM,"On Motion to Suspend the Rules and Pass, as Amended",Korean Interdiction and Modernization of Sanctions Act,Passed,232,1,0,4,187,0,0,6,0,0,0,0,419,1,0,10
258,R,115,H R 1616,16-May-2017,6:53 PM,"On Motion to Suspend the Rules and Pass, as Amended",Strengthening State and Local Cyber Crime Fighting Act of 2017,Passed,224,3,0,10,184,0,0,9,0,0,0,0,408,3,0,19
259,R,115,H RES 323,17-May-2017,1:49 PM,On Ordering the Previous Question,"Providing for consideration of the bill (H.R. 115) to amend title 18, United States Code, to provide additional aggravating factors for the imposition of the death penalty based on the status of the victim",Passed,230,1,0,6,0,188,0,5,0,0,0,0,230,189,0,11
260,R,115,H RES 323,17-May-2017,1:57 PM,On Agreeing to the Resolution,"Providing for consideration of the bill (H.R. 115) to amend title 18, United States Code, to provide additional aggravating factors for the imposition of the death penalty based on the status of the victim",Passed,231,0,0,6,2,184,0,7,0,0,0,0,233,184,0,13
261,R,115,MOTION,17-May-2017,6:21 PM,Table Appeal of the Ruling of the Chair,None,Passed,229,1,1,6,0,187,0,6,0,0,0,0,229,188,1,12
262,R,115,H R 1177,17-May-2017,6:29 PM,On Motion to Suspend the Rules and Pass,Removing Outdated Restrictions to Allow for Job Growth Act,Passed,231,1,0,5,187,0,0,6,0,0,0,0,418,1,0,11
263,R,115,H RES 324,18-May-2017,2:38 PM,On Ordering the Previous Question,"Providing for consideration of the bill (H.R. 1039) to amend section 3606 of title 18, United States Code, to grant probation officers authority to arrest hostile third parties who obstruct or impede a probation officer in the performance of official duties.",Passed,226,1,0,10,0,187,0,6,0,0,0,0,226,188,0,16
264,R,115,H RES 324,18-May-2017,2:47 PM,On Agreeing to the Resolution,"Providing for consideration of the bill (H.R. 1039) to amend section 3606 of title 18, United States Code, to grant probation officers authority to arrest hostile third parties who obstruct or impede a probation officer in the performance of official duties.",Passed,227,0,0,10,3,184,0,6,0,0,0,0,230,184,0,16
265,R,115,H R 115,18-May-2017,4:20 PM,On Passage,Thin Blue Line Act,Passed,223,4,0,10,48,139,0,6,0,0,0,0,271,143,0,16
266,R,115,H R 1892,18-May-2017,4:27 PM,On Motion to Suspend the Rules and Pass,Honoring Hometown Heroes Act,Passed,224,0,0,13,187,1,0,5,0,0,0,0,411,1,0,18
267,R,115,H R 1039,19-May-2017,11:39 AM,On Agreeing to the Amendment,None,Failed,7,218,0,12,171,11,0,11,0,0,0,0,178,229,0,23
268,R,115,H R 1039,19-May-2017,11:47 AM,On Passage,Probation Officer Protection Act of 2017,Passed,192,33,0,12,37,144,0,12,0,0,0,0,229,177,0,24
269,R,115,H R 1862,22-May-2017,6:57 PM,On Motion to Suspend the Rules and Pass,Global Child Protection Act of 2017,Passed,219,2,0,16,153,28,0,12,0,0,0,0,372,30,0,28
270,R,115,H R 1842,22-May-2017,7:04 PM,On Motion to Suspend the Rules and Pass,Strengthening Children’s Safety Act of 2017,Passed,218,2,0,17,153,28,1,11,0,0,0,0,371,30,1,28
271,R,115,H RES 348,23-May-2017,1:33 PM,On Ordering the Previous Question,"Providing for consideration of H. R. 953, the Reducing Regulatory Burdens Act of 2017",Passed,229,1,0,7,0,190,0,3,0,0,0,0,229,191,0,10
272,R,115,H RES 348,23-May-2017,1:42 PM,On Agreeing to the Resolution,"Providing for consideration of H. R. 953, the Reducing Regulatory Burdens Act of 2017",Passed,230,0,0,7,2,189,0,2,0,0,0,0,232,189,0,9
273,R,115,H R 2288,23-May-2017,5:10 PM,"On Motion to Suspend the Rules and Pass, as Amended",Veterans Appeals Improvement and Modernization Act of 2017,Passed,232,0,0,5,186,0,0,7,0,0,0,0,418,0,0,12
274,R,115,MOTION,24-May-2017,1:31 PM,Table Appeal of the Ruling of the Chair,None,Passed,225,1,1,10,0,186,0,7,0,0,0,0,225,187,1,17
275,R,115,H RES 352,24-May-2017,1:39 PM,On Ordering the Previous Question,"Providing for consideration of H.R. 1973, Protecting Young Victims from Sexual Abuse Act of 2017; providing for consideration of HR 1761, Protecting Against Child Exploitation Act of 2017; providing for proceedings during the period from May 26, 2017, through June 5, 2017",Passed,230,1,0,6,1,187,0,5,0,0,0,0,231,188,0,11
276,R,115,H RES 352,24-May-2017,1:46 PM,On Agreeing to the Resolution,"Providing for consideration of H.R. 1973, Protecting Young Victims from Sexual Abuse Act of 2017; providing for consideration of HR 1761, Protecting Against Child Exploitation Act of 2017; providing for proceedings during the period from May 26, 2017, through June 5, 2017",Passed,229,0,0,8,10,179,0,4,0,0,0,0,239,179,0,12
277,R,115,H R 2052,24-May-2017,1:53 PM,On Motion to Suspend the Rules and Pass,PRIVATE Act,Passed,230,0,0,7,188,0,0,5,0,0,0,0,418,0,0,12
278,R,115,H R 467,24-May-2017,2:00 PM,On Motion to Suspend the Rules and Pass,VA Scheduling Accountability Act,Passed,230,0,0,7,189,0,0,4,0,0,0,0,419,0,0,11
279,R,115,H R 953,24-May-2017,4:37 PM,On Agreeing to the Amendment,None,Failed,9,223,0,5,182,6,0,5,0,0,0,0,191,229,0,10
280,R,115,H R 953,24-May-2017,4:45 PM,On Agreeing to the Amendment,None,Failed,5,225,0,7,184,5,0,4,0,0,0,0,189,230,0,11
281,R,115,H R 953,24-May-2017,5:03 PM,On Motion to Recommit with Instructions,Reducing Regulatory Burdens Act,Failed,1,228,0,8,182,2,0,9,0,0,0,0,183,230,0,17
282,R,115,H R 953,24-May-2017,5:10 PM,On Passage,Reducing Regulatory Burdens Act,Passed,231,1,0,5,25,164,0,4,0,0,0,0,256,165,0,9
283,R,115,H R 1761,25-May-2017,11:32 AM,On Agreeing to the Amendment,None,Failed,2,231,0,4,178,7,0,8,0,0,0,0,180,238,0,12
284,R,115,H R 1761,25-May-2017,11:40 AM,On Passage,Protecting Against Child Exploitation Act of 2017,Passed,231,2,0,4,137,49,0,7,0,0,0,0,368,51,0,11
285,R,115,H R 1973,25-May-2017,11:47 AM,On Passage,Protecting Young Victims from Sexual Abuse Act of 2017,Passed,231,2,0,4,184,1,0,8,0,0,0,0,415,3,0,12
286,R,115,H RES 354,6-Jun-2017,6:55 PM,"On Motion to Suspend the Rules and Agree, as Amended","Condemning the violence against peaceful protesters outside the Turkish Ambassador’s residence on May 16, 2017, and calling for the perpetrators to be brought to justice and measures to be taken to prevent similar incidents in the future",Passed,224,0,0,13,173,0,0,20,0,0,0,0,397,0,0,33
287,R,115,H RES 355,6-Jun-2017,7:02 PM,"On Motion to Suspend the Rules and Agree, as Amended","Condemning in the strongest terms the terrorist attacks in Manchester, United Kingdom, on May 22, 2017, expressing heartfelt condolences, and reaffirming unwavering support for the special relationship between our peoples and nations in the wake of these attacks",Passed,221,0,0,16,176,0,0,17,0,0,0,0,397,0,0,33
288,R,115,H RES 374,7-Jun-2017,2:19 PM,On Ordering the Previous Question,"Providing for consideration of H.R. 2213, the Anti-Border Corruption Reauthorization Act of 2017, and for other purposes",Passed,228,1,0,8,0,188,0,5,0,0,0,0,228,189,0,13
289,R,115,H RES 374,7-Jun-2017,2:27 PM,On Agreeing to the Resolution,"Providing for consideration of H.R. 2213, the Anti-Border Corruption Reauthorization Act of 2017, and for other purposes",Passed,231,0,0,6,0,185,0,8,0,0,0,0,231,185,0,14
290,R,115,H RES 375,7-Jun-2017,2:43 PM,On Ordering the Previous Question,"Providing for consideration of H.R. 10, the Financial CHOICE Act of 2017, and for other purposes",Passed,227,1,0,9,1,184,0,8,0,0,0,0,228,185,0,17
291,R,115,H RES 375,7-Jun-2017,2:49 PM,On Agreeing to the Resolution,"Providing for consideration of H.R. 10, the Financial CHOICE Act of 2017, and for other purposes",Passed,230,1,0,6,1,187,0,5,0,0,0,0,231,188,0,11
292,R,115,MOTION,7-Jun-2017,4:39 PM,Table Appeal of the Ruling of the Chair,None,Passed,227,1,1,8,1,185,0,7,0,0,0,0,228,186,1,15
293,R,115,H R 2213,7-Jun-2017,4:52 PM,On Agreeing to the Amendment,None,Failed,3,227,0,7,176,11,0,6,0,0,0,0,179,238,0,13
294,R,115,H R 2213,7-Jun-2017,5:06 PM,On Passage,Anti-Border Corruption Reauthorization Act,Passed,231,0,0,6,51,137,0,5,0,0,0,0,282,137,0,11
295,R,115,H R 10,8-Jun-2017,4:16 PM,On Agreeing to the Amendment,None,Agreed to,231,1,0,5,1,184,0,8,0,0,0,0,232,185,0,13
296,R,115,H R 10,8-Jun-2017,4:20 PM,On Agreeing to the Amendment,None,Agreed to,228,1,0,8,3,179,0,11,0,0,0,0,231,180,0,19
297,R,115,H R 10,8-Jun-2017,4:24 PM,On Agreeing to the Amendment,None,Agreed to,233,1,0,3,2,183,0,8,0,0,0,0,235,184,0,11
298,R,115,H R 10,8-Jun-2017,4:28 PM,On Agreeing to the Amendment,None,Agreed to,232,1,0,4,1,184,0,8,0,0,0,0,233,185,0,12
299,R,115,H R 10,8-Jun-2017,4:38 PM,On Passage,Financial CHOICE Act of 2017,Passed,233,1,0,3,0,185,0,8,0,0,0,0,233,186,0,11
300,R,115,H R 2292,12-Jun-2017,6:52 PM,On Motion to Suspend the Rules and Pass,To extend a project of the Federal Energy Regulatory Commission involving the Cannonsville Dam,Passed,222,1,0,14,178,0,0,15,0,0,0,0,400,1,0,29
301,R,115,H R 2457,12-Jun-2017,6:59 PM,"On Motion to Suspend the Rules and Pass, as Amended",J. Bennett Johnston Waterway Hydropower Extension Act,Passed,221,1,0,15,181,0,0,12,0,0,0,0,402,1,0,27
302,R,115,H RES 378,13-Jun-2017,1:21 PM,On Ordering the Previous Question,"Providing for consideration of H.R. 2581, the Verify First Act; and providing for consideration of S. 1094, the Department of Veterans Affairs Accountability and Whistleblower Protection Act of 2017, and for other purposes",Passed,229,1,0,7,0,188,0,5,0,0,0,0,229,189,0,12
303,R,115,H RES 378,13-Jun-2017,1:27 PM,On Agreeing to the Resolution,"Providing for consideration of H.R. 2581, the Verify First Act; and providing for consideration of S. 1094, the Department of Veterans Affairs Accountability and Whistleblower Protection Act of 2017, and for other purposes",Passed,229,0,0,8,0,190,0,3,0,0,0,0,229,190,0,11
304,R,115,JOURNAL,13-Jun-2017,1:34 PM,On Approving the Journal,None,Passed,147,76,1,13,91,90,1,11,0,0,0,0,238,166,2,24
305,R,115,H R 2581,13-Jun-2017,4:03 PM,On Motion to Recommit with Instructions,Verify First Act,Failed,2,231,0,4,191,0,0,2,0,0,0,0,193,231,0,6
306,R,115,H R 2581,13-Jun-2017,4:10 PM,On Passage,Verify First Act,Passed,231,1,0,5,7,183,0,3,0,0,0,0,238,184,0,8
307,R,115,S 1094,13-Jun-2017,4:35 PM,On Passage,Department of Veterans Affairs Accountability and Whistleblower Protection Act,Passed,231,1,0,5,137,54,0,2,0,0,0,0,368,55,0,7
308,R,115,H R 2579,15-Jun-2017,1:40 PM,On Passage,Broader Options for Americans Act,Passed,226,0,0,11,41,144,0,8,0,0,0,0,267,144,0,19
309,R,115,H R 2847,20-Jun-2017,6:51 PM,On Motion to Suspend the Rules and Pass,Improving Services for Older Youth in Foster Care Act,Passed,217,8,0,12,174,0,0,19,0,0,0,0,391,8,0,31
310,R,115,H R 2866,20-Jun-2017,7:00 PM,"On Motion to Suspend the Rules and Pass, as Amended",Reducing Unnecessary Barriers for Relative Foster Parents Act,Passed,206,19,0,12,176,0,0,17,0,0,0,0,382,19,0,29
311,R,115,MOTION,21-Jun-2017,2:19 PM,Table Appeal of the Ruling of the Chair,None,Passed,227,1,1,8,0,187,0,6,0,0,0,0,227,188,1,14
312,R,115,H RES 392,21-Jun-2017,2:34 PM,On Ordering the Previous Question,"Providing for consideration of H.R. 1873, the Electricity and Reliability and Forest Protection Act; and H.R.1654, the Water Supply Permitting Coordination Act",Passed,229,1,0,8,0,185,0,8,0,0,0,0,229,186,0,16
313,R,115,H RES 392,21-Jun-2017,2:42 PM,On Agreeing to the Resolution,"Providing for consideration of H.R. 1873, the Electricity and Reliability and Forest Protection Act; and H.R.1654, the Water Supply Permitting Coordination Act",Passed,228,0,0,10,2,185,0,6,0,0,0,0,230,185,0,16
314,R,115,H R 1873,21-Jun-2017,4:22 PM,On Agreeing to the Amendment,None,Failed,0,229,0,9,171,14,0,8,0,0,0,0,171,243,0,17
315,R,115,H R 1873,21-Jun-2017,4:39 PM,On Passage,Electricity Reliability and Forest Protection Act,Passed,231,0,0,7,69,118,0,6,0,0,0,0,300,118,0,13
316,R,115,H RES 396,22-Jun-2017,1:33 PM,On Ordering the Previous Question,"Providing for consideration of the bill (H.R. 2842) to provide for the conduct of demonstration projects to test the effectiveness of subsidized employment for TANF recipients, and providing for consideration of motions to suspend the rules.",Passed,226,0,0,12,0,184,0,9,0,0,0,0,226,184,0,21
317,R,115,H RES 396,22-Jun-2017,1:42 PM,On Agreeing to the Resolution,"Providing for consideration of the bill (H.R. 2842) to provide for the conduct of demonstration projects to test the effectiveness of subsidized employment for TANF recipients, and providing for consideration of motions to suspend the rules.",Passed,228,0,0,10,5,179,0,9,0,0,0,0,233,179,0,19
318,R,115,H R 1654,22-Jun-2017,4:12 PM,On Agreeing to the Amendment,None,Failed,2,228,0,8,177,4,0,12,0,0,0,0,179,232,0,20
319,R,115,H R 1654,22-Jun-2017,4:32 PM,On Passage,Water Supply Permitting Coordination Act,Passed,225,5,0,8,8,175,0,10,0,0,0,0,233,180,0,18
320,R,115,H R 2842,23-Jun-2017,10:42 AM,On Agreeing to the Amendment,None,Agreed to,197,32,0,9,183,0,0,10,0,0,0,0,380,32,0,19
321,R,115,H R 2842,23-Jun-2017,10:53 AM,On Agreeing to the Amendment,None,Agreed to,224,4,0,10,40,143,0,10,0,0,0,0,264,147,0,20
322,R,115,H R 2842,23-Jun-2017,11:01 AM,On Passage,Accelerating Individuals into the Workforce Act,Passed,214,13,0,11,163,21,0,9,0,0,0,0,377,34,0,20
323,R,115,H R 2547,26-Jun-2017,6:52 PM,"On Motion to Suspend the Rules and Pass, as Amended",Veterans Expanded Trucking Opportunities Act of 2017,Passed,228,0,0,10,181,0,0,12,0,0,0,0,409,0,0,22
324,R,115,H R 2258,26-Jun-2017,7:13 PM,"On Motion to Suspend the Rules and Pass, as Amended",Active Duty Voluntary Acquisition of Necessary Credentials for Employment (ADVANCE) Act,Passed,228,0,0,12,181,0,0,12,0,0,0,0,409,0,0,24
325,R,115,H RES 382,27-Jun-2017,1:40 PM,On Ordering the Previous Question,"Providing for consideration of H.R. 1215, the Protecting Access to Care Act of 2017",Passed,234,0,0,6,0,184,0,9,0,0,0,0,234,184,0,15
326,R,115,H RES 382,27-Jun-2017,1:48 PM,On Agreeing to the Resolution,"Providing for consideration of H.R. 1215, the Protecting Access to Care Act of 2017",Passed,235,0,0,5,0,186,0,7,0,0,0,0,235,186,0,12
327,R,115,JOURNAL,27-Jun-2017,1:55 PM,On Approving the Journal,None,Passed,145,86,0,9,93,92,2,6,0,0,0,0,238,178,2,15
328,R,115,H RES 397,27-Jun-2017,4:14 PM,On Motion to Suspend the Rules and Agree,Solemnly reaffirming the commitment of the United States to the North Atlantic Treaty Organization’s principle of collective defense as enumerated in Article 5 of the North Atlantic Treaty,Passed,232,4,0,4,191,0,0,2,0,0,0,0,423,4,0,6
329,R,115,H R 497,27-Jun-2017,4:20 PM,"On Motion to Suspend the Rules and Pass, as Amended",Santa Ana River Wash Plan Land Exchange Act,Passed,235,0,0,5,189,0,0,4,0,0,0,0,424,0,0,9
330,R,115,H R 220,27-Jun-2017,4:30 PM,"On Motion to Suspend the Rules and Pass, as Amended","To authorize the expansion of an existing hydroelectric project, and for other purposes",Passed,235,1,0,4,189,0,0,4,0,0,0,0,424,1,0,8
331,R,115,H RES 414,28-Jun-2017,1:49 PM,On Ordering the Previous Question,"Providing for consideration of H.R. 3003, the No Sanctuary for Criminals Act",Passed,235,0,0,5,0,190,0,3,0,0,0,0,235,190,0,8
332,R,115,H RES 414,28-Jun-2017,1:57 PM,On Agreeing to the Resolution,"Providing for consideration of H.R. 3003, the No Sanctuary for Criminals Act",Passed,235,0,0,5,0,190,0,3,0,0,0,0,235,190,0,8
333,R,115,JOURNAL,28-Jun-2017,2:04 PM,On Approving the Journal,None,Passed,144,88,1,7,88,95,1,9,0,0,0,0,232,183,2,16
334,R,115,H R 1215,28-Jun-2017,4:46 PM,On Agreeing to the Amendment,None,Agreed to,215,17,0,8,7,180,0,6,0,0,0,0,222,197,0,14
335,R,115,H R 1215,28-Jun-2017,4:53 PM,On Agreeing to the Amendment,None,Failed,107,129,0,4,9,181,0,3,0,0,0,0,116,310,0,7
336,R,115,H R 1215,28-Jun-2017,5:12 PM,On Motion to Recommit with Instructions,Protecting Access to Care Act,Failed,0,235,0,5,191,0,0,2,0,0,0,0,191,235,0,7
337,R,115,H R 1215,28-Jun-2017,5:19 PM,On Passage,Protecting Access to Care Act,Passed,218,19,0,4,0,191,0,2,0,0,0,0,218,210,0,6
338,R,115,H R 1500,28-Jun-2017,5:27 PM,On Motion to Suspend the Rules and Pass,Robert Emmet Park Act,Passed,233,0,0,7,190,0,0,3,0,0,0,0,423,0,0,10
339,R,115,H RES 415,29-Jun-2017,1:57 PM,On Ordering the Previous Question,"Providing for consideration of the bill (H.R. 3004) to amend section 276 of the Immigration and Nationality Act relating to reentry of removed aliens, and providing for proceedings during the period from July 3, 2017, through July 10, 2017",Passed,235,1,0,4,0,189,0,4,0,0,0,0,235,190,0,8
340,R,115,H RES 415,29-Jun-2017,2:04 PM,On Agreeing to the Resolution,"Providing for consideration of the bill (H.R. 3004) to amend section 276 of the Immigration and Nationality Act relating to reentry of removed aliens, and providing for proceedings during the period from July 3, 2017, through July 10, 2017",Passed,236,0,0,4,0,191,0,2,0,0,0,0,236,191,0,6
341,R,115,H R 3003,29-Jun-2017,5:07 PM,On Motion to Recommit with Instructions,No Sanctuary for Criminals Act,Failed,0,230,0,10,181,0,0,12,0,0,0,0,181,230,0,22
342,R,115,H R 3003,29-Jun-2017,5:14 PM,On Passage,No Sanctuary for Criminals Act,Passed,225,7,0,8,3,188,0,2,0,0,0,0,228,195,0,10
343,R,115,H R 3004,29-Jun-2017,5:20 PM,On Motion to Recommit with Instructions,Kate’s Law,Failed,2,232,0,6,191,0,0,2,0,0,0,0,193,232,0,8
344,R,115,H R 3004,29-Jun-2017,5:26 PM,On Passage,Kate’s Law,Passed,233,1,0,6,24,166,0,3,0,0,0,0,257,167,0,9
345,R,115,H R 1397,11-Jul-2017,6:53 PM,On Motion to Suspend the Rules and Pass,"To authorize, direct, facilitate, and expedite the transfer of administrative jurisdiction of certain Federal land, and for other purposes",Passed,226,0,0,13,180,0,0,13,0,0,0,0,406,0,0,26
346,R,115,H R 1719,11-Jul-2017,7:10 PM,"On Motion to Suspend the Rules and Pass, as Amended","To authorize the Secretary of the Interior to acquire approximately 44 acres of land in Martinez, California, and for other purposes",Passed,216,15,0,8,185,0,0,9,0,0,0,0,401,15,0,17
347,R,115,H RES 431,12-Jul-2017,2:44 PM,On Ordering the Previous Question,"Providing for consideration of H.R. 2810, the National Defense Authorization Act for Fiscal Year 2018; and H.R. 23, Gaining Responsibility on Water Act of 2017",Passed,234,0,0,5,0,183,0,11,0,0,0,0,234,183,0,16
348,R,115,H RES 431,12-Jul-2017,2:52 PM,On Agreeing to the Resolution,"Providing for consideration of H.R. 2810, the National Defense Authorization Act for Fiscal Year 2018; and H.R. 23, Gaining Responsibility on Water Act of 2017",Passed,232,1,0,6,0,186,0,8,0,0,0,0,232,187,0,14
349,R,115,H R 1492,12-Jul-2017,3:06 PM,On Motion to Suspend the Rules and Pass,Medical Controlled Substances Transportation Act,Passed,230,2,0,7,186,0,0,8,0,0,0,0,416,2,0,15
350,R,115,H R 23,12-Jul-2017,6:52 PM,On Agreeing to the Amendment,None,Failed,12,221,0,6,189,0,0,5,0,0,0,0,201,221,0,11
351,R,115,H R 23,12-Jul-2017,7:09 PM,On Motion to Recommit with Instructions,Gaining Responsibility on Water Act,Failed,2,230,0,7,187,0,0,7,0,0,0,0,189,230,0,14
352,R,115,H R 23,12-Jul-2017,7:16 PM,On Passage,Gaining Responsibility on Water Act,Passed,226,7,0,6,4,183,0,7,0,0,0,0,230,190,0,13
353,R,115,ADJOURN,13-Jul-2017,1:19 PM,On Motion to Adjourn,None,Failed,2,224,0,13,75,102,0,17,0,0,0,0,77,326,0,30
354,R,115,H RES 440,13-Jul-2017,2:25 PM,On Ordering the Previous Question,"Providing for further consideration of H.R. 2810, the National Defense Authorization Act for Fiscal Year 2018",Passed,234,0,0,5,0,187,0,7,0,0,0,0,234,187,0,12
355,R,115,H RES 440,13-Jul-2017,2:35 PM,On Agreeing to the Resolution,"Providing for further consideration of H.R. 2810, the National Defense Authorization Act for Fiscal Year 2018",Passed,229,3,0,7,1,187,0,6,0,0,0,0,230,190,0,13
356,R,115,H R 2810,13-Jul-2017,2:41 PM,On Agreeing to the Amendment,None,Failed,194,40,0,5,4,185,0,5,0,0,0,0,198,225,0,10
357,R,115,H R 2810,13-Jul-2017,2:47 PM,On Agreeing to the Amendment,None,Failed,4,231,0,4,69,120,0,5,0,0,0,0,73,351,0,9
358,R,115,H R 2810,13-Jul-2017,2:52 PM,On Agreeing to the Amendment,None,Failed,2,233,0,4,177,12,0,5,0,0,0,0,179,245,0,9
359,R,115,H R 2810,13-Jul-2017,2:56 PM,On Agreeing to the Amendment,None,Failed,3,232,0,4,164,25,0,5,0,0,0,0,167,257,0,9
360,R,115,H R 2810,13-Jul-2017,2:59 PM,On Agreeing to the Amendment,None,Failed,1,234,0,4,172,15,0,7,0,0,0,0,173,249,0,11
361,R,115,H R 2810,13-Jul-2017,3:04 PM,On Agreeing to the Amendment,None,Failed,7,227,0,5,181,8,0,5,0,0,0,0,188,235,0,10
362,R,115,H R 2810,13-Jul-2017,3:09 PM,On Agreeing to the Amendment,None,Agreed to,233,2,0,4,20,170,0,4,0,0,0,0,253,172,0,8
363,R,115,H R 2810,13-Jul-2017,3:13 PM,On Agreeing to the Amendment,None,Failed,6,229,0,4,186,3,0,5,0,0,0,0,192,232,0,9
364,R,115,H R 2810,13-Jul-2017,3:17 PM,On Agreeing to the Amendment,None,Failed,2,232,0,5,167,22,0,5,0,0,0,0,169,254,0,10
365,R,115,H R 2810,13-Jul-2017,3:22 PM,On Agreeing to the Amendment,None,Failed,95,140,0,4,80,108,0,6,0,0,0,0,175,248,0,10
366,R,115,H R 2810,13-Jul-2017,5:29 PM,On Agreeing to the Amendment,None,Failed,20,213,0,6,178,7,0,9,0,0,0,0,198,220,0,15
367,R,115,H R 2810,13-Jul-2017,5:34 PM,On Agreeing to the Amendment,None,Failed,202,32,0,5,1,186,0,7,0,0,0,0,203,218,0,12
368,R,115,H R 2810,13-Jul-2017,5:38 PM,On Agreeing to the Amendment,None,Failed,185,46,0,8,0,188,0,6,0,0,0,0,185,234,0,14
369,R,115,H R 2810,13-Jul-2017,5:41 PM,On Agreeing to the Amendment,None,Failed,209,24,0,6,0,190,0,4,0,0,0,0,209,214,0,10
370,R,115,H R 2810,13-Jul-2017,5:45 PM,On Agreeing to the Amendment,None,Failed,183,51,0,5,0,191,0,3,0,0,0,0,183,242,0,8
371,R,115,H R 2810,13-Jul-2017,5:50 PM,On Agreeing to the Amendment,None,Failed,46,188,0,5,61,130,0,3,0,0,0,0,107,318,0,8
372,R,115,H R 2810,14-Jul-2017,10:57 AM,On Agreeing to the Amendment,None,Failed,208,27,0,4,0,190,0,4,0,0,0,0,208,217,0,8
373,R,115,H R 2810,14-Jul-2017,11:01 AM,On Agreeing to the Amendment,None,Agreed to,231,3,0,5,4,186,0,4,0,0,0,0,235,189,0,9
374,R,115,H R 2810,14-Jul-2017,11:05 AM,On Agreeing to the Amendment,None,Agreed to,229,6,0,4,15,175,0,4,0,0,0,0,244,181,0,8
375,R,115,H R 2810,14-Jul-2017,11:08 AM,On Agreeing to the Amendment,None,Agreed to,234,1,0,4,0,189,0,5,0,0,0,0,234,190,0,9
376,R,115,H R 2810,14-Jul-2017,11:12 AM,On Agreeing to the Amendment,None,Agreed to,234,0,0,5,190,0,0,4,0,0,0,0,424,0,0,9
377,R,115,H R 2810,14-Jul-2017,11:32 AM,On Motion to Recommit with Instructions,National Defense Authorization Act for Fiscal Year 2018,Failed,0,235,0,4,190,0,0,4,0,0,0,0,190,235,0,8
378,R,115,H R 2810,14-Jul-2017,11:39 AM,On Passage,National Defense Authorization Act for Fiscal Year 2018,Passed,227,8,0,4,117,73,0,4,0,0,0,0,344,81,0,8
379,R,115,H R 2210,17-Jul-2017,6:54 PM,On Motion to Suspend the Rules and Pass,Sergeant Joseph George Kusick VA Community Living Center,Passed,224,0,0,15,177,0,0,17,0,0,0,0,401,0,0,32
380,R,115,H J RES 92,17-Jul-2017,7:02 PM,On Motion to Suspend the Rules and Pass,"Granting the consent and approval of Congress for the Commonwealth of Virginia, the State of Maryland, and the District of Columbia to amend the Washington Area Transit Regulation Compact",Passed,224,0,0,15,178,0,0,16,0,0,0,0,402,0,0,31
381,R,115,H J RES 76,17-Jul-2017,7:09 PM,"On Motion to Suspend the Rules and Pass, as Amended","Granting the consent and approval of Congress for the Commonwealth of Virginia, the State of Maryland, and the District of Columbia to a enter into a compact relating to the establishment of the Washington Metrorail Satefy Commission",Passed,221,5,0,13,178,0,0,16,0,0,0,0,399,5,0,29
382,R,115,H RES 451,18-Jul-2017,2:06 PM,On Ordering the Previous Question,"Providing for consideration of H.R. 806, the Ozone Standards Implementation Act of 2017",Passed,231,0,0,8,0,188,0,6,0,0,0,0,231,188,0,14
383,R,115,H RES 451,18-Jul-2017,2:17 PM,On Agreeing to the Resolution,"Providing for consideration of H.R. 806, the Ozone Standards Implementation Act of 2017",Passed,234,0,0,5,1,188,0,5,0,0,0,0,235,188,0,10
384,R,115,H R 2786,18-Jul-2017,2:36 PM,"On Motion to Suspend the Rules and Pass, as Amended",To amend the Federal Power Act with respect to the criteria and process to qualify as a qualifying conduit hydropower facility,Passed,234,1,0,4,186,1,0,7,0,0,0,0,420,2,0,11
385,R,115,H R 806,18-Jul-2017,5:04 PM,On Agreeing to the Amendment,None,Failed,5,230,0,4,189,2,0,3,0,0,0,0,194,232,0,7
386,R,115,H R 806,18-Jul-2017,5:08 PM,On Agreeing to the Amendment,None,Failed,4,230,0,5,178,11,0,5,0,0,0,0,182,241,0,10
387,R,115,H R 806,18-Jul-2017,5:12 PM,On Agreeing to the Amendment,None,Failed,6,230,0,3,185,5,0,4,0,0,0,0,191,235,0,7
388,R,115,H R 806,18-Jul-2017,5:16 PM,On Agreeing to the Amendment,None,Failed,0,236,0,3,186,6,0,2,0,0,0,0,186,242,0,5
389,R,115,H R 806,18-Jul-2017,5:20 PM,On Agreeing to the Amendment,None,Failed,2,233,0,4,188,3,0,3,0,0,0,0,190,236,0,7
390,R,115,H R 806,18-Jul-2017,5:36 PM,On Motion to Recommit with Instructions,Ozone Standards Implementation Act of 2017,Failed,2,234,0,3,189,1,0,4,0,0,0,0,191,235,0,7
391,R,115,H R 806,18-Jul-2017,5:43 PM,On Passage,Ozone Standards Implementation Act of 2017,Passed,225,11,0,3,4,188,0,2,0,0,0,0,229,199,0,5
392,R,115,MOTION,19-Jul-2017,2:01 PM,Table Appeal of the Ruling of the Chair,None,Passed,235,1,1,2,0,189,0,5,0,0,0,0,235,190,1,7
393,R,115,H RES 454,19-Jul-2017,2:10 PM,On Ordering the Previous Question,Providing for consideration of the bills (H.R. 2910) Promoting Interagency Coordination for Review of Natural Gas Pipelines Act; (H.R. 2883) Promoting Cross-Border Energy Infrastructure Act; and (H.R. 218) King Cove Road Land Exchange Act,Passed,236,1,0,2,0,191,0,3,0,0,0,0,236,192,0,5
394,R,115,H RES 454,19-Jul-2017,2:22 PM,On Agreeing to the Resolution,Providing for consideration of the bills (H.R. 2910) Promoting Interagency Coordination for Review of Natural Gas Pipelines Act; (H.R. 2883) Promoting Cross-Border Energy Infrastructure Act; and (H.R. 218) King Cove Road Land Exchange Act,Passed,234,2,0,3,0,192,0,2,0,0,0,0,234,194,0,5
395,R,115,H R 2883,19-Jul-2017,4:58 PM,On Agreeing to the Amendment,None,Failed,2,234,0,3,180,12,0,2,0,0,0,0,182,246,0,5
396,R,115,H R 2883,19-Jul-2017,5:03 PM,On Agreeing to the Amendment,None,Failed,0,234,0,5,179,13,0,2,0,0,0,0,179,247,0,7
397,R,115,H R 2883,19-Jul-2017,5:18 PM,On Motion to Recommit with Instructions,Promoting Cross-Border Energy Infrastructure Act,Failed,2,232,0,5,191,0,0,3,0,0,0,0,193,232,0,8
398,R,115,H R 2883,19-Jul-2017,5:24 PM,On Passage,Promoting Cross-Border Energy Infrastructure Act,Passed,237,0,0,2,17,175,0,2,0,0,0,0,254,175,0,4
399,R,115,H R 2910,19-Jul-2017,5:30 PM,On Agreeing to the Amendment,None,Failed,1,236,0,2,179,13,0,2,0,0,0,0,180,249,0,4
400,R,115,H R 2910,19-Jul-2017,5:35 PM,On Agreeing to the Amendment,None,Failed,3,233,0,3,189,3,0,2,0,0,0,0,192,236,0,5
401,R,115,H R 2910,19-Jul-2017,5:49 PM,On Motion to Recommit with Instructions,Promoting Interagency Coordination for Review of Natural Gas Pipelines Act,Failed,1,235,0,3,188,4,0,2,0,0,0,0,189,239,0,5
402,R,115,H R 2910,19-Jul-2017,5:56 PM,On Passage,Promoting Interagency Coordination for Review of Natural Gas Pipelines Act,Passed,235,1,0,3,13,178,0,3,0,0,0,0,248,179,0,6
403,R,115,H R 2825,20-Jul-2017,11:33 AM,"On Motion to Suspend the Rules and Pass, as Amended",DHS Authorization Act,Passed,227,9,0,3,159,32,0,3,0,0,0,0,386,41,0,6
404,R,115,H R 218,20-Jul-2017,11:39 AM,On Agreeing to the Amendment,None,Failed,0,233,0,6,190,1,0,3,0,0,0,0,190,234,0,9
405,R,115,H R 218,20-Jul-2017,11:44 AM,On Agreeing to the Amendment,None,Failed,0,236,0,3,167,24,0,3,0,0,0,0,167,260,0,6
406,R,115,H R 218,20-Jul-2017,12:09 PM,On Passage,King Cove Road Land Exchange Act,Passed,233,3,0,3,15,176,0,3,0,0,0,0,248,179,0,6
407,R,115,H R 3180,24-Jul-2017,6:54 PM,"On Motion to Suspend the Rules and Pass, as Amended",Intelligence Authorization Act for Fiscal Year 2018,Failed,211,10,0,18,30,153,0,11,0,0,0,0,241,163,0,29
408,R,115,S 114,24-Jul-2017,7:03 PM,"On Motion to Suspend the Rules and Pass, as Amended","To amend title 38, United States Code, to require the Secretary of Veterans Affairs to submit an annual report regarding performance awards and bonuses awarded to certain high-level employees of the Department of Veterans Affairs",Failed,217,4,0,18,2,182,0,10,0,0,0,0,219,186,0,28
409,R,115,H R 3218,24-Jul-2017,7:11 PM,"On Motion to Suspend the Rules and Pass, as Amended",Harry W. Colmery Veterans Educational Assistance Act,Passed,221,0,0,18,184,0,0,10,0,0,0,0,405,0,0,28
410,R,115,H RES 468,25-Jul-2017,1:30 PM,On Ordering the Previous Question,"Providing for consideration of the joint resolution (H.J.Res. 111) providing for congressional disapproval under chapter 8 of title 5, United States Code, of the rule submitted by Bureau of Consumer Financial Protection relating to “Arbitration Agreements”.",Passed,229,0,0,10,0,184,0,10,0,0,0,0,229,184,0,20
411,R,115,H RES 468,25-Jul-2017,1:37 PM,On Agreeing to the Resolution,"Providing for consideration of the joint resolution (H.J.Res. 111) providing for congressional disapproval under chapter 8 of title 5, United States Code, of the rule submitted by Bureau of Consumer Financial Protection relating to “Arbitration Agreements”.",Passed,233,0,0,6,0,188,0,6,0,0,0,0,233,188,0,12
412,R,115,H J RES 111,25-Jul-2017,5:06 PM,On Passage,"Providing for congressional disapproval under chapter 8 of title 5, United States Code, of the rule submitted by Bureau of Consumer Financial Protection relating to “Arbitration Agreements”",Passed,231,1,0,7,0,189,0,5,0,0,0,0,231,190,0,12
413,R,115,H R 3364,25-Jul-2017,5:13 PM,On Motion to Suspend the Rules and Pass,Countering America’s Adversaries Through Sanctions Act,Passed,229,3,0,7,190,0,0,4,0,0,0,0,419,3,0,11
414,R,115,H RES 473,26-Jul-2017,1:55 PM,On Ordering the Previous Question,"Providing for consideration of the bill (H.R. 3219) making appropriations for the Department of Defense for the fiscal year ending September 30, 2018, and for other purposes",Passed,230,2,0,7,0,191,0,3,0,0,0,0,230,193,0,10
415,R,115,H RES 473,26-Jul-2017,2:02 PM,On Agreeing to the Resolution,"Providing for consideration of the bill (H.R. 3219) making appropriations for the Department of Defense for the fiscal year ending September 30, 2018, and for other purposes",Passed,230,3,0,6,2,189,0,3,0,0,0,0,232,192,0,9
416,R,115,H R 3219,26-Jul-2017,10:48 PM,On Agreeing to the Amendment,None,Failed,107,124,0,8,0,190,0,4,0,0,0,0,107,314,0,12
417,R,115,H R 3219,26-Jul-2017,10:53 PM,On Agreeing to the Amendment,None,Failed,116,120,0,3,0,189,0,5,0,0,0,0,116,309,0,8
418,R,115,H R 3219,26-Jul-2017,10:57 PM,On Agreeing to the Amendment,None,Failed,13,223,0,3,178,13,0,3,0,0,0,0,191,236,0,6
419,R,115,H R 3219,26-Jul-2017,11:00 PM,On Agreeing to the Amendment,None,Failed,178,58,0,3,0,191,0,3,0,0,0,0,178,249,0,6
420,R,115,H R 3219,26-Jul-2017,11:03 PM,On Agreeing to the Amendment,None,Failed,10,226,0,3,171,20,0,3,0,0,0,0,181,246,0,6
421,R,115,H R 3219,26-Jul-2017,11:06 PM,On Agreeing to the Amendment,None,Failed,12,224,0,3,174,17,0,3,0,0,0,0,186,241,0,6
422,R,115,H R 3219,26-Jul-2017,11:09 PM,On Agreeing to the Amendment,None,Failed,21,215,0,3,182,9,0,3,0,0,0,0,203,224,0,6
423,R,115,H R 3219,26-Jul-2017,11:12 PM,On Agreeing to the Amendment,None,Failed,1,235,0,3,179,12,0,3,0,0,0,0,180,247,0,6
424,R,115,H R 3219,26-Jul-2017,11:15 PM,On Agreeing to the Amendment,None,Failed,3,233,0,3,189,2,0,3,0,0,0,0,192,235,0,6
425,R,115,H R 3219,26-Jul-2017,11:20 PM,On Agreeing to the Amendment,None,Agreed to,51,185,0,3,183,7,0,4,0,0,0,0,234,192,0,7
426,R,115,H RES 478,27-Jul-2017,2:08 PM,On Ordering the Previous Question,"Providing for further consideration of the bill (H.R. 3219) making appropriations for the Department of Defense for the fiscal year ending Sept. 30, 2018, and for other purposes, and providing for consideration of motions to suspend the rules",Passed,233,1,0,5,0,184,0,10,0,0,0,0,233,185,0,15
427,R,115,H RES 478,27-Jul-2017,2:15 PM,On Agreeing to the Resolution,"Providing for further consideration of the bill (H.R. 3219) making appropriations for the Department of Defense for the fiscal year ending Sept. 30, 2018, and for other purposes, and providing for consideration of motions to suspend the rules",Passed,230,5,0,4,0,191,0,3,0,0,0,0,230,196,0,7
428,R,115,H R 3219,27-Jul-2017,2:20 PM,On Agreeing to the Amendment,None,Failed,139,96,0,4,1,189,1,3,0,0,0,0,140,285,1,7
429,R,115,H R 3219,27-Jul-2017,2:24 PM,On Agreeing to the Amendment,None,Failed,177,57,0,5,0,191,0,3,0,0,0,0,177,248,0,8
430,R,115,H R 3219,27-Jul-2017,4:41 PM,On Agreeing to the Amendment,None,Agreed to,25,209,0,5,189,2,0,3,0,0,0,0,214,211,0,8
431,R,115,H R 3219,27-Jul-2017,4:46 PM,On Agreeing to the Amendment,None,Agreed to,68,166,0,5,188,3,0,3,0,0,0,0,256,169,0,8
432,R,115,H R 3219,27-Jul-2017,4:51 PM,On Agreeing to the Amendment,None,Failed,3,230,0,6,169,22,0,3,0,0,0,0,172,252,0,9
433,R,115,H R 3219,27-Jul-2017,4:56 PM,On Agreeing to the Amendment,None,Agreed to,62,172,0,5,191,0,0,3,0,0,0,0,253,172,0,8
434,R,115,H R 3219,27-Jul-2017,5:13 PM,On Motion to Recommit with Instructions,"Making appropriations for the Department of Defense for the fiscal year ending September 30, 2018, and for other purposes",Failed,1,234,0,4,192,0,0,2,0,0,0,0,193,234,0,6
435,R,115,H R 3219,27-Jul-2017,5:19 PM,On Passage,"Making appropriations for the Department of Defense for the fiscal year ending September 30, 2018, and for other purposes",Passed,230,5,0,4,5,187,0,2,0,0,0,0,235,192,0,6
436,R,115,H RES 481,28-Jul-2017,10:27 AM,On Agreeing to the Resolution,"Providing for consideration of the bill (H.R. 3180) Intelligence Authorization Act for FY 2018; and providing for proceedings during the period from July 31, 2017, through September 4, 2017",Passed,223,3,0,13,1,183,0,10,0,0,0,0,224,186,0,23
437,R,115,H R 3180,28-Jul-2017,12:45 PM,On Passage,Intelligence Authorization Act for Fiscal Year 2018,Passed,223,6,0,10,157,29,0,8,0,0,0,0,380,35,0,18
438,R,115,S 114,28-Jul-2017,12:52 PM,On Passage,Department of Veterans Affairs Bonus Transparency Act,Passed,228,0,0,11,186,0,0,8,0,0,0,0,414,0,0,19
439,R,115,H R 3110,5-Sep-2017,6:52 PM,On Motion to Suspend the Rules and Pass,Financial Stability Oversight Council Insurance Member Continuity Act,Passed,226,1,0,12,181,0,0,13,0,0,0,0,407,1,0,25
440,R,115,H R 2864,5-Sep-2017,7:07 PM,"On Motion to Suspend the Rules and Pass, as Amended","To direct the Securities and Exchange Commission to allow certain issuers to be exempt from registration requirements, and for other purposes",Passed,225,2,0,12,178,1,0,15,0,0,0,0,403,3,0,27
441,R,115,H RES 502,6-Sep-2017,12:34 PM,On Motion to Suspend the Rules and Agree,"Providing for the concurrence by the House in the Senate amendments to H.R. 601, with an amendment.",Passed,229,3,0,7,190,0,0,4,0,0,0,0,419,3,0,11
442,R,115,H RES 500,6-Sep-2017,4:08 PM,On Ordering the Previous Question,Providing for consideration of the bill (H.R. 3354) making appropriations for the Dept. of the Interior; providing for consideration of motions to suspend the rules; and waiving a requirement of clause 6(a) of rule XIII with respect to consideration of certain resolutions reported from the Committee on Rules,Passed,233,0,0,6,0,187,0,7,0,0,0,0,233,187,0,13
443,R,115,H RES 500,6-Sep-2017,4:16 PM,On Agreeing to the Resolution,Providing for consideration of the bill (H.R. 3354) making appropriations for the Dept. of the Interior; providing for consideration of motions to suspend the rules; and waiving a requirement of clause 6(a) of rule XIII with respect to consideration of certain resolutions reported from the Committee on Rules,Passed,230,3,0,6,0,188,0,6,0,0,0,0,230,191,0,12
444,R,115,JOURNAL,6-Sep-2017,4:23 PM,On Approving the Journal,None,Passed,145,85,1,8,85,97,1,11,0,0,0,0,230,182,2,19
445,R,115,H R 3354,6-Sep-2017,10:39 PM,On Agreeing to the Amendment,None,Failed,176,54,0,9,0,187,0,7,0,0,0,0,176,241,0,16
446,R,115,H R 3354,6-Sep-2017,10:45 PM,On Agreeing to the Amendment,None,Failed,136,96,0,7,5,183,0,6,0,0,0,0,141,279,0,13
447,R,115,H R 3354,6-Sep-2017,10:49 PM,On Agreeing to the Amendment,None,Failed,136,96,0,7,4,184,0,6,0,0,0,0,140,280,0,13
448,R,115,H R 3354,6-Sep-2017,10:53 PM,On Agreeing to the Amendment,None,Failed,155,76,0,8,4,184,0,6,0,0,0,0,159,260,0,14
449,R,115,H R 3354,6-Sep-2017,10:57 PM,On Agreeing to the Amendment,None,Failed,128,105,0,6,0,188,0,6,0,0,0,0,128,293,0,12
450,R,115,H R 3354,6-Sep-2017,11:00 PM,On Agreeing to the Amendment,None,Failed,16,216,0,7,184,4,0,6,0,0,0,0,200,220,0,13
451,R,115,H R 3354,6-Sep-2017,11:03 PM,On Agreeing to the Amendment,None,Failed,124,108,0,7,0,187,0,7,0,0,0,0,124,295,0,14
452,R,115,H R 3354,6-Sep-2017,11:06 PM,On Agreeing to the Amendment,None,Failed,139,94,0,6,0,188,0,6,0,0,0,0,139,282,0,12
453,R,115,H R 3354,6-Sep-2017,11:09 PM,On Agreeing to the Amendment,None,Failed,180,53,0,6,0,188,0,6,0,0,0,0,180,241,0,12
454,R,115,H R 3354,6-Sep-2017,11:12 PM,On Agreeing to the Amendment,None,Failed,140,92,0,7,0,188,0,6,0,0,0,0,140,280,0,13
455,R,115,H R 3354,6-Sep-2017,11:15 PM,On Agreeing to the Amendment,None,Agreed to,224,8,0,7,1,187,0,6,0,0,0,0,225,195,0,13
456,R,115,H R 3354,6-Sep-2017,11:20 PM,On Agreeing to the Amendment,None,Failed,165,67,0,7,8,179,0,7,0,0,0,0,173,246,0,14
457,R,115,H RES 504,7-Sep-2017,2:12 PM,On Ordering the Previous Question,"Providing for further consideration of the bill (H.R. 3354) making appropriations for the Department of the Interior, environment, and related agencies for the fiscal year ending September 30, 2018, and for other purposes",Passed,227,0,0,12,0,186,0,8,0,0,0,0,227,186,0,20
458,R,115,H RES 504,7-Sep-2017,2:22 PM,On Agreeing to the Resolution,"Providing for further consideration of the bill (H.R. 3354) making appropriations for the Department of the Interior, environment, and related agencies for the fiscal year ending September 30, 2018, and for other purposes",Passed,222,4,0,13,0,186,0,8,0,0,0,0,222,190,0,21
459,R,115,H R 3354,7-Sep-2017,2:29 PM,On Agreeing to the Amendment,None,Failed,20,207,0,12,185,0,0,9,0,0,0,0,205,207,0,21
460,R,115,H R 3354,7-Sep-2017,2:32 PM,On Agreeing to the Amendment,None,Failed,1,226,0,12,169,15,0,10,0,0,0,0,170,241,0,22
461,R,115,H R 3354,7-Sep-2017,2:37 PM,On Agreeing to the Amendment,None,Failed,17,210,0,12,186,1,0,7,0,0,0,0,203,211,0,19
462,R,115,H R 3354,7-Sep-2017,2:41 PM,On Agreeing to the Amendment,None,Failed,0,224,0,15,182,5,0,7,0,0,0,0,182,229,0,22
463,R,115,H R 3354,7-Sep-2017,2:46 PM,On Agreeing to the Amendment,None,Agreed to,215,12,0,12,30,156,0,8,0,0,0,0,245,168,0,20
464,R,115,H R 3354,7-Sep-2017,2:50 PM,On Agreeing to the Amendment,None,Failed,173,54,0,12,0,186,0,8,0,0,0,0,173,240,0,20
465,R,115,H R 3354,7-Sep-2017,2:54 PM,On Agreeing to the Amendment,None,Failed,0,227,0,12,183,3,0,8,0,0,0,0,183,230,0,20
466,R,115,H R 3354,7-Sep-2017,3:11 PM,On Agreeing to the Amendment,None,Failed,0,225,0,14,180,5,0,9,0,0,0,0,180,230,0,23
467,R,115,H R 3354,7-Sep-2017,9:02 PM,On Agreeing to the Amendment,None,Failed,163,62,0,14,0,186,0,8,0,0,0,0,163,248,0,22
468,R,115,H R 3354,7-Sep-2017,9:09 PM,On Agreeing to the Amendment,None,Agreed to,213,11,0,15,4,182,0,8,0,0,0,0,217,193,0,23
469,R,115,H R 3354,7-Sep-2017,9:14 PM,On Agreeing to the Amendment,None,Failed,105,121,0,13,0,186,0,8,0,0,0,0,105,307,0,21
470,R,115,H R 3354,7-Sep-2017,9:19 PM,On Agreeing to the Amendment,None,Failed,196,29,0,14,3,183,0,8,0,0,0,0,199,212,0,22
471,R,115,H R 3354,7-Sep-2017,9:25 PM,On Agreeing to the Amendment,None,Failed,9,217,0,13,182,4,0,8,0,0,0,0,191,221,0,21
472,R,115,H R 3354,7-Sep-2017,9:30 PM,On Agreeing to the Amendment,None,Agreed to,198,28,0,13,9,177,0,8,0,0,0,0,207,205,0,21
473,R,115,H R 3354,7-Sep-2017,9:34 PM,On Agreeing to the Amendment,None,Failed,9,213,0,17,181,5,0,8,0,0,0,0,190,218,0,25
474,R,115,H R 3354,7-Sep-2017,9:38 PM,On Agreeing to the Amendment,None,Failed,184,42,0,13,0,186,0,8,0,0,0,0,184,228,0,21
475,R,115,H R 3354,7-Sep-2017,9:42 PM,On Agreeing to the Amendment,None,Agreed to,35,191,0,13,185,0,0,9,0,0,0,0,220,191,0,22
476,R,115,H R 3354,7-Sep-2017,9:45 PM,On Agreeing to the Amendment,None,Failed,11,215,0,13,183,3,0,8,0,0,0,0,194,218,0,21
477,R,115,H R 3354,7-Sep-2017,9:49 PM,On Agreeing to the Amendment,None,Failed,6,219,0,14,183,1,0,10,0,0,0,0,189,220,0,24
478,R,115,H R 3354,7-Sep-2017,9:52 PM,On Agreeing to the Amendment,None,Agreed to,210,15,0,14,5,181,0,8,0,0,0,0,215,196,0,22
479,R,115,H R 3354,7-Sep-2017,9:56 PM,On Agreeing to the Amendment,None,Agreed to,213,13,0,13,1,184,0,9,0,0,0,0,214,197,0,22
480,R,115,H R 601,8-Sep-2017,10:33 AM,On Motion to Concur in the Senate Adt to the House Adt to the Senate Adt,Reinforcing Education Accountability in Development Act,Passed,133,90,0,16,183,0,0,11,0,0,0,0,316,90,0,27
481,R,115,H R 3354,8-Sep-2017,10:40 AM,On Agreeing to the Amendment,None,Failed,154,68,0,17,2,180,0,12,0,0,0,0,156,248,0,29
482,R,115,H R 3354,8-Sep-2017,10:44 AM,On Agreeing to the Amendment,None,Failed,177,45,0,17,1,182,0,11,0,0,0,0,178,227,0,28
483,R,115,H R 3354,8-Sep-2017,10:50 AM,On Agreeing to the Amendment,None,Failed,4,220,0,15,173,10,0,11,0,0,0,0,177,230,0,26
484,R,115,H R 3354,8-Sep-2017,10:54 AM,On Agreeing to the Amendment,None,Agreed to,214,8,0,17,2,178,0,14,0,0,0,0,216,186,0,31
485,R,115,H R 2611,12-Sep-2017,6:52 PM,On Motion to Suspend the Rules and Pass,Little Rock Central High School National Historic Site Boundary Modification Act,Passed,214,0,0,25,176,0,0,18,0,0,0,0,390,0,0,43
486,R,115,H RES 513,13-Sep-2017,1:20 PM,On Ordering the Previous Question,"Providing for consideration of H.R. 3697, the Criminal Alien Gang Member Removal Act; providing for proceedings during the period from September 15, 2017, through September 22, 2017",Passed,222,0,0,17,0,184,0,10,0,0,0,0,222,184,0,27
487,R,115,H RES 513,13-Sep-2017,1:28 PM,On Agreeing to the Resolution,"Providing for consideration of H.R. 3697, the Criminal Alien Gang Member Removal Act; providing for proceedings during the period from September 15, 2017, through September 22, 2017",Passed,222,0,0,17,0,186,0,8,0,0,0,0,222,186,0,25
488,R,115,H R 3354,13-Sep-2017,1:41 PM,On Agreeing to the Amendment,None,Agreed to,215,11,0,13,3,184,0,7,0,0,0,0,218,195,0,20
489,R,115,H R 3354,13-Sep-2017,1:45 PM,On Agreeing to the Amendment,None,Agreed to,221,5,0,13,4,181,0,9,0,0,0,0,225,186,0,22
490,R,115,H R 3354,13-Sep-2017,1:51 PM,On Agreeing to the Amendment,None,Failed,17,209,0,13,184,3,0,7,0,0,0,0,201,212,0,20
491,R,115,H R 3354,13-Sep-2017,1:54 PM,On Agreeing to the Amendment,None,Failed,13,211,0,15,185,1,0,8,0,0,0,0,198,212,0,23
492,R,115,H R 3354,13-Sep-2017,1:58 PM,On Agreeing to the Amendment,None,Failed,150,75,0,14,1,185,0,8,0,0,0,0,151,260,0,22
493,R,115,H R 3354,13-Sep-2017,5:29 PM,On Agreeing to the Amendment,None,Agreed to,90,136,0,13,189,1,0,4,0,0,0,0,279,137,0,17
494,R,115,H R 3354,13-Sep-2017,5:32 PM,On Agreeing to the Amendment,None,Failed,95,127,0,17,3,186,0,5,0,0,0,0,98,313,0,22
495,R,115,H R 3354,13-Sep-2017,5:35 PM,On Agreeing to the Amendment,None,Failed,3,223,0,13,189,0,0,5,0,0,0,0,192,223,0,18
496,R,115,H R 3354,13-Sep-2017,5:38 PM,On Agreeing to the Amendment,None,Failed,3,222,0,14,186,3,0,5,0,0,0,0,189,225,0,19
497,R,115,H R 3354,13-Sep-2017,5:41 PM,On Agreeing to the Amendment,None,Agreed to,214,11,0,14,2,188,0,4,0,0,0,0,216,199,0,18
498,R,115,H R 3354,13-Sep-2017,5:45 PM,On Agreeing to the Amendment,None,Agreed to,222,6,0,11,4,185,0,5,0,0,0,0,226,191,0,16
499,R,115,H R 3354,13-Sep-2017,5:47 PM,On Agreeing to the Amendment,None,Agreed to,57,170,0,12,190,0,0,4,0,0,0,0,247,170,0,16
500,R,115,H R 3354,13-Sep-2017,5:51 PM,On Agreeing to the Amendment,None,Failed,10,218,0,11,189,1,0,4,0,0,0,0,199,219,0,15
501,R,115,H R 3354,13-Sep-2017,5:54 PM,On Agreeing to the Amendment,None,Agreed to,30,198,0,11,190,0,0,4,0,0,0,0,220,198,0,15
502,R,115,H R 3354,13-Sep-2017,5:57 PM,On Agreeing to the Amendment,None,Agreed to,53,175,0,11,190,0,0,4,0,0,0,0,243,175,0,15
503,R,115,H R 3354,13-Sep-2017,6:00 PM,On Agreeing to the Amendment,None,Agreed to,38,189,0,12,187,3,0,4,0,0,0,0,225,192,0,16
504,R,115,H R 3354,13-Sep-2017,6:04 PM,On Agreeing to the Amendment,None,Failed,131,96,0,12,67,123,0,4,0,0,0,0,198,219,0,16
505,R,115,H R 3354,13-Sep-2017,6:07 PM,On Agreeing to the Amendment,None,Agreed to,23,205,0,11,190,0,0,4,0,0,0,0,213,205,0,15
506,R,115,H R 3354,13-Sep-2017,6:10 PM,On Agreeing to the Amendment,None,Agreed to,39,187,0,13,189,1,0,4,0,0,0,0,228,188,0,17
507,R,115,H R 3354,13-Sep-2017,6:13 PM,On Agreeing to the Amendment,None,Failed,19,208,0,12,185,4,0,5,0,0,0,0,204,212,0,17
508,R,115,H R 3354,13-Sep-2017,6:17 PM,On Agreeing to the Amendment,None,Failed,149,77,1,12,4,186,0,4,0,0,0,0,153,263,1,16
509,R,115,H R 3354,13-Sep-2017,6:21 PM,On Agreeing to the Amendment,None,Failed,131,96,0,12,0,189,0,5,0,0,0,0,131,285,0,17
510,R,115,H R 3354,13-Sep-2017,6:24 PM,On Agreeing to the Amendment,None,Failed,175,52,0,12,0,189,0,5,0,0,0,0,175,241,0,17
511,R,115,H R 3354,13-Sep-2017,6:27 PM,On Agreeing to the Amendment,None,Failed,177,49,1,12,1,189,0,4,0,0,0,0,178,238,1,16
512,R,115,H R 3354,13-Sep-2017,6:30 PM,On Agreeing to the Amendment,None,Agreed to,220,7,0,12,1,189,0,4,0,0,0,0,221,196,0,16
513,R,115,H R 3354,13-Sep-2017,6:33 PM,On Agreeing to the Amendment,None,Failed,156,70,0,13,0,190,0,4,0,0,0,0,156,260,0,17
514,R,115,H R 3354,13-Sep-2017,6:36 PM,On Agreeing to the Amendment,None,Failed,3,224,0,12,188,2,0,4,0,0,0,0,191,226,0,16
515,R,115,H R 3354,13-Sep-2017,6:39 PM,On Agreeing to the Amendment,None,Agreed to,214,13,0,12,1,188,0,5,0,0,0,0,215,201,0,17
516,R,115,H R 3697,14-Sep-2017,10:50 AM,On Motion to Recommit with Instructions,Criminal Alien Gang Member Removal Act,Failed,0,220,0,19,184,0,0,10,0,0,0,0,184,220,0,29
517,R,115,H R 3697,14-Sep-2017,10:59 AM,On Passage,Criminal Alien Gang Member Removal Act,Passed,222,1,0,16,11,174,0,9,0,0,0,0,233,175,0,25
518,R,115,H R 3354,14-Sep-2017,11:06 AM,On Agreeing to the Amendment,None,Agreed to,212,11,0,16,2,183,0,9,0,0,0,0,214,194,0,25
519,R,115,H R 3354,14-Sep-2017,11:09 AM,On Agreeing to the Amendment,None,Failed,186,37,0,16,0,186,0,8,0,0,0,0,186,223,0,24
520,R,115,H R 3354,14-Sep-2017,11:13 AM,On Agreeing to the Amendment,None,Failed,0,222,0,17,186,0,0,8,0,0,0,0,186,222,0,25
521,R,115,H R 3354,14-Sep-2017,11:17 AM,On Agreeing to the Amendment,None,Failed,2,221,0,16,181,5,0,8,0,0,0,0,183,226,0,24
522,R,115,H R 3354,14-Sep-2017,11:20 AM,On Agreeing to the Amendment,None,Failed,1,222,0,16,162,23,0,9,0,0,0,0,163,245,0,25
523,R,115,H R 3354,14-Sep-2017,11:24 AM,On Agreeing to the Amendment,None,Failed,4,218,0,17,182,3,0,9,0,0,0,0,186,221,0,26
524,R,115,H R 3354,14-Sep-2017,11:28 AM,On Agreeing to the Amendment,None,Failed,166,56,0,17,0,185,0,9,0,0,0,0,166,241,0,26
525,R,115,H R 3354,14-Sep-2017,11:31 AM,On Agreeing to the Amendment,None,Agreed to,211,10,0,18,0,185,0,9,0,0,0,0,211,195,0,27
526,R,115,H R 3354,14-Sep-2017,11:35 AM,On Agreeing to the Amendment,None,Agreed to,82,140,0,17,183,3,0,8,0,0,0,0,265,143,0,25
527,R,115,H R 3354,14-Sep-2017,11:52 AM,On Motion to Recommit with Instructions,"Making appropriations for the Department of the Interior, environment, and related agencies for the fiscal year ending September 30, 2018, and for other purposes",Failed,0,223,0,16,186,0,0,8,0,0,0,0,186,223,0,24
528,R,115,H R 3354,14-Sep-2017,11:59 AM,On Passage,"Making appropriations for the Department of the Interior, environment, and related agencies for the fiscal year ending September 30, 2018, and for other purposes",Passed,210,14,0,16,1,184,0,9,0,0,0,0,211,198,0,25
529,R,115,H R 3284,14-Sep-2017,12:05 PM,"On Motion to Suspend the Rules and Pass, as Amended",Joint Counterterrorism Awareness Workshop Series Act,Passed,216,4,0,19,182,0,0,12,0,0,0,0,398,4,0,31
530,R,115,H R 3823,25-Sep-2017,6:52 PM,On Motion to Suspend the Rules and Pass,Disaster Tax Relief and Airport and Airway Extension Act,Failed,219,8,0,12,26,163,0,5,0,0,0,0,245,171,0,17
531,R,115,H R 2061,25-Sep-2017,6:59 PM,"On Motion to Suspend the Rules and Pass, as Amended",North Korean Human Rights Reauthorization Act,Passed,227,0,0,12,188,0,0,6,0,0,0,0,415,0,0,18
532,R,115,H RES 533,26-Sep-2017,1:27 PM,On Ordering the Previous Question,Providing for consideration of the bill (H.R. 2824) Increasing Opportunity through Evidence-Based Home Visiting Act and providing for consideration of the bill (H.R. 2792) Control Unlawful Fugitive Felons Act,Passed,230,0,0,9,0,189,0,5,0,0,0,0,230,189,0,14
533,R,115,H RES 533,26-Sep-2017,1:37 PM,On Agreeing to the Resolution,Providing for consideration of the bill (H.R. 2824) Increasing Opportunity through Evidence-Based Home Visiting Act and providing for consideration of the bill (H.R. 2792) Control Unlawful Fugitive Felons Act,Passed,230,0,0,9,0,190,0,4,0,0,0,0,230,190,0,13
534,R,115,JOURNAL,26-Sep-2017,1:44 PM,On Approving the Journal,None,Passed,136,91,0,12,78,108,1,7,0,0,0,0,214,199,1,19
535,R,115,H R 2824,26-Sep-2017,3:40 PM,On Agreeing to the Amendment,None,Failed,1,231,0,7,190,0,0,4,0,0,0,0,191,231,0,11
536,R,115,H R 2824,26-Sep-2017,3:58 PM,On Motion to Recommit with Instructions,Increasing Opportunity and Success for Children and Parents through Evidence-Based Home Visiting Act,Failed,0,232,0,7,191,0,0,3,0,0,0,0,191,232,0,10
537,R,115,H R 2824,26-Sep-2017,4:04 PM,On Passage,Increasing Opportunity and Success for Children and Parents through Evidence-Based Home Visiting Act,Passed,212,20,0,7,2,189,0,3,0,0,0,0,214,209,0,10
538,R,115,H RES 538,27-Sep-2017,5:13 PM,On Ordering the Previous Question,"Providing for consideration of H.R. 3823, Disaster Tax Relief and Airport and Airway Extension Act of 2017; and providing for consideration of motions to suspend the rules",Passed,223,0,0,16,0,187,0,7,0,0,0,0,223,187,0,23
539,R,115,H RES 538,27-Sep-2017,5:22 PM,On Agreeing to the Resolution,"Providing for consideration of H.R. 3823, Disaster Tax Relief and Airport and Airway Extension Act of 2017; and providing for consideration of motions to suspend the rules",Passed,218,7,0,14,5,183,0,6,0,0,0,0,223,190,0,20
540,R,115,H RES 311,27-Sep-2017,5:29 PM,"On Motion to Suspend the Rules and Agree, as Amended","Recognizing that for 50 years the Association of South East Asian Nations (ASEAN) has worked toward stability, prosperity, and peace in Southeast Asia",Passed,225,0,0,14,188,0,0,6,0,0,0,0,413,0,0,20
541,R,115,H R 3823,28-Sep-2017,10:51 AM,On Motion to Recommit with Instructions,Disaster Tax Relief and Airport and Airway Extension Act of 2017,Failed,0,227,0,12,188,0,0,6,0,0,0,0,188,227,0,18
542,R,115,H R 3823,28-Sep-2017,11:24 AM,On Passage,Disaster Tax Relief and Airport and Airway Extension Act of 2017,Passed,221,7,0,11,43,148,0,3,0,0,0,0,264,155,0,14
543,R,115,H R 2792,28-Sep-2017,11:32 AM,On Passage,Control Unlawful Fugitive Felons Act of 2017,Passed,223,3,0,13,21,168,0,5,0,0,0,0,244,171,0,18
544,R,115,H R 1547,2-Oct-2017,6:51 PM,On Motion to Suspend the Rules and Pass,Udall Park Land Exchange Completion Act,Passed,229,0,0,10,172,0,0,22,0,0,0,0,401,0,0,32
545,R,115,H R 965,2-Oct-2017,7:00 PM,"On Motion to Suspend the Rules and Pass, as Amended",Saint-Gaudens National Historical Park Redesignation Act,Passed,229,0,0,10,172,0,0,22,0,0,0,0,401,0,0,32
546,R,115,H RES 548,3-Oct-2017,1:53 PM,On Ordering the Previous Question,"Providing for consideration of the bill (H.R. 36) to amend title 18, United States Code, to protect pain-capable unborn children, and for other purposes",Passed,233,0,0,6,0,184,0,10,0,0,0,0,233,184,0,16
547,R,115,H RES 548,3-Oct-2017,1:59 PM,On Agreeing to the Resolution,"Providing for consideration of the bill (H.R. 36) to amend title 18, United States Code, to protect pain-capable unborn children, and for other purposes",Passed,232,0,0,7,1,187,0,6,0,0,0,0,233,187,0,13
548,R,115,H R 36,3-Oct-2017,5:55 PM,On Motion to Recommit with Instructions,Pain-Capable Unborn Child Protection Act,Failed,0,236,0,3,187,2,0,5,0,0,0,0,187,238,0,8
549,R,115,H R 36,3-Oct-2017,6:02 PM,On Passage,Pain-Capable Unborn Child Protection Act,Passed,234,2,0,3,3,187,0,4,0,0,0,0,237,189,0,7
550,R,115,S 782,3-Oct-2017,6:10 PM,"On Motion to Suspend the Rules and Pass, as Amended","To reauthorize the National Internet Crimes Against Children Task Force Program, and for other purposes",Passed,231,2,0,6,186,1,0,7,0,0,0,0,417,3,0,13
551,R,115,H RES 553,4-Oct-2017,1:51 PM,On Ordering the Previous Question,Providing for consideration of the concurrent resolution (H. Con. Res. 71) establishing the congressional budget for the United States Government for fiscal year 2018 and setting forth the appropriate budgetary levels for fiscal years 2019 through 2027,Passed,231,0,0,8,0,189,0,5,0,0,0,0,231,189,0,13
552,R,115,H RES 553,4-Oct-2017,1:59 PM,On Agreeing to the Resolution,Providing for consideration of the concurrent resolution (H. Con. Res. 71) establishing the congressional budget for the United States Government for fiscal year 2018 and setting forth the appropriate budgetary levels for fiscal years 2019 through 2027,Passed,232,0,0,7,0,188,0,6,0,0,0,0,232,188,0,13
553,R,115,H CON RES 71,4-Oct-2017,9:10 PM,On Agreeing to the Amendment,None,Failed,0,235,0,4,108,79,0,7,0,0,0,0,108,314,0,11
554,R,115,H CON RES 71,4-Oct-2017,9:17 PM,On Agreeing to the Amendment,None,Failed,0,235,0,4,130,57,0,7,0,0,0,0,130,292,0,11
555,R,115,H CON RES 71,5-Oct-2017,10:11 AM,On Agreeing to the Amendment,None,Failed,139,95,0,5,0,186,0,8,0,0,0,0,139,281,0,13
556,R,115,H CON RES 71,5-Oct-2017,11:11 AM,On Agreeing to the Amendment,None,Failed,0,236,0,3,156,32,0,6,0,0,0,0,156,268,0,9
557,R,115,H CON RES 71,5-Oct-2017,11:48 AM,On Agreeing to the Resolution,Establishing the congressional budget for the United States Government for fiscal year 2018 and setting forth the appropriate budgetary levels for fiscal years 2019 through 2027,Passed,219,18,0,3,0,188,0,6,0,0,0,0,219,206,0,9
558,R,115,H R 1858,10-Oct-2017,6:52 PM,On Motion to Suspend the Rules and Pass,"To designate the facility of the United States Postal Service located at 4514 Williamson Trail in Liberty, Pennsylvania, as the “Staff Sergeant Ryan Scott Ostrom Post Office”",Passed,222,0,0,17,175,0,0,19,0,0,0,0,397,0,0,36
559,R,115,H R 2464,10-Oct-2017,7:01 PM,On Motion to Suspend the Rules and Pass,"To designate the facility of the United States Postal Service located at 25 New Chardon Street Lobby in Boston, Massachusetts, as the “John Fitzgerald Kennedy Post Office”",Passed,220,0,0,19,175,0,0,19,0,0,0,0,395,0,0,38
560,R,115,H RES 562,11-Oct-2017,1:44 PM,On Ordering the Previous Question,"Providing for consideration of S. 585, the Dr. Chris Kirkpatrick Whistleblower Protection Act of 2017; providing for proceedings during the period from October 16, 2017, through October 20, 2017; and providing for consideration of motions to suspend the rules",Passed,227,0,0,12,0,190,0,4,0,0,0,0,227,190,0,16
561,R,115,H RES 562,11-Oct-2017,1:50 PM,On Agreeing to the Resolution,"Providing for consideration of S. 585, the Dr. Chris Kirkpatrick Whistleblower Protection Act of 2017; providing for proceedings during the period from October 16, 2017, through October 20, 2017; and providing for consideration of motions to suspend the rules",Passed,227,2,0,10,7,183,0,4,0,0,0,0,234,185,0,14
562,R,115,H R 452,11-Oct-2017,4:54 PM,On Motion to Suspend the Rules and Pass,"To designate the facility of the United States Postal Service located at 324 West Saint Louis Street in Pacific, Missouri, as the “Specialist Jeffrey L. White, Jr. Post Office”",Passed,227,0,0,12,191,0,0,3,0,0,0,0,418,0,0,15
563,R,115,H R 3243,11-Oct-2017,5:02 PM,On Motion to Suspend the Rules and Pass,FITARA Enhancement Act of 2017,Passed,227,0,0,12,191,0,0,3,0,0,0,0,418,0,0,15
564,R,115,H R 2810,12-Oct-2017,3:08 PM,On Motion to Instruct Conferees,National Defense Authorization Act for Fiscal Year 2018,Failed,1,231,0,7,183,6,0,5,0,0,0,0,184,237,0,12
565,R,115,H R 2810,12-Oct-2017,3:15 PM,On Closing Portions of the Conference,National Defense Authorization Act for Fiscal Year 2018,Passed,228,5,0,6,186,3,0,5,0,0,0,0,414,8,0,11
566,R,115,H RES 569,12-Oct-2017,3:23 PM,On Motion to Suspend the Rules and Agree,"Providing for the concurrence by the House in the Senate amendment to H.R. 2266, with an amendment",Passed,164,69,0,6,189,0,0,5,0,0,0,0,353,69,0,11
567,R,115,S 585,12-Oct-2017,3:31 PM,On Motion to Recommit with Instructions,Dr. Chris Kirkpatrick Whistleblower Protection Act of 2017,Failed,1,232,0,6,189,0,0,5,0,0,0,0,190,232,0,11
568,R,115,S 585,12-Oct-2017,3:38 PM,On Passage,Dr. Chris Kirkpatrick Whistleblower Protection Act of 2017,Passed,232,0,0,7,188,0,0,6,0,0,0,0,420,0,0,13
569,R,115,H R 3551,23-Oct-2017,6:53 PM,"On Motion to Suspend the Rules and Pass, as Amended",C-TPAT Reauthorization Act,Passed,222,1,0,15,180,0,0,14,0,0,0,0,402,1,0,29
570,R,115,S 504,23-Oct-2017,7:01 PM,On Motion to Suspend the Rules and Pass,Asia-Pacific Economic Cooperation Business Travel Cards Act,Passed,220,2,0,16,181,0,0,13,0,0,0,0,401,2,0,29
571,R,115,JOURNAL,23-Oct-2017,7:09 PM,On Approving the Journal,None,Passed,134,83,1,20,102,75,1,16,0,0,0,0,236,158,2,36
572,R,115,H RES 577,24-Oct-2017,1:37 PM,On Ordering the Previous Question,"Providing for consideration of H.R. 469, the Sunshine for Regulations and Regulatory Decrees and Settlements Act of 2017; providing for consideration of H.R. 732, the Stop Settlement Slush Funds Act of 2017",Passed,228,0,0,10,0,189,0,5,0,0,0,0,228,189,0,15
573,R,115,H RES 577,24-Oct-2017,1:44 PM,On Agreeing to the Resolution,"Providing for consideration of H.R. 469, the Sunshine for Regulations and Regulatory Decrees and Settlements Act of 2017; providing for consideration of H.R. 732, the Stop Settlement Slush Funds Act of 2017",Passed,227,0,0,11,0,190,0,4,0,0,0,0,227,190,0,15
574,R,115,H R 2142,24-Oct-2017,1:55 PM,"On Motion to Suspend the Rules and Pass, as Amended",International Narcotics Trafficking Emergency Response by Detecting Incoming Contraband with Technology Act,Passed,226,2,0,10,186,1,0,7,0,0,0,0,412,3,0,17
575,R,115,H R 732,24-Oct-2017,5:21 PM,On Agreeing to the Amendment,None,Failed,0,230,0,8,187,3,0,4,0,0,0,0,187,233,0,12
576,R,115,H R 732,24-Oct-2017,5:26 PM,On Agreeing to the Amendment,None,Failed,0,229,1,8,183,6,0,5,0,0,0,0,183,235,1,13
577,R,115,H R 732,24-Oct-2017,5:30 PM,On Agreeing to the Amendment,None,Failed,0,229,0,9,185,5,0,4,0,0,0,0,185,234,0,13
578,R,115,H R 732,24-Oct-2017,5:35 PM,On Agreeing to the Amendment,None,Failed,3,227,0,8,186,4,0,4,0,0,0,0,189,231,0,12
579,R,115,H R 732,24-Oct-2017,5:39 PM,On Agreeing to the Amendment,None,Failed,4,226,0,8,187,3,0,4,0,0,0,0,191,229,0,12
580,R,115,H R 732,24-Oct-2017,5:47 PM,On Passage,Stop Settlement Slush Funds Act,Passed,231,0,0,7,7,183,0,4,0,0,0,0,238,183,0,11
581,R,115,H R 3898,24-Oct-2017,5:53 PM,"On Motion to Suspend the Rules and Pass, as Amended",Otto Warmbier North Korea Nuclear Sanctions Act,Passed,228,2,0,8,187,0,0,7,0,0,0,0,415,2,0,15
582,R,115,H RES 580,25-Oct-2017,1:57 PM,On Ordering the Previous Question,"Providing for consideration of the Senate amendment to H.Con.Res. 71, establishing the congressional budget for the United States Government for fiscal year 2018 and setting forth the appropriate budgetary levels for fiscal years 2019 through 2027",Passed,229,1,0,8,0,187,0,7,0,0,0,0,229,188,0,15
583,R,115,H RES 580,25-Oct-2017,2:05 PM,On Agreeing to the Resolution,"Providing for consideration of the Senate amendment to H.Con.Res. 71, establishing the congressional budget for the United States Government for fiscal year 2018 and setting forth the appropriate budgetary levels for fiscal years 2019 through 2027",Passed,233,1,0,4,0,187,0,7,0,0,0,0,233,188,0,11
584,R,115,JOURNAL,25-Oct-2017,2:10 PM,On Approving the Journal,None,Passed,146,82,1,9,84,98,1,11,0,0,0,0,230,180,2,20
585,R,115,H R 469,25-Oct-2017,6:05 PM,On Agreeing to the Amendment,None,Failed,0,230,0,8,185,1,0,8,0,0,0,0,185,231,0,16
586,R,115,H R 469,25-Oct-2017,6:09 PM,On Agreeing to the Amendment,None,Failed,3,226,0,9,184,0,0,10,0,0,0,0,187,226,0,19
587,R,115,H R 469,25-Oct-2017,6:14 PM,On Agreeing to the Amendment,None,Failed,0,232,0,6,186,0,0,8,0,0,0,0,186,232,0,14
588,R,115,H R 469,25-Oct-2017,6:27 PM,On Passage,Sunshine for Regulations and Regulatory Decrees and Settlements Act,Passed,232,0,0,6,2,187,0,5,0,0,0,0,234,187,0,11
589,R,115,H CON RES 71,26-Oct-2017,10:59 AM,On Motion to Concur in the Senate Amendment,Establishing the congressional budget for the United States Government for fiscal year 2018 and setting forth the appropriate budgetary levels for fiscal years 2019 through 2027,Passed,216,20,0,3,0,192,0,2,0,0,0,0,216,212,0,5
590,R,115,H R 1698,26-Oct-2017,11:06 AM,"On Motion to Suspend the Rules and Pass, as Amended",Iran Ballistic Missiles and International Sanctions Enforcement Act,Passed,232,2,0,4,191,0,0,3,0,0,0,0,423,2,0,7
591,R,115,H R 2521,31-Oct-2017,6:55 PM,On Motion to Suspend the Rules and Pass,South Carolina Peanut Parity Act of 2017,Passed,218,0,0,20,176,1,0,17,0,0,0,0,394,1,0,37
592,R,115,H RES 595,1-Nov-2017,1:45 PM,On Ordering the Previous Question,Providing for consideration of the bill (H.R. 2936) Resilient Federal Forests Act and for other purposes,Passed,232,0,0,6,0,184,0,10,0,0,0,0,232,184,0,16
593,R,115,H RES 595,1-Nov-2017,1:53 PM,On Agreeing to the Resolution,Providing for consideration of the bill (H.R. 2936) Resilient Federal Forests Act and for other purposes,Passed,231,0,0,7,1,184,0,9,0,0,0,0,232,184,0,16
594,R,115,H R 2936,1-Nov-2017,5:45 PM,On Agreeing to the Amendment,None,Failed,5,227,0,6,184,5,0,5,0,0,0,0,189,232,0,11
595,R,115,H R 2936,1-Nov-2017,5:50 PM,On Agreeing to the Amendment,None,Failed,6,225,0,7,188,1,0,5,0,0,0,0,194,226,0,12
596,R,115,H R 2936,1-Nov-2017,5:55 PM,On Agreeing to the Amendment,None,Agreed to,229,3,0,6,7,181,0,6,0,0,0,0,236,184,0,12
597,R,115,H R 2936,1-Nov-2017,6:11 PM,On Motion to Recommit with Instructions,Resilient Federal Forests Act of 2017,Failed,2,230,0,6,187,0,0,7,0,0,0,0,189,230,0,13
598,R,115,H R 2936,1-Nov-2017,6:18 PM,On Passage,Resilient Federal Forests Act of 2017,Passed,222,9,0,7,10,179,0,5,0,0,0,0,232,188,0,12
599,R,115,H R 3903,1-Nov-2017,6:24 PM,"On Motion to Suspend the Rules and Pass, as Amended",Encouraging Public Offerings Act,Passed,232,0,0,6,187,0,0,7,0,0,0,0,419,0,0,13
600,R,115,H RES 600,2-Nov-2017,3:16 PM,On Ordering the Previous Question,"Providing for consideration of the bill H.R. 849, Protecting Seniors Access to Medicare Act.",Passed,230,1,0,7,0,192,0,2,0,0,0,0,230,193,0,9
601,R,115,H RES 600,2-Nov-2017,3:24 PM,On Agreeing to the Resolution,"Providing for consideration of the bill H.R. 849, Protecting Seniors Access to Medicare Act.",Passed,229,0,0,9,11,178,0,5,0,0,0,0,240,178,0,14
602,R,115,H RES 601,2-Nov-2017,3:31 PM,On Ordering the Previous Question,"Providing for consideration of H.R. 3922, the Community Health and Medical Professionals Improve Our Nation Act",Passed,230,1,0,7,0,190,0,4,0,0,0,0,230,191,0,11
603,R,115,H RES 601,2-Nov-2017,3:38 PM,On Agreeing to the Resolution,"Providing for consideration of H.R. 3922, the Community Health and Medical Professionals Improve Our Nation Act",Passed,231,0,0,7,0,192,0,2,0,0,0,0,231,192,0,9
604,R,115,H R 849,2-Nov-2017,5:11 PM,On Passage,Protecting Seniors Access to Medicare Act,Passed,231,0,0,7,76,111,0,7,0,0,0,0,307,111,0,14
605,R,115,H R 3922,3-Nov-2017,10:58 AM,On Motion to Recommit with Instructions,Community Health and Medical Professionals Improve Our Nation Act of 2017,Failed,0,231,0,7,187,0,0,7,0,0,0,0,187,231,0,14
606,R,115,H R 3922,3-Nov-2017,11:06 AM,On Passage,Community Health and Medical Professionals Improve Our Nation Act of 2017,Passed,227,3,0,8,15,171,0,8,0,0,0,0,242,174,0,16
607,R,115,H R 3562,6-Nov-2017,6:53 PM,On Motion to Suspend the Rules and Pass,"To amend title 38, United States Code, to authorize the Secretary of Veterans Affairs to furnish assistance for adaptations of residences of veterans in rehabilitation programs under chapter 31 of such title, and for other purposes",Passed,223,0,0,15,177,0,0,17,0,0,0,0,400,0,0,32
608,R,115,H R 1066,6-Nov-2017,7:03 PM,On Motion to Suspend the Rules and Pass,VA Management Alignment Act,Passed,223,0,0,15,176,0,0,18,0,0,0,0,399,0,0,33
609,R,115,JOURNAL,6-Nov-2017,7:11 PM,On Approving the Journal,None,Passed,134,86,1,17,88,83,2,21,0,0,0,0,222,169,3,38
610,R,115,H RES 607,7-Nov-2017,1:48 PM,On Ordering the Previous Question,Providing for consideration of the bill (H.R. 3043) Hydropower Policy Modernization Act and providing for consideration of the bill (H.R. 3441) Save Local Business Act,Passed,232,1,0,5,1,181,0,12,0,0,0,0,233,182,0,17
611,R,115,H RES 607,7-Nov-2017,1:57 PM,On Agreeing to the Resolution,Providing for consideration of the bill (H.R. 3043) Hydropower Policy Modernization Act and providing for consideration of the bill (H.R. 3441) Save Local Business Act,Passed,233,0,0,5,0,182,0,12,0,0,0,0,233,182,0,17
612,R,115,JOURNAL,7-Nov-2017,2:03 PM,On Approving the Journal,None,Passed,144,87,1,6,81,97,2,14,0,0,0,0,225,184,3,20
613,R,115,H R 3441,7-Nov-2017,6:14 PM,On Motion to Recommit with Instructions,Save Local Business Act,Failed,1,233,0,4,185,2,0,7,0,0,0,0,186,235,0,11
614,R,115,H R 3441,7-Nov-2017,6:23 PM,On Passage,Save Local Business Act,Passed,234,0,0,4,8,181,0,5,0,0,0,0,242,181,0,9
615,R,115,H R 3911,7-Nov-2017,6:29 PM,On Motion to Suspend the Rules and Pass,Risk-Based Credit Examination Act,Passed,232,1,0,5,157,31,0,6,0,0,0,0,389,32,0,11
616,R,115,H RES 609,8-Nov-2017,1:26 PM,On Ordering the Previous Question,"Providing for consideration of H.R. 2201, the Micro Offering Safe Harbor Act",Passed,224,0,0,14,0,190,0,4,0,0,0,0,224,190,0,18
617,R,115,H RES 609,8-Nov-2017,1:34 PM,On Agreeing to the Resolution,"Providing for consideration of H.R. 2201, the Micro Offering Safe Harbor Act",Passed,233,0,0,5,0,190,0,4,0,0,0,0,233,190,0,9
618,R,115,H R 4173,8-Nov-2017,1:40 PM,"On Motion to Suspend the Rules and Pass, as Amended",Veterans Crisis Line Study Act of 2017,Passed,230,0,0,8,190,0,0,4,0,0,0,0,420,0,0,12
619,R,115,H R 3043,8-Nov-2017,4:54 PM,On Agreeing to the Amendment,None,Failed,4,229,0,5,181,5,0,8,0,0,0,0,185,234,0,13
620,R,115,H R 3043,8-Nov-2017,5:02 PM,On Passage,Hydropower Policy Modernization Act of 2017,Passed,231,3,0,4,26,163,0,5,0,0,0,0,257,166,0,9
621,R,115,H R 3705,8-Nov-2017,5:09 PM,"On Motion to Suspend the Rules and Pass, as Amended",Veterans Fair Debt Notice Act of 2017,Passed,233,0,0,5,189,0,0,5,0,0,0,0,422,0,0,10
622,R,115,H R 2201,9-Nov-2017,11:22 AM,On Passage,Micro Offering Safe Harbor Act,Passed,232,1,0,5,0,187,0,7,0,0,0,0,232,188,0,12
623,R,115,H RES 599,13-Nov-2017,6:58 PM,On Agreeing to the Resolution,"Expressing the sense of the House of Representatives with respect to United States policy towards Yemen, and for other purposes",Passed,203,19,0,16,163,11,1,19,0,0,0,0,366,30,1,35
624,R,115,H R 3071,13-Nov-2017,7:14 PM,"On Motion to Suspend the Rules and Pass, as Amended",Federal Acquisition Savings Act of 2017,Passed,221,0,0,18,175,0,0,19,0,0,0,0,396,0,0,37
625,R,115,JOURNAL,13-Nov-2017,7:20 PM,On Approving the Journal,None,Passed,132,85,1,21,88,80,1,25,0,0,0,0,220,165,2,46
626,R,115,H RES 616,14-Nov-2017,1:37 PM,On Ordering the Previous Question,"Providing for consideration of H.R. 2874, the 21st Century Flood Reform Act; and the conference report to accompany H.R. 2810, the National Defense Authorization Act for Fiscal Year 2018",Passed,234,0,0,5,0,189,0,5,0,0,0,0,234,189,0,10
627,R,115,H RES 616,14-Nov-2017,1:44 PM,On Agreeing to the Resolution,"Providing for consideration of H.R. 2874, the 21st Century Flood Reform Act; and the conference report to accompany H.R. 2810, the National Defense Authorization Act for Fiscal Year 2018",Passed,229,2,0,8,4,185,0,5,0,0,0,0,233,187,0,13
628,R,115,JOURNAL,14-Nov-2017,1:50 PM,On Approving the Journal,None,Passed,138,90,0,11,86,100,1,7,0,0,0,0,224,190,1,18
629,R,115,H R 2874,14-Nov-2017,4:56 PM,On Motion to Recommit with Instructions,21st Century Flood Reform Act,Failed,0,236,0,3,190,0,0,4,0,0,0,0,190,236,0,7
630,R,115,H R 2874,14-Nov-2017,5:03 PM,On Passage,21st Century Flood Reform Act,Passed,222,14,0,3,15,175,0,4,0,0,0,0,237,189,0,7
631,R,115,H R 2810,14-Nov-2017,5:11 PM,On Agreeing to the Conference Report,National Defense Authorization Act for Fiscal Year 2018,Passed,229,7,0,3,127,63,0,4,0,0,0,0,356,70,0,7
632,R,115,H RES 619,15-Nov-2017,2:20 PM,On Ordering the Previous Question,"Providing for consideration of H.R. 1, Tax Cuts and Jobs Act; and providing for proceedings during the period from November 17, 2017, through November 27, 2017",Passed,234,1,0,4,0,192,0,2,0,0,0,0,234,193,0,6
633,R,115,H RES 619,15-Nov-2017,2:29 PM,On Agreeing to the Resolution,"Providing for consideration of H.R. 1, Tax Cuts and Jobs Act; and providing for proceedings during the period from November 17, 2017, through November 27, 2017",Passed,235,0,0,4,0,191,0,3,0,0,0,0,235,191,0,7
634,R,115,H R 2331,15-Nov-2017,2:35 PM,"On Motion to Suspend the Rules and Pass, as Amended",Connected Government Act,Passed,234,0,0,5,189,0,0,5,0,0,0,0,423,0,0,10
635,R,115,H R 3821,15-Nov-2017,4:41 PM,"On Motion to Suspend the Rules and Pass, as Amended","To designate the facility of the United States Postal Service located at 430 Main Street in Clermont, Georgia, as the “Zachary Addington Post Office”",Passed,230,0,0,9,190,0,0,4,0,0,0,0,420,0,0,13
636,R,115,H R 2672,15-Nov-2017,4:48 PM,On Motion to Suspend the Rules and Pass,"To designate the facility of the United States Postal Service located at 520 Carter Street in Fairview, Illinois, as the “Sgt. Douglas J. Riney Post Office”",Passed,231,0,0,8,192,0,0,2,0,0,0,0,423,0,0,10
637,R,115,H R 1,16-Nov-2017,1:48 PM,On Passage,Tax Cuts and Jobs Act,Passed,227,13,0,0,0,192,0,2,0,0,0,0,227,205,0,2
638,R,115,H R 2768,28-Nov-2017,6:56 PM,On Motion to Suspend the Rules and Pass,Fowler and Boskoff Peaks Designation Act,Passed,225,0,0,14,184,0,0,10,0,0,0,0,409,0,0,24
639,R,115,H R 3115,28-Nov-2017,7:04 PM,"On Motion to Suspend the Rules and Pass, as Amended",Superior National Forest Land Exchange Act,Passed,220,4,0,15,89,95,0,10,0,0,0,0,309,99,0,25
640,R,115,H RES 631,29-Nov-2017,2:13 PM,On Ordering the Previous Question,"Providing for the consideration of the bill (H.R. 3017) Brownfields Enhancement, Economic Redevelopment, and Reauthorization Act, and providing for consideration of the bill (H.R. 3905) Minnesota’s Economic Rights in the Superior National Forest Act",Passed,227,1,0,11,0,188,0,6,0,0,0,0,227,189,0,17
641,R,115,H RES 631,29-Nov-2017,2:21 PM,On Agreeing to the Resolution,"Providing for the consideration of the bill (H.R. 3017) Brownfields Enhancement, Economic Redevelopment, and Reauthorization Act, and providing for consideration of the bill (H.R. 3905) Minnesota’s Economic Rights in the Superior National Forest Act",Passed,228,0,0,11,0,186,0,8,0,0,0,0,228,186,0,19
642,R,115,H R 3905,30-Nov-2017,1:42 PM,On Agreeing to the Amendment,None,Failed,1,230,0,8,181,7,0,6,0,0,0,0,182,237,0,14
643,R,115,H R 3905,30-Nov-2017,1:50 PM,On Passage,Minnesota’s Economic Rights in the Superior National Forest Act,Passed,208,22,0,9,8,182,0,4,0,0,0,0,216,204,0,13
644,R,115,H RES 635,30-Nov-2017,2:08 PM,On Ordering the Previous Question,"Providing for consideration of H.R. 4182, the Ensuring a Qualified Civil Service Act of 2017; and H.R. 1699, the Preserving Access to Manufactured Housing Act of 2017",Passed,229,0,0,10,0,189,0,5,0,0,0,0,229,189,0,15
645,R,115,H RES 635,30-Nov-2017,2:15 PM,On Agreeing to the Resolution,"Providing for consideration of H.R. 4182, the Ensuring a Qualified Civil Service Act of 2017; and H.R. 1699, the Preserving Access to Manufactured Housing Act of 2017",Passed,226,0,0,13,0,186,0,8,0,0,0,0,226,186,0,21
646,R,115,H R 4182,30-Nov-2017,4:37 PM,On Agreeing to the Amendment,None,Failed,6,221,0,12,189,0,0,5,0,0,0,0,195,221,0,17
647,R,115,H R 4182,30-Nov-2017,4:44 PM,On Agreeing to the Amendment,None,Failed,5,223,0,11,188,0,0,6,0,0,0,0,193,223,0,17
648,R,115,H R 4182,30-Nov-2017,4:51 PM,On Passage,Ensuring a Qualified Civil Service Act,Passed,211,18,0,10,2,186,0,6,0,0,0,0,213,204,0,16
649,R,115,H R 3017,30-Nov-2017,5:00 PM,On Passage,"Brownfields Enhancement, Economic Redevelopment, and Reauthorization Act",Passed,220,8,0,11,189,0,0,5,0,0,0,0,409,8,0,16
650,R,115,H R 1699,1-Dec-2017,10:59 AM,On Motion to Recommit with Instructions,Preserving Access to Manufactured Housing Act,Failed,3,227,0,9,190,0,0,4,0,0,0,0,193,227,0,13
651,R,115,H R 1699,1-Dec-2017,11:10 AM,On Passage,Preserving Access to Manufactured Housing Act,Passed,229,1,0,9,27,162,0,5,0,0,0,0,256,163,0,14
652,R,115,JOURNAL,1-Dec-2017,11:18 AM,On Approving the Journal,None,Passed,129,78,1,31,80,91,1,22,0,0,0,0,209,169,2,53
653,R,115,H R 1,4-Dec-2017,7:04 PM,On Motion to go to Conference,Tax Cuts and Jobs Act,Passed,222,7,0,10,0,185,0,9,0,0,0,0,222,192,0,19
654,R,115,H R 1,4-Dec-2017,8:54 PM,On Motion to Instruct Conferees,Tax Cuts and Jobs Act,Failed,0,233,0,6,186,0,0,8,0,0,0,0,186,233,0,14
655,R,115,H R 3731,5-Dec-2017,1:37 PM,On Motion to Suspend the Rules and Pass,Secret Service Recruitment and Retention Act of 2017,Passed,229,4,0,6,178,0,0,16,0,0,0,0,407,4,0,22
656,R,115,H R 3317,5-Dec-2017,1:45 PM,"On Motion to Suspend the Rules and Pass, as Amended",Stopping Abusive Female Exploitation Act of 2017,Passed,228,0,0,11,181,0,0,13,0,0,0,0,409,0,0,24
657,R,115,JOURNAL,5-Dec-2017,1:51 PM,On Approving the Journal,None,Passed,136,91,0,12,88,92,1,13,0,0,0,0,224,183,1,25
658,R,115,H RES 646,6-Dec-2017,2:09 PM,On Motion to Table,None,Passed,238,0,0,1,126,58,4,5,0,0,0,0,364,58,4,6
659,R,115,H RES 645,6-Dec-2017,2:16 PM,On Ordering the Previous Question,"Providing for consideration of the bill (H.R. 38) to amend title 18, United States Code, to provide a means by which nonresidents of a State whose residents may carry concealed firearms may also do so in the State",Passed,234,4,0,1,2,185,0,6,0,0,0,0,236,189,0,7
660,R,115,H RES 645,6-Dec-2017,2:24 PM,On Agreeing to the Resolution,"Providing for consideration of the bill (H.R. 38) to amend title 18, United States Code, to provide a means by which nonresidents of a State whose residents may carry concealed firearms may also do so in the State",Passed,228,10,0,1,4,184,0,5,0,0,0,0,232,194,0,6
661,R,115,S 1266,6-Dec-2017,2:35 PM,On Motion to Suspend the Rules and Pass,Enhancing Veteran Care Act,Passed,237,0,0,2,186,0,0,7,0,0,0,0,423,0,0,9
662,R,115,H R 38,6-Dec-2017,4:34 PM,On Motion to Recommit with Instructions,Concealed Carry Reciprocity Act of 2017,Failed,2,235,0,2,188,1,0,4,0,0,0,0,190,236,0,6
663,R,115,H R 38,6-Dec-2017,4:42 PM,On Passage,Concealed Carry Reciprocity Act of 2017,Passed,225,14,0,1,6,184,0,3,0,0,0,0,231,198,0,4
664,R,115,H CON RES 90,6-Dec-2017,4:50 PM,"On Motion to Suspend the Rules and Agree, as Amended",Condemning ethnic cleansing of the Rohingya and calling for an end to the attacks in and an immediate restoration of humanitarian access to the state of Rakhine in Burma,Passed,235,3,0,1,188,0,0,5,0,0,0,0,423,3,0,6
665,R,115,H RES 647,7-Dec-2017,2:04 PM,On Ordering the Previous Question,"Providing for consideration of H.R. 477, Small Business Mergers, Acquisitions Sales, and Brokerage Simplification Act of 2017; providing for consideration of H.R. 3971, Community Institution Mortgage Relief Act of 2017; and providing for consideration of H.J. Res. 123, Making further continuing appropriations, FY 2018",Passed,236,1,0,2,0,189,0,4,0,0,0,0,236,190,0,6
666,R,115,H RES 647,7-Dec-2017,2:11 PM,On Agreeing to the Resolution,"Providing for consideration of H.R. 477, Small Business Mergers, Acquisitions Sales, and Brokerage Simplification Act of 2017; providing for consideration of H.R. 3971, Community Institution Mortgage Relief Act of 2017; and providing for consideration of H.J. Res. 123, Making further continuing appropriations, FY 2018",Passed,237,1,0,1,1,187,0,5,0,0,0,0,238,188,0,6
667,R,115,H RES 259,7-Dec-2017,2:18 PM,"On Motion to Suspend the Rules and Agree, as Amended","Expressing concern and condemnation over the political, economic, social, and humanitarian crisis in Venezuela",Passed,229,8,0,2,190,0,0,3,0,0,0,0,419,8,0,5
668,R,115,JOURNAL,7-Dec-2017,2:25 PM,On Approving the Journal,None,Passed,137,98,1,3,75,107,1,10,0,0,0,0,212,205,2,13
669,R,115,H R 477,7-Dec-2017,4:40 PM,On Passage,"Small Business Mergers, Acquisitions, Sales, and Brokerage Simplification Act of 2017",Passed,238,0,0,1,188,0,0,5,0,0,0,0,426,0,0,6
670,R,115,H J RES 123,7-Dec-2017,4:47 PM,On Passage,"Making further continuing appropriations for fiscal year 2018, and for other purposes",Passed,221,18,0,1,14,175,0,4,0,0,0,0,235,193,0,5
671,R,115,H R 2658,7-Dec-2017,5:11 PM,"On Motion to Suspend the Rules and Pass, as Amended",Venezuela Humanitarian Assistance and Defense of Democratic Governance Act,Passed,206,29,0,4,182,0,0,11,0,0,0,0,388,29,0,15
672,R,115,H R 2706,11-Dec-2017,6:51 PM,"On Motion to Suspend the Rules and Pass, as Amended",Financial Institution Customer Protection Act of 2017,Passed,222,0,0,16,173,2,0,18,0,0,0,0,395,2,0,34
673,R,115,H R 1730,11-Dec-2017,6:59 PM,"On Motion to Suspend the Rules and Pass, as Amended",Protecting Religiously Affiliated Institutions Act of 2017,Passed,222,2,0,14,180,0,0,13,0,0,0,0,402,2,0,27
674,R,115,H R 3971,12-Dec-2017,5:02 PM,On Motion to Recommit with Instructions,Community Institution Mortgage Relief Act of 2017,Failed,2,233,0,3,188,0,0,5,0,0,0,0,190,233,0,8
675,R,115,H R 3971,12-Dec-2017,5:09 PM,On Passage,Community Institution Mortgage Relief Act of 2017,Passed,234,1,0,3,60,128,0,5,0,0,0,0,294,129,0,8
676,R,115,H RES 658,13-Dec-2017,1:49 PM,On Ordering the Previous Question,"Providing for consideration of H.R. 1638, the Iranian Leadership Asset Transparency Act; and providing for consideration of H.R. 4324, the Strengthening Oversight of Iran’s Access to Finance Act",Passed,229,0,0,9,0,189,0,4,0,0,0,0,229,189,0,13
677,R,115,H RES 658,13-Dec-2017,1:57 PM,On Agreeing to the Resolution,"Providing for consideration of H.R. 1638, the Iranian Leadership Asset Transparency Act; and providing for consideration of H.R. 4324, the Strengthening Oversight of Iran’s Access to Finance Act",Passed,232,0,0,6,6,182,0,5,0,0,0,0,238,182,0,11
678,R,115,H RES 657,13-Dec-2017,5:11 PM,On Ordering the Previous Question,"Providing for consideration of H.R. 2396, the Privacy Notification Technical Clarifications Act; and providing for consideration of H.R. 4015, the Corporate Governance Reform and Transparency Act of 2017",Passed,236,0,0,2,0,187,0,6,0,0,0,0,236,187,0,8
679,R,115,H RES 657,13-Dec-2017,5:19 PM,On Agreeing to the Resolution,"Providing for consideration of H.R. 2396, the Privacy Notification Technical Clarifications Act; and providing for consideration of H.R. 4015, the Corporate Governance Reform and Transparency Act of 2017",Passed,236,0,0,2,4,184,0,5,0,0,0,0,240,184,0,7
680,R,115,H R 1638,13-Dec-2017,5:26 PM,On Passage,Iranian Leadership Asset Transparency Act,Passed,233,3,0,2,56,132,0,5,0,0,0,0,289,135,0,7
681,R,115,H R 2396,14-Dec-2017,11:01 AM,On Motion to Recommit with Instructions,Privacy Notification Technical Clarification Act,Failed,0,233,0,5,185,2,0,6,0,0,0,0,185,235,0,11
682,R,115,H R 2396,14-Dec-2017,11:09 AM,On Passage,Privacy Notification Technical Clarification Act,Passed,231,2,0,5,44,144,0,5,0,0,0,0,275,146,0,10
683,R,115,H R 4324,14-Dec-2017,11:15 AM,On Motion to Recommit with Instructions,Strengthening Oversight of Iran’s Access to Finance Act,Failed,0,233,0,5,188,0,0,5,0,0,0,0,188,233,0,10
684,R,115,H R 4324,14-Dec-2017,11:26 AM,On Passage,Strengthening Oversight of Iran’s Access to Finance Act,Passed,229,4,0,5,23,163,0,7,0,0,0,0,252,167,0,12
685,R,115,MOTION,18-Dec-2017,6:58 PM,On Motion to Fix the Convening Time,None,Passed,216,1,0,21,0,168,0,25,0,0,0,0,216,169,0,46
686,R,115,H R 4375,18-Dec-2017,7:06 PM,"On Motion to Suspend the Rules and Pass, as Amended",STEM Research and Education Effectiveness and Transparency Act,Passed,208,9,0,21,168,0,0,25,0,0,0,0,376,9,0,46
687,R,115,H R 3979,18-Dec-2017,7:14 PM,"On Motion to Suspend the Rules and Pass, as Amended",Keep America’s Refuges Operational Act,Passed,202,14,0,22,169,0,0,24,0,0,0,0,371,14,0,46
688,R,115,H RES 667,19-Dec-2017,11:56 AM,On Ordering the Previous Question,Providing for consideration of the conference report to accompany the bill (H.R. 1) the Tax Cuts and Jobs Act; providing for consideration of the bill (H.R. 3312) the Systemic Risk Designation Improvement Act; waiving a requirement of clause 6(a) of rule XIII; and motions to suspend the rules,Passed,233,0,0,5,0,187,0,6,0,0,0,0,233,187,0,11
689,R,115,H RES 667,19-Dec-2017,12:05 PM,On Agreeing to the Resolution,Providing for consideration of the conference report to accompany the bill (H.R. 1) the Tax Cuts and Jobs Act; providing for consideration of the bill (H.R. 3312) the Systemic Risk Designation Improvement Act; waiving a requirement of clause 6(a) of rule XIII; and motions to suspend the rules,Passed,233,3,0,2,0,190,0,3,0,0,0,0,233,193,0,5
690,R,115,H R 4254,19-Dec-2017,12:13 PM,"On Motion to Suspend the Rules and Pass, as Amended",Women in Aerospace Education Act,Passed,220,16,0,2,189,1,0,3,0,0,0,0,409,17,0,5
691,R,115,H R 1,19-Dec-2017,2:20 PM,On Motion to Recommit Conference Report with Instructions,Tax Cuts and Jobs Act,Failed,0,236,0,2,191,0,0,2,0,0,0,0,191,236,0,4
692,R,115,H R 1,19-Dec-2017,2:27 PM,On Agreeing to the Conference Report,Tax Cuts and Jobs Act,Passed,227,12,0,0,0,191,0,2,0,0,0,0,227,203,0,2
693,R,115,H R 4323,19-Dec-2017,2:35 PM,"On Motion to Suspend the Rules and Pass, as Amended",Supporting Veterans in STEM Careers Act,Passed,232,1,0,5,188,0,0,5,0,0,0,0,420,1,0,10
694,R,115,H R 3312,19-Dec-2017,4:49 PM,On Passage,Systemic Risk Designation Improvement Act of 2017,Passed,229,2,0,7,59,128,0,6,0,0,0,0,288,130,0,13
695,R,115,S 1536,19-Dec-2017,4:56 PM,On Motion to Suspend the Rules and Pass,Combating Human Trafficking in Commercial Vehicles Act,Passed,230,1,0,7,188,0,0,5,0,0,0,0,418,1,0,12
696,R,115,JOURNAL,19-Dec-2017,5:04 PM,On Approving the Journal,None,Passed,143,84,0,11,84,96,1,12,0,0,0,0,227,180,1,23
697,R,115,H RES 668,20-Dec-2017,11:43 AM,On Ordering the Previous Question,"Providing for consideration of the Senate amendment to H.R. 1, the Tax Cuts and Jobs Act",Passed,234,0,0,4,0,188,0,5,0,0,0,0,234,188,0,9
698,R,115,H RES 668,20-Dec-2017,11:51 AM,On Agreeing to the Resolution,"Providing for consideration of the Senate amendment to H.R. 1, the Tax Cuts and Jobs Act",Passed,232,1,0,5,0,189,0,4,0,0,0,0,232,190,0,9
699,R,115,H R 1,20-Dec-2017,12:55 PM,On Motion to Concur in the Senate Amendment,Tax Cuts and Jobs Act,Passed,224,12,0,3,0,189,0,4,0,0,0,0,224,201,0,7
700,R,115,H R 1159,20-Dec-2017,1:02 PM,"On Motion to Suspend the Rules and Pass, as Amended",United States and Israel Space Cooperation Act,Passed,227,0,0,11,184,0,0,9,0,0,0,0,411,0,0,20
701,R,115,H R 4015,20-Dec-2017,6:37 PM,On Motion to Recommit with Instructions,Corporate Governance Reform and Transparency Act,Failed,1,231,0,6,188,0,0,5,0,0,0,0,189,231,0,11
702,R,115,H R 4015,20-Dec-2017,6:47 PM,On Passage,Corporate Governance Reform and Transparency Act,Passed,226,6,0,6,12,176,0,5,0,0,0,0,238,182,0,11
703,R,115,JOURNAL,20-Dec-2017,6:53 PM,On Approving the Journal,None,Passed,143,85,1,9,74,109,1,9,0,0,0,0,217,194,2,18
704,R,115,H RES 670,21-Dec-2017,2:02 PM,On Ordering the Previous Question,"Providing for consideration of the Senate Amendment to H.R. 1370, the Department of Homeland Security Blue Campaign Authorization Act of 2017; and providing for consideration of H.R. 4667, making further supplemental appropriations for FY 2018, for disaster assistance for Hurricanes and Wildfires in calendar year 2017",Passed,232,0,0,6,0,188,0,5,0,0,0,0,232,188,0,11
705,R,115,H RES 670,21-Dec-2017,2:10 PM,On Agreeing to the Resolution,"Providing for consideration of the Senate Amendment to H.R. 1370, the Department of Homeland Security Blue Campaign Authorization Act of 2017; and providing for consideration of H.R. 4667, making further supplemental appropriations for FY 2018, for disaster assistance for Hurricanes and Wildfires in calendar year 2017",Passed,228,2,0,8,0,186,0,7,0,0,0,0,228,188,0,15
706,R,115,S 1393,21-Dec-2017,2:19 PM,On Motion to Suspend the Rules and Pass,Jobs for Our Heroes Act,Passed,231,0,0,7,187,0,0,6,0,0,0,0,418,0,0,13
707,R,115,JOURNAL,21-Dec-2017,2:26 PM,On Approving the Journal,None,Passed,159,66,0,13,66,121,1,5,0,0,0,0,225,187,1,18
708,R,115,H R 1370,21-Dec-2017,4:53 PM,On Motion to Concur in the Senate Amendment with an Amendment,Department of Homeland Security Blue Campaign Authorization Act of 2017,Passed,217,16,0,6,14,172,0,7,0,0,0,0,231,188,0,13
709,R,115,H R 4667,21-Dec-2017,5:01 PM,On Passage,"Making further supplemental appropriations for the fiscal year ending September 30, 2018, for disaster assistance for Hurricanes Harvey, Irma, and Maria, and calendar year 2017 wildfires, and for other purposes",Passed,182,51,0,6,69,118,0,6,0,0,0,0,251,169,0,12
710,R,115,S 1532,21-Dec-2017,5:11 PM,On Motion to Suspend the Rules and Pass,No Human Trafficking on Our Roads Act,Passed,221,0,0,17,172,0,0,21,0,0,0,0,393,0,0,38
