Roll Call,Majority,Congress Num,Legislation Number,Date,Time,Question,Description,Result,Republican Yes,Republican No,Republican Present,Republican Not Voting,Democrat Yes,Democrat No,Democrat Present,Democrat Not Voting,Independent Yes,Independent No,Independent Present,Independent Not Voting,Total Yes,Total No,Total Present,Total Not Voting
1,R,115,QUORUM,8-Jan-2018,6:53 PM,Call of the House,None,Passed,0,0,206,32,0,0,151,42,0,0,0,0,0,0,357,74
2,R,115,H RES 676,9-Jan-2018,4:17 PM,On Motion to Suspend the Rules and Agree,"Supporting the rights of the people of Iran to free expression, condemning the Iranian regime for its crackdown on legitimate protests, and for other purposes",Passed,233,2,0,3,182,0,0,11,0,0,0,0,415,2,0,14
3,R,115,H R 4564,9-Jan-2018,4:25 PM,On Motion to Suspend the Rules and Pass,Post-Caliphate Threat Assessment Act of 2017,Passed,235,0,0,3,178,0,0,15,0,0,0,0,413,0,0,18
4,R,115,H R 4581,9-Jan-2018,4:33 PM,On Motion to Suspend the Rules and Pass,Screening and Vetting Passenger Exchange Act,Passed,234,1,0,3,181,0,0,12,0,0,0,0,415,1,0,15
5,R,115,ADJOURN,10-Jan-2018,12:39 PM,On Motion to Adjourn,None,Failed,0,215,0,23,51,116,0,26,0,0,0,0,51,331,0,49
6,R,115,ADJOURN,10-Jan-2018,1:16 PM,On Motion to Adjourn,None,Failed,0,216,0,22,54,95,0,44,0,0,0,0,54,311,0,66
7,R,115,ADJOURN,10-Jan-2018,1:46 PM,On Motion to Adjourn,None,Failed,1,213,0,24,61,111,0,21,0,0,0,0,62,324,0,45
8,R,115,H RES 682,10-Jan-2018,4:13 PM,On Agreeing to the Resolution,"Providing for consideration of the bill (S. 139) to implement the use of Rapid DNA instruments to inform decisions about pretrial release or detention and their conditions, to solve and prevent violent crimes and other crimes, to exonerate the innocent, to prevent DNA analysis backlongs, and for other purposes",Passed,231,2,0,5,2,179,0,12,0,0,0,0,233,181,0,17
9,R,115,H RES 681,10-Jan-2018,4:33 PM,On Ordering the Previous Question,Providing for consideration of the bill (S. 140) to amend the White Mountain Apache Tribe Water Rights Quantification Act of 2010 to clarify the use of amounts in the WMAT Settlement Fund,Passed,234,0,0,4,0,181,0,12,0,0,0,0,234,181,0,16
10,R,115,H RES 681,10-Jan-2018,4:41 PM,On Agreeing to the Resolution,Providing for consideration of the bill (S. 140) to amend the White Mountain Apache Tribe Water Rights Quantification Act of 2010 to clarify the use of amounts in the WMAT Settlement Fund,Passed,227,0,0,11,0,181,0,12,0,0,0,0,227,181,0,23
11,R,115,S 140,10-Jan-2018,6:09 PM,On Passage,To amend the White Mountain Apache Tribe Water Rights Quantification Act of 2010 to clarify the use of amounts in the WMAT Settlement Fund,Passed,216,15,0,7,23,158,0,12,0,0,0,0,239,173,0,19
12,R,115,H R 4567,10-Jan-2018,6:16 PM,"On Motion to Suspend the Rules and Pass, as Amended",DHS Overseas Personnel Enhancement Act of 2017,Passed,232,0,0,6,183,0,0,10,0,0,0,0,415,0,0,16
13,R,115,JOURNAL,10-Jan-2018,6:23 PM,On Approving the Journal,None,Passed,146,85,0,7,85,93,1,14,0,0,0,0,231,178,1,21
14,R,115,S 139,11-Jan-2018,11:16 AM,On Agreeing to the Amendment,None,Failed,58,178,0,3,125,55,0,13,0,0,0,0,183,233,0,16
15,R,115,S 139,11-Jan-2018,11:32 AM,On Motion to Commit with Instructions,Rapid DNA Act of 2017,Failed,6,227,0,5,183,0,0,10,0,0,0,0,189,227,0,15
16,R,115,S 139,11-Jan-2018,11:39 AM,On Passage,Rapid DNA Act of 2017,Passed,191,45,0,3,65,119,0,9,0,0,0,0,256,164,0,12
17,R,115,H R 4578,11-Jan-2018,11:45 AM,On Motion to Suspend the Rules and Pass,Counter Terrorist Network Act,Passed,228,2,0,8,182,0,0,11,0,0,0,0,410,2,0,19
18,R,115,H R 4318,16-Jan-2018,6:53 PM,"On Motion to Suspend the Rules and Pass, as Amended",Miscellaneous Tariff Bill Act of 2018,Passed,222,0,0,15,180,0,0,13,0,0,0,0,402,0,0,28
19,R,115,S 117,16-Jan-2018,7:02 PM,On Motion to Suspend the Rules and Pass,Alex Diekmann Peak Designation Act of 2017,Passed,219,3,0,15,181,0,0,12,0,0,0,0,400,3,0,27
20,R,115,H RES 693,17-Jan-2018,1:35 PM,On Ordering the Previous Question,Providing for consideration of the bill (H.R. 3326) the World Bank Accountability Act; and providing for consideration of the bill (H.R. 2954) the Home Mortgage Disclosure Adjustment Act,Passed,230,0,0,7,0,187,0,6,0,0,0,0,230,187,0,13
21,R,115,H RES 693,17-Jan-2018,1:45 PM,On Agreeing to the Resolution,Providing for consideration of the bill (H.R. 3326) the World Bank Accountability Act; and providing for consideration of the bill (H.R. 2954) the Home Mortgage Disclosure Adjustment Act,Passed,228,0,0,9,0,188,0,5,0,0,0,0,228,188,0,14
22,R,115,H R 4258,17-Jan-2018,1:54 PM,"On Motion to Suspend the Rules and Pass, as Amended",Family Self-Sufficiency Act,Passed,224,5,0,8,188,0,0,5,0,0,0,0,412,5,0,13
23,R,115,H R 3326,17-Jan-2018,5:26 PM,On Agreeing to the Amendment,None,Agreed to,231,0,0,6,189,0,0,4,0,0,0,0,420,0,0,10
24,R,115,H R 3326,17-Jan-2018,5:37 PM,On Passage,World Bank Accountability Act of 2017,Passed,216,16,0,5,21,168,0,4,0,0,0,0,237,184,0,9
25,R,115,H R 4279,17-Jan-2018,5:44 PM,"On Motion to Suspend the Rules and Pass, as Amended",Expanding Investment Opportunities Act,Passed,230,1,0,6,188,1,0,4,0,0,0,0,418,2,0,10
26,R,115,JOURNAL,17-Jan-2018,5:52 PM,On Approving the Journal,None,Passed,143,86,0,8,82,99,1,11,0,0,0,0,225,185,1,19
27,R,115,H RES 696,18-Jan-2018,2:58 PM,On Ordering the Previous Question,"Providing for consideration of the Senate amendment to H.R. 195, the Federal Register Printing Savings Act of 2017; waiving a requirement of clause 6(a) of rule XIII with respect to consideration of certain resolutions reported from the Committee on Rules; and providing for consideration of motions to suspend the rules",Passed,229,0,0,8,0,191,0,2,0,0,0,0,229,191,0,10
28,R,115,H RES 696,18-Jan-2018,3:06 PM,On Agreeing to the Resolution,"Providing for consideration of the Senate amendment to H.R. 195, the Federal Register Printing Savings Act of 2017; waiving a requirement of clause 6(a) of rule XIII with respect to consideration of certain resolutions reported from the Committee on Rules; and providing for consideration of motions to suspend the rules",Passed,226,3,0,8,0,191,0,2,0,0,0,0,226,194,0,10
29,R,115,H RES 694,18-Jan-2018,3:14 PM,On Ordering the Previous Question,"Providing for consideration of H.R. 4712, the Born-Alive Abortion Survivors Protection Act; providing for proceedings during the period from January 22, 2018, through January 26, 2018",Passed,229,0,0,8,0,190,0,3,0,0,0,0,229,190,0,11
30,R,115,H RES 694,18-Jan-2018,3:22 PM,On Agreeing to the Resolution,"Providing for consideration of H.R. 4712, the Born-Alive Abortion Survivors Protection Act; providing for proceedings during the period from January 22, 2018, through January 26, 2018",Passed,226,1,0,10,2,188,0,3,0,0,0,0,228,189,0,13
31,R,115,H R 2954,18-Jan-2018,7:23 PM,On Motion to Recommit with Instructions,Home Mortgage Disclosure Adjustment Act,Failed,1,234,0,2,190,2,0,1,0,0,0,0,191,236,0,3
32,R,115,H R 2954,18-Jan-2018,7:30 PM,On Passage,Home Mortgage Disclosure Adjustment Act,Passed,234,1,0,2,9,183,0,1,0,0,0,0,243,184,0,3
33,R,115,H R 195,18-Jan-2018,7:36 PM,On Motion to Concur in the Senate Amendment with an Amendment,Federal Register Printing Savings Act,Passed,224,11,0,3,6,186,0,1,0,0,0,0,230,197,0,4
34,R,115,H R 1660,18-Jan-2018,7:43 PM,On Motion to Suspend the Rules and Pass,Global Health Innovation Act of 2017,Passed,231,3,0,3,192,0,0,1,0,0,0,0,423,3,0,4
35,R,115,H RES 705,19-Jan-2018,11:16 AM,On Motion to Table,"Impeaching Donald John Trump, President of the United States, of high misdemeanors",Passed,234,0,0,3,121,66,3,3,0,0,0,0,355,66,3,6
36,R,115,H R 4712,19-Jan-2018,11:26 AM,On Passage,Born-Alive Abortion Survivors Protection Act,Passed,235,0,0,2,6,183,0,4,0,0,0,0,241,183,0,6
37,R,115,ADJOURN,19-Jan-2018,11:43 AM,On Motion to Adjourn,None,Failed,1,231,0,5,0,187,1,5,0,0,0,0,1,418,1,10
38,R,115,MOTION,20-Jan-2018,12:29 PM,On Ordering a Call of the House,None,Passed,205,0,0,32,19,150,10,14,0,0,0,0,224,150,10,46
39,R,115,QUORUM,20-Jan-2018,12:45 PM,Call of the House,None,Passed,0,0,205,32,0,0,172,21,0,0,0,0,0,0,377,53
40,R,115,H RES 708,20-Jan-2018,5:11 PM,Table Appeal of the Ruling of the Chair,"Waiving a Requirement of Clause 6(A) of Rule XIII with Respect to Consideration of Certain Resolutions Reported from the Committee on Rules, and Providing for Consideration of Motions to Suspend the Rules",Passed,218,0,0,19,6,173,2,12,0,0,0,0,224,173,2,31
41,R,115,H RES 708,20-Jan-2018,6:48 PM,On Ordering the Previous Question,"Waiving a Requirement of Clause 6(A) of Rule XIII with Respect to Consideration of Certain Resolutions Reported from the Committee on Rules, and Providing for Consideration of Motions to Suspend the Rules",Passed,224,0,0,13,0,180,0,13,0,0,0,0,224,180,0,26
42,R,115,H RES 708,20-Jan-2018,6:54 PM,On Agreeing to the Resolution,"Waiving a Requirement of Clause 6(A) of Rule XIII with Respect to Consideration of Certain Resolutions Reported from the Committee on Rules, and Providing for Consideration of Motions to Suspend the Rules",Passed,222,1,0,14,13,169,0,11,0,0,0,0,235,170,0,25
43,R,115,MOTION,20-Jan-2018,7:10 PM,On Motion to Fix the Convening Time,None,Passed,219,0,0,18,175,0,0,18,0,0,0,0,394,0,0,36
44,R,115,H R 195,22-Jan-2018,6:09 PM,On Motion to Concur in the Senate Adt to the House Adt to the Senate Adt,Federal Register Printing Savings Act,Passed,221,6,0,10,45,144,0,4,0,0,0,0,266,150,0,14
45,R,115,S 534,29-Jan-2018,6:57 PM,"On Motion to Suspend the Rules and Pass, as Amended",Protecting Young Victims from Sexual Abuse and Safe Sport Authorization Act,Passed,225,3,0,9,181,0,0,12,0,0,0,0,406,3,0,21
46,R,115,H R 1457,29-Jan-2018,7:06 PM,"On Motion to Suspend the Rules and Pass, as Amended","To establish requirements for use of a driver’s license or personal identification card by certain financial institutions for opening an account or obtaining a financial product or service, and for other purposes",Passed,219,8,0,10,178,0,0,15,0,0,0,0,397,8,0,25
47,R,115,H RES 714,30-Jan-2018,1:43 PM,On Ordering the Previous Question,"Providing for consideration of the Senate amendments to H.R. 695, the Child Protection Improvements Act of 2017",Passed,232,0,0,5,0,187,0,6,0,0,0,0,232,187,0,11
48,R,115,H RES 714,30-Jan-2018,1:52 PM,On Agreeing to the Resolution,"Providing for consideration of the Senate amendments to H.R. 695, the Child Protection Improvements Act of 2017",Passed,231,2,0,4,5,181,0,7,0,0,0,0,236,183,0,11
49,R,115,H R 695,30-Jan-2018,3:11 PM,On Motion to Concur in the Senate Amendments with an Amendment,Child Protection Improvements Act of 2017,Passed,227,4,0,6,23,162,0,8,0,0,0,0,250,166,0,14
50,R,115,H R 4292,30-Jan-2018,3:20 PM,"On Motion to Suspend the Rules and Pass, as Amended",Financial Institution Living Will Improvement Act,Passed,231,0,0,6,183,0,0,10,0,0,0,0,414,0,0,16
51,R,115,H R 4547,5-Feb-2018,6:55 PM,"On Motion to Suspend the Rules and Pass, as Amended",Strengthening Protections for Social Security Beneficiaries Act of 2018,Passed,225,0,0,12,171,0,0,22,0,0,0,0,396,0,0,34
52,R,115,JOURNAL,5-Feb-2018,7:02 PM,On Approving the Journal,None,Passed,145,78,0,14,87,81,1,24,0,0,0,0,232,159,1,38
53,R,115,H RES 726,6-Feb-2018,11:26 AM,On Motion to Table,Raising a question of the privileges of the House,Passed,231,0,0,6,0,187,0,6,0,0,0,0,231,187,0,12
54,R,115,H RES 725,6-Feb-2018,11:34 AM,On Ordering the Previous Question,"Providing for consideration of H.R. 772, the Common Sense Nutrition Disclosure Act of 2017; H.R. 1153, the Mortgage Choice Act of 2017; H.R. 4771, the Small Bank Holding Company Relief Act of 2018; and for other purposes",Passed,231,1,0,5,0,187,0,6,0,0,0,0,231,188,0,11
55,R,115,H RES 725,6-Feb-2018,11:41 AM,On Agreeing to the Resolution,"Providing for consideration of H.R. 772, the Common Sense Nutrition Disclosure Act of 2017; H.R. 1153, the Mortgage Choice Act of 2017; H.R. 4771, the Small Bank Holding Company Relief Act of 2018; and for other purposes",Passed,229,2,0,6,2,184,0,7,0,0,0,0,231,186,0,13
56,R,115,H R 772,6-Feb-2018,4:36 PM,On Passage,Common Sense Nutrition Disclosure Act of 2017,Passed,234,1,0,2,32,156,1,4,0,0,0,0,266,157,1,6
57,R,115,MOTION,6-Feb-2018,5:03 PM,Table Appeal of the Ruling of the Chair,None,Passed,236,0,0,1,0,190,0,3,0,0,0,0,236,190,0,4
58,R,115,H RES 727,6-Feb-2018,5:11 PM,On Ordering the Previous Question,"Providing for consideration of the Senate amendment to the bill (H.R. 1892) to amend title 4, United States Code, to provide for the flying of the flag at half-staff in the event of the death of a first responder in the line of duty",Passed,235,0,0,2,0,189,0,4,0,0,0,0,235,189,0,6
59,R,115,H RES 727,6-Feb-2018,5:18 PM,On Agreeing to the Resolution,"Providing for consideration of the Senate amendment to the bill (H.R. 1892) to amend title 4, United States Code, to provide for the flying of the flag at half-staff in the event of the death of a first responder in the line of duty",Passed,232,3,0,2,4,185,0,4,0,0,0,0,236,188,0,6
60,R,115,H R 1892,6-Feb-2018,6:55 PM,On Motion to Concur in the Senate Amendment with an Amendment,"Further Extension of Continuing Appropriations Act, 2018",Passed,228,8,0,1,17,174,0,2,0,0,0,0,245,182,0,3
61,R,115,H R 3851,7-Feb-2018,7:06 PM,"On Motion to Suspend the Rules and Pass, as Amended",War Crimes Rewards Expansion Act,Passed,224,0,0,13,183,0,0,10,0,0,0,0,407,0,0,23
62,R,115,H R 1997,7-Feb-2018,7:16 PM,"On Motion to Suspend the Rules and Pass, as Amended",Ukraine Cybersecurity Cooperation Act of 2017,Passed,220,3,0,14,184,0,0,9,0,0,0,0,404,3,0,23
63,R,115,JOURNAL,7-Feb-2018,7:24 PM,On Approving the Journal,None,Passed,130,89,0,18,80,96,3,14,0,0,0,0,210,185,3,32
64,R,115,H R 1153,8-Feb-2018,10:57 AM,On Passage,Mortgage Choice Act of 2017,Passed,228,0,0,9,52,131,0,10,0,0,0,0,280,131,0,19
65,R,115,JOURNAL,8-Feb-2018,11:04 AM,On Approving the Journal,None,Passed,128,96,0,13,80,98,2,13,0,0,0,0,208,194,2,26
66,R,115,H R 4771,8-Feb-2018,4:43 PM,On Passage,Small Bank Holding Company Relief Act of 2018,Passed,230,0,0,7,50,139,0,4,0,0,0,0,280,139,0,11
67,R,115,H RES 734,9-Feb-2018,4:31 AM,On Ordering the Previous Question,"Providing for consideration of the Senate Amendment to the House Amendment to the Senate Amendment to H.R. 1892, the Bipartisan Budget Act of 2018",Passed,224,0,0,13,0,186,0,7,0,0,0,0,224,186,0,20
68,R,115,H RES 734,9-Feb-2018,4:39 AM,On Agreeing to the Resolution,"Providing for consideration of the Senate Amendment to the House Amendment to the Senate Amendment to H.R. 1892, the Bipartisan Budget Act of 2018",Passed,221,7,0,9,3,186,0,4,0,0,0,0,224,193,0,13
69,R,115,H R 1892,9-Feb-2018,5:32 AM,On Motion to Concur in the Senate Amdt to the House Amdt to the Senate Amdt,The Bipartisan Budget Act of 2018,Passed,167,67,0,4,73,119,0,1,0,0,0,0,240,186,0,5
70,R,115,H R 4533,13-Feb-2018,6:54 PM,"On Motion to Suspend the Rules and Pass, as Amended",Lexington VA Health Care System,Passed,220,0,0,17,182,0,0,11,0,0,0,0,402,0,0,28
71,R,115,H R 4979,13-Feb-2018,7:03 PM,"On Motion to Suspend the Rules and Pass, as Amended",To extend the Generalized System of Preferences and to make technical changes to the competitive need limitations provision of the program,Passed,217,2,0,18,183,0,0,10,0,0,0,0,400,2,0,28
72,R,115,H RES 736,14-Feb-2018,1:38 PM,On Ordering the Previous Question,"Providing for consideration of H.R. 620, the ADA Education and Reform Act of 2017; H.R. 3299, the Protection Consumers’ Access to Credit Act of 2017; H.R. 3978, theTRID Improvement Act of 2017; and providing for proceedings during the period from February 16, 2018, through February 23, 2018",Passed,228,0,0,9,0,187,0,6,0,0,0,0,228,187,0,15
73,R,115,H RES 736,14-Feb-2018,1:50 PM,On Agreeing to the Resolution,"Providing for consideration of H.R. 620, the ADA Education and Reform Act of 2017; H.R. 3299, the Protection Consumers’ Access to Credit Act of 2017; H.R. 3978, theTRID Improvement Act of 2017; and providing for proceedings during the period from February 16, 2018, through February 23, 2018",Passed,227,0,0,10,0,187,0,6,0,0,0,0,227,187,0,16
74,R,115,H R 3542,14-Feb-2018,1:58 PM,"On Motion to Suspend the Rules and Pass, as Amended",Hamas Human Shields Prevention Act,Passed,228,0,0,9,187,0,0,6,0,0,0,0,415,0,0,15
75,R,115,H RES 129,14-Feb-2018,2:05 PM,"On Motion to Suspend the Rules and Agree, as Amended","Calling on the Department of Defense, other elements of the Federal Government, and foreign governments to intensify efforts to investigate, recover, and identify all missing and unaccounted-for personnel of the United States",Passed,227,0,0,10,184,0,0,9,0,0,0,0,411,0,0,19
76,R,115,H R 3978,14-Feb-2018,4:56 PM,On Motion to Recommit with Instructions,TRID Improvement Act,Failed,2,228,0,7,187,0,0,6,0,0,0,0,189,228,0,13
77,R,115,H R 3978,14-Feb-2018,5:04 PM,On Passage,TRID Improvement Act,Passed,228,1,0,8,43,144,0,6,0,0,0,0,271,145,0,14
78,R,115,H R 3299,14-Feb-2018,5:12 PM,On Passage,Protecting Consumers’ Access to Credit Act of 2017,Passed,229,1,0,7,16,170,0,7,0,0,0,0,245,171,0,14
79,R,115,H R 620,15-Feb-2018,11:46 AM,On Agreeing to the Amendment,None,Failed,15,215,0,7,173,11,0,9,0,0,0,0,188,226,0,16
80,R,115,H R 620,15-Feb-2018,11:56 AM,On Passage,ADA Education and Reform Act of 2017,Passed,213,19,0,5,12,173,0,8,0,0,0,0,225,192,0,13
81,R,115,H R 1222,26-Feb-2018,6:55 PM,"On Motion to Suspend the Rules and Pass, as Amended",Congenital Heart Futures Reauthorization Act of 2017,Passed,217,7,0,13,177,0,0,16,0,0,0,0,394,7,0,29
82,R,115,H R 2422,26-Feb-2018,7:13 PM,"On Motion to Suspend the Rules and Pass, as Amended",Action for Dental Health Act of 2017,Passed,209,13,0,15,178,0,0,15,0,0,0,0,387,13,0,30
83,R,115,MOTION,27-Feb-2018,1:37 PM,Table Appeal of the Ruling of the Chair,None,Passed,228,0,0,9,0,184,0,9,0,0,0,0,228,184,0,18
84,R,115,H RES 748,27-Feb-2018,1:45 PM,On Ordering the Previous Question,"Providing for consideration of the bill (H.R. 1865), the Allow States and Victims to Fight Online Sex Trafficking Act of 2017",Passed,228,0,0,9,0,184,0,9,0,0,0,0,228,184,0,18
85,R,115,H RES 748,27-Feb-2018,1:52 PM,On Agreeing to the Resolution,"Providing for consideration of the bill (H.R. 1865), the Allow States and Victims to Fight Online Sex Trafficking Act of 2017",Passed,226,0,0,11,9,175,0,9,0,0,0,0,235,175,0,20
86,R,115,H RES 747,27-Feb-2018,1:59 PM,On Ordering the Previous Question,"Providing for consideration of the bill (H.R. 4296) to place requirements on operational risk capital requirements for banking organizations established by an appropriate Federal banking agency, and providing for consideration of the bill (H.R. 4607) the Comprehensive Regulatory Review Act",Passed,227,0,0,10,0,185,0,8,0,0,0,0,227,185,0,18
87,R,115,H RES 747,27-Feb-2018,2:05 PM,On Agreeing to the Resolution,"Providing for consideration of the bill (H.R. 4296) to place requirements on operational risk capital requirements for banking organizations established by an appropriate Federal banking agency, and providing for consideration of the bill (H.R. 4607) the Comprehensive Regulatory Review Act",Passed,226,0,0,11,4,177,0,12,0,0,0,0,230,177,0,23
88,R,115,H R 4296,27-Feb-2018,5:28 PM,On Motion to Recommit with Instructions,To place requirements on operational risk capital requirements for banking organizations established by an appropriate Federal banking agency,Failed,2,228,0,7,183,0,0,10,0,0,0,0,185,228,0,17
89,R,115,H R 4296,27-Feb-2018,5:37 PM,On Passage,To place requirements on operational risk capital requirements for banking organizations established by an appropriate Federal banking agency,Passed,226,3,0,8,19,166,0,8,0,0,0,0,245,169,0,16
90,R,115,H R 1865,27-Feb-2018,5:46 PM,On Agreeing to the Amendment,None,Agreed to,169,61,0,7,139,46,0,8,0,0,0,0,308,107,0,15
91,R,115,H R 1865,27-Feb-2018,5:59 PM,On Passage,Allow States and Victims to Fight Online Sex Trafficking Act,Passed,214,14,0,9,174,11,0,8,0,0,0,0,388,25,0,17
92,R,115,H R 3183,5-Mar-2018,6:55 PM,On Motion to Suspend the Rules and Pass,"To designate the facility of the United States Postal Service located at 13683 James Madison Highway in Palmyra, Virginia, as the “U.S. Navy Seaman Dakota Kyle Rigsby Post Office”",Passed,225,0,0,12,164,0,0,29,0,0,0,0,389,0,0,41
93,R,115,H R 4406,5-Mar-2018,7:04 PM,"On Motion to Suspend the Rules and Pass, as Amended","To designate the facility of the United States Postal Service located at 99 Macombs Place in New York, New York, as the “Tuskegee Airman Post Office Building”",Passed,223,0,0,14,164,0,0,29,0,0,0,0,387,0,0,43
94,R,115,H R 4607,6-Mar-2018,4:17 PM,On Motion to Recommit with Instructions,Comprehensive Regulatory Review Act,Failed,2,227,0,8,180,1,0,12,0,0,0,0,182,228,0,20
95,R,115,H R 4607,6-Mar-2018,4:25 PM,On Passage,Comprehensive Regulatory Review Act,Passed,226,0,0,11,38,143,0,12,0,0,0,0,264,143,0,23
96,R,115,H RES 762,7-Mar-2018,1:39 PM,On Ordering the Previous Question,"Providing for consideration of the bill (H.R. 1119) Satisfying Energy Needs and Saving the Environment Act, and providing for consideration of the bill (H.R. 1917) Blocking Regulatory Interference from Closing Kilns Act",Passed,229,0,0,8,0,183,0,10,0,0,0,0,229,183,0,18
97,R,115,H RES 762,7-Mar-2018,1:46 PM,On Agreeing to the Resolution,"Providing for consideration of the bill (H.R. 1119) Satisfying Energy Needs and Saving the Environment Act, and providing for consideration of the bill (H.R. 1917) Blocking Regulatory Interference from Closing Kilns Act",Passed,227,0,0,10,0,185,0,8,0,0,0,0,227,185,0,18
98,R,115,H R 1917,7-Mar-2018,4:24 PM,On Motion to Recommit with Instructions,Blocking Regulatory Interference from Closing Kilns Act,Failed,2,227,0,8,184,0,0,9,0,0,0,0,186,227,0,17
99,R,115,H R 1917,7-Mar-2018,4:32 PM,On Passage,Blocking Regulatory Interference from Closing Kilns Act,Passed,228,1,0,8,6,179,1,7,0,0,0,0,234,180,1,15
100,R,115,H R 1119,8-Mar-2018,10:35 AM,On Motion to Recommit with Instructions,Satisfying Energy Needs and Saving the Environment (SENSE) Act,Failed,1,225,0,11,180,0,0,13,0,0,0,0,181,225,0,24
101,R,115,H R 1119,8-Mar-2018,10:44 AM,On Passage,Satisfying Energy Needs and Saving the Environment (SENSE) Act,Passed,210,14,0,13,5,175,0,13,0,0,0,0,215,189,0,26
102,R,115,H R 5247,13-Mar-2018,6:55 PM,On Motion to Suspend the Rules and Pass,"Trickett Wendler, Frank Mongiello, Jordan McLinn, and Matthew Bellina Right to Try Act of 2018",Failed,227,2,0,8,32,138,0,23,0,0,0,0,259,140,0,31
103,R,115,H R 4465,13-Mar-2018,7:03 PM,On Motion to Suspend the Rules and Pass,Endangered Fish Recovery Programs Extension Act of 2017,Passed,222,6,0,9,170,0,0,23,0,0,0,0,392,6,0,32
104,R,115,H RES 773,14-Mar-2018,2:43 PM,On Ordering the Previous Question,"Providing for consideration of H.R. 4545, the Financial Institutions Examination Fairness and Reform Act; H.R. 1116, the TAILOR Act of 2017; and H.R. 4263, the Regulation At Improvement Act of 2017",Passed,234,0,0,3,0,183,0,10,0,0,0,0,234,183,0,13
105,R,115,H RES 773,14-Mar-2018,2:51 PM,On Agreeing to the Resolution,"Providing for consideration of H.R. 4545, the Financial Institutions Examination Fairness and Reform Act; H.R. 1116, the TAILOR Act of 2017; and H.R. 4263, the Regulation At Improvement Act of 2017",Passed,232,0,0,5,3,182,0,8,0,0,0,0,235,182,0,13
106,R,115,H R 4909,14-Mar-2018,3:10 PM,"On Motion to Suspend the Rules and Pass, as Amended","Student, Teachers, and Officers Preventing School Violence Act of 2018",Passed,229,5,0,3,178,5,0,10,0,0,0,0,407,10,0,13
107,R,115,H R 1116,14-Mar-2018,5:37 PM,On Motion to Recommit with Instructions,Taking Account of Institutions with Low Operation Risk Act of 2017 or the TAILOR Act of 2017,Failed,1,232,0,4,181,0,0,12,0,0,0,0,182,232,0,16
108,R,115,H R 1116,14-Mar-2018,5:45 PM,On Passage,Taking Account of Institutions with Low Operation Risk Act of 2017 or the TAILOR Act of 2017,Passed,231,1,0,5,16,168,0,9,0,0,0,0,247,169,0,14
109,R,115,H R 4263,15-Mar-2018,3:48 PM,On Motion to Recommit with Instructions,Regulation At Improvement Act of 2017,Failed,2,231,0,4,180,4,0,9,0,0,0,0,182,235,0,13
110,R,115,H R 4263,15-Mar-2018,3:55 PM,On Passage,Regulation At Improvement Act of 2017,Passed,232,1,0,4,14,169,0,10,0,0,0,0,246,170,0,14
111,R,115,H R 4545,15-Mar-2018,4:03 PM,On Agreeing to the Amendment,None,Failed,1,232,0,4,183,1,0,9,0,0,0,0,184,233,0,13
112,R,115,H R 4545,15-Mar-2018,4:10 PM,On Passage,Financial Institutions Examination Fairness and Reform Act,Passed,231,1,0,5,52,132,0,9,0,0,0,0,283,133,0,14
113,R,115,H RES 780,15-Mar-2018,4:17 PM,On Ordering the Previous Question,"Providing for consideration of H.R. 4061, the Financial Stability Oversight Council Improvement Act of 2017; and providing for consideration of H.R. 4293, the Stress Test Improvement Act of 2017",Passed,232,0,0,5,0,182,0,11,0,0,0,0,232,182,0,16
114,R,115,H RES 780,15-Mar-2018,4:23 PM,On Agreeing to the Resolution,"Providing for consideration of H.R. 4061, the Financial Stability Oversight Council Improvement Act of 2017; and providing for consideration of H.R. 4293, the Stress Test Improvement Act of 2017",Passed,230,0,0,7,5,177,0,11,0,0,0,0,235,177,0,18
115,R,115,H R 835,19-Mar-2018,6:52 PM,On Motion to Suspend the Rules and Pass,"To update the map of, and modify the maximum acreage available for inclusion in, the Florissant Fossil Beds National Monument",Passed,220,3,0,14,165,0,0,27,0,0,0,0,385,3,0,41
116,R,115,H R 4851,19-Mar-2018,7:02 PM,"On Motion to Suspend the Rules and Pass, as Amended",Kennedy--King National Commemorative Site Act,Passed,222,0,0,15,169,0,0,23,0,0,0,0,391,0,0,38
117,R,115,H RES 787,20-Mar-2018,2:05 PM,On Ordering the Previous Question,"Providing for consideration of H.R. 4566, the Alleviating Stress Test Burdens to Help Investors Act; Providing for consideration of H.R. 5247, the Trickett Wendler, Frank Mongiello, Jordan McLinn, and Matthew Bellina Right to Try Act of 2018; and for other purposes",Passed,233,0,0,4,0,181,0,11,0,0,0,0,233,181,0,15
118,R,115,H RES 787,20-Mar-2018,2:18 PM,On Agreeing to the Resolution,"Providing for consideration of H.R. 4566, the Alleviating Stress Test Burdens to Help Investors Act; Providing for consideration of H.R. 5247, the Trickett Wendler, Frank Mongiello, Jordan McLinn, and Matthew Bellina Right to Try Act of 2018; and for other purposes",Passed,225,3,0,9,0,180,0,12,0,0,0,0,225,183,0,21
119,R,115,H R 4566,20-Mar-2018,3:43 PM,On Passage,Alleviating Stress Test Burdens to Help Investors Act,Passed,233,0,0,4,162,19,0,11,0,0,0,0,395,19,0,15
120,R,115,H R 5247,21-Mar-2018,9:43 PM,On Motion to Recommit with Instructions,"Trickett Wendler, Frank Mongiello, Jordan McLinn, and Matthew Bellina Right to Try Act of 2018",Failed,1,232,0,4,181,1,0,10,0,0,0,0,182,233,0,14
121,R,115,H R 5247,21-Mar-2018,9:53 PM,On Passage,"Trickett Wendler, Frank Mongiello, Jordan McLinn, and Matthew Bellina Right to Try Act of 2018",Passed,232,2,0,3,35,147,0,10,0,0,0,0,267,149,0,13
122,R,115,JOURNAL,21-Mar-2018,10:06 PM,On Approving the Journal,None,Passed,136,96,0,5,80,96,2,14,0,0,0,0,216,192,2,19
123,R,115,H RES 796,22-Mar-2018,10:44 AM,On Ordering the Previous Question,"Providing for consideration of the Senate amendment to H.R. 1625, Consolidated Appropriations Act and the TARGET Act; and providing for proceedings during the period from March 23, 2018, through April 9, 2018",Passed,233,0,0,4,0,186,0,6,0,0,0,0,233,186,0,10
124,R,115,H RES 796,22-Mar-2018,10:52 AM,On Agreeing to the Resolution,"Providing for consideration of the Senate amendment to H.R. 1625, Consolidated Appropriations Act and the TARGET Act; and providing for proceedings during the period from March 23, 2018, through April 9, 2018",Passed,210,25,0,3,1,182,0,9,0,0,0,0,211,207,0,12
125,R,115,H R 4227,22-Mar-2018,11:00 AM,"On Motion to Suspend the Rules and Pass, as Amended",Vehicular Terrorism Prevention Act of 2018,Passed,232,2,0,3,185,0,0,7,0,0,0,0,417,2,0,10
126,R,115,H R 5131,22-Mar-2018,11:07 AM,"On Motion to Suspend the Rules and Pass, as Amended",Surface Transportation Security Improvement Act 2018,Passed,228,5,0,4,181,0,0,11,0,0,0,0,409,5,0,15
127,R,115,H R 1625,22-Mar-2018,12:59 PM,On Motion to Concur in the Senate Amendment with an Amendment,TARGET Act,Passed,145,90,0,3,111,77,0,4,0,0,0,0,256,167,0,7
128,R,115,H R 4467,22-Mar-2018,1:05 PM,"On Motion to Suspend the Rules and Pass, as Amended",Strengthening Aviation Security Act of 2018,Passed,230,0,0,7,178,0,0,14,0,0,0,0,408,0,0,21
129,R,115,H R 5089,22-Mar-2018,1:13 PM,"On Motion to Suspend the Rules and Pass, as Amended",Strengthening Local Transportation Security Capabilities Act of 2018,Passed,221,1,0,15,176,0,0,16,0,0,0,0,397,1,0,31
130,R,115,H R 2219,10-Apr-2018,6:56 PM,"On Motion to Suspend the Rules and Pass, as Amended",End Banking for Human Traffickers Act of 2018,Passed,226,2,0,8,182,0,0,10,0,0,0,0,408,2,0,18
131,R,115,H R 4203,10-Apr-2018,7:05 PM,"On Motion to Suspend the Rules and Pass, as Amended",Combat Online Predators Act,Passed,226,2,0,8,183,0,0,9,0,0,0,0,409,2,0,17
132,R,115,JOURNAL,10-Apr-2018,7:13 PM,On Approving the Journal,None,Passed,135,85,0,16,96,81,1,14,0,0,0,0,231,166,1,30
133,R,115,H RES 811,11-Apr-2018,2:05 PM,On Ordering the Previous Question,"Providing for consideration of the bill (H.R. 4790) to amend the Volcker rule to give the Board of Governors of the Federal Reserve System sole rulemaking authority, to exclude community banks from the requirements of the Volcker rule, and for other purposes, and providing for motions to suspend the rules",Passed,231,1,0,4,0,185,0,7,0,0,0,0,231,186,0,11
134,R,115,H RES 811,11-Apr-2018,2:15 PM,On Agreeing to the Resolution,"Providing for consideration of the bill (H.R. 4790) to amend the Volcker rule to give the Board of Governors of the Federal Reserve System sole rulemaking authority, to exclude community banks from the requirements of the Volcker rule, and for other purposes, and providing for motions to suspend the rules",Passed,229,0,0,7,1,184,0,7,0,0,0,0,230,184,0,14
135,R,115,H R 4061,11-Apr-2018,4:53 PM,On Passage,Financial Stability Oversight Council Improvement Act,Passed,231,1,0,4,66,120,0,6,0,0,0,0,297,121,0,10
136,R,115,H R 4293,11-Apr-2018,5:01 PM,On Motion to Recommit with Instructions,Stress Test Improvement Act,Failed,2,231,0,3,186,0,0,6,0,0,0,0,188,231,0,9
137,R,115,H R 4293,11-Apr-2018,5:09 PM,On Passage,Stress Test Improvement Act,Passed,232,1,0,3,13,173,0,6,0,0,0,0,245,174,0,9
138,R,115,H J RES 2,12-Apr-2018,5:29 PM,On Motion to Suspend the Rules and Pass,Proposing a balanced budget amendment to the Constitution of the United States,Failed,226,6,0,4,7,178,0,7,0,0,0,0,233,184,0,11
139,R,115,H R 4790,13-Apr-2018,10:47 AM,On Passage,Volcker Rule Regulatory Harmonization Act,Passed,222,1,0,13,78,103,0,12,0,0,0,0,300,104,0,25
140,R,115,H R 146,16-Apr-2018,6:55 PM,"On Motion to Suspend the Rules and Pass, as Amended",Eastern Band of Cherokee Historic Lands Reacquisition Act,Passed,215,2,0,19,168,0,0,25,0,0,0,0,383,2,0,44
141,R,115,S 167,16-Apr-2018,7:03 PM,On Motion to Suspend the Rules and Pass,"To designate a National Memorial to Fallen Educators at the National Teachers Hall of Fame in Emporia, Kansas",Passed,216,1,0,19,168,0,0,25,0,0,0,0,384,1,0,44
142,R,115,H R 5192,17-Apr-2018,5:20 PM,On Passage,Protecting Children from Identity Theft Act,Passed,230,1,0,5,190,0,0,3,0,0,0,0,420,1,0,8
143,R,115,H RES 831,18-Apr-2018,1:25 PM,On Ordering the Previous Question,"Providing for consideration of the bill (H.R. 5444) Taxpayer First Act, and providing for consideration of the (H.R. 5445) 21st Century IRS Act",Passed,226,1,0,9,0,188,0,5,0,0,0,0,226,189,0,14
144,R,115,H RES 831,18-Apr-2018,1:32 PM,On Agreeing to the Resolution,"Providing for consideration of the bill (H.R. 5444) Taxpayer First Act, and providing for consideration of the (H.R. 5445) 21st Century IRS Act",Passed,227,2,0,7,12,175,0,6,0,0,0,0,239,177,0,13
145,R,115,H R 5445,18-Apr-2018,5:53 PM,On Passage,21st Century IRS Act,Passed,225,3,0,8,189,0,0,4,0,0,0,0,414,3,0,12
146,R,115,H R 5444,18-Apr-2018,6:02 PM,On Passage,Taxpayer First Act,Passed,227,0,0,9,187,0,0,6,0,0,0,0,414,0,0,15
147,R,115,H R 2905,18-Apr-2018,6:09 PM,"On Motion to Suspend the Rules and Pass, as Amended",Justice for Victims of IRS Scams and Identity Theft Act of 2018,Passed,219,2,0,15,184,1,0,8,0,0,0,0,403,3,0,23
148,R,115,H CON RES 111,24-Apr-2018,6:56 PM,"On Motion to Suspend the Rules and Agree, as Amended","Recognizing and supporting the efforts of the United Bid Committee to bring the 2026 Federation Internationale de Football Association (FIFA) World Cup competition to Canada, Mexico, and the United States",Passed,211,3,0,21,181,0,0,12,0,0,0,0,392,3,0,33
149,R,115,H R 5086,24-Apr-2018,7:06 PM,"On Motion to Suspend the Rules and Pass, as Amended",Innovators to Entrepreneurs Act of 2018,Passed,199,16,0,20,180,0,0,13,0,0,0,0,379,16,0,33
150,R,115,H RES 839,25-Apr-2018,1:53 PM,On Ordering the Previous Question,"Providing for consideration of H.R. 4, the FAA Reauthorization Act of 2018; and providing for consideration of H.R. 3144, to provide for operations of the Federal Columbia River Power System pursuant to a certain operation plan for a specified period of time",Passed,225,1,0,9,0,189,0,4,0,0,0,0,225,190,0,13
151,R,115,H RES 839,25-Apr-2018,2:00 PM,On Agreeing to the Resolution,"Providing for consideration of H.R. 4, the FAA Reauthorization Act of 2018; and providing for consideration of H.R. 3144, to provide for operations of the Federal Columbia River Power System pursuant to a certain operation plan for a specified period of time",Passed,225,0,0,10,3,184,0,6,0,0,0,0,228,184,0,16
152,R,115,H R 3144,25-Apr-2018,4:28 PM,On Motion to Recommit with Instructions,"To provide for operations of the Federal Columbia River Power System pursuant to a certain operation plan for a specified period of time, and for other purposes",Failed,2,225,0,8,188,1,0,4,0,0,0,0,190,226,0,12
153,R,115,H R 3144,25-Apr-2018,4:35 PM,On Passage,"To provide for operations of the Federal Columbia River Power System pursuant to a certain operation plan for a specified period of time, and for other purposes",Passed,217,8,0,10,8,181,0,4,0,0,0,0,225,189,0,14
154,R,115,H R 5447,25-Apr-2018,4:42 PM,"On Motion to Suspend the Rules and Pass, as Amended",Music Modernization Act,Passed,227,0,0,8,188,0,0,5,0,0,0,0,415,0,0,13
155,R,115,H R 4,26-Apr-2018,5:16 PM,On Agreeing to the Amendment,None,Failed,10,219,0,6,182,4,0,7,0,0,0,0,192,223,0,13
156,R,115,H R 4,26-Apr-2018,5:20 PM,On Agreeing to the Amendment,None,Failed,27,201,0,7,10,174,0,9,0,0,0,0,37,375,0,16
157,R,115,H R 4,26-Apr-2018,5:27 PM,On Agreeing to the Amendment,None,Failed,172,57,0,6,0,186,0,7,0,0,0,0,172,243,0,13
158,R,115,H R 4,26-Apr-2018,5:32 PM,On Agreeing to the Amendment,None,Failed,13,216,0,6,79,107,0,7,0,0,0,0,92,323,0,13
159,R,115,H R 4,26-Apr-2018,5:35 PM,On Agreeing to the Amendment,None,Agreed to,217,12,0,6,5,181,0,7,0,0,0,0,222,193,0,13
160,R,115,H R 4,26-Apr-2018,5:39 PM,On Agreeing to the Amendment,None,Failed,7,222,0,6,180,5,0,8,0,0,0,0,187,227,0,14
161,R,115,H R 4744,26-Apr-2018,5:47 PM,"On Motion to Suspend the Rules and Pass, as Amended",Iran Human Rights and Hostage-Taking Accountability Act,Passed,224,2,0,9,186,0,0,7,0,0,0,0,410,2,0,16
162,R,115,H R 4,27-Apr-2018,11:06 AM,On Agreeing to the Amendment,None,Failed,109,115,0,11,4,178,0,11,0,0,0,0,113,293,0,22
163,R,115,H R 4,27-Apr-2018,11:12 AM,On Agreeing to the Amendment,None,Agreed to,210,13,0,12,2,178,0,13,0,0,0,0,212,191,0,25
164,R,115,H R 4,27-Apr-2018,11:30 AM,On Motion to Recommit with Instructions,FAA Reauthorization Act,Failed,0,223,0,12,182,0,0,11,0,0,0,0,182,223,0,23
165,R,115,H R 4,27-Apr-2018,11:38 AM,On Passage,FAA Reauthorization Act,Passed,217,7,0,11,176,6,0,11,0,0,0,0,393,13,0,22
166,R,115,H RES 856,27-Apr-2018,12:04 PM,On Motion to Table,None,Passed,215,2,3,15,0,169,0,24,0,0,0,0,215,171,3,39
167,R,115,H R 4910,7-May-2018,6:54 PM,"On Motion to Suspend the Rules and Pass, as Amended",Veterans Cemetery Benefit Correction Act,Passed,218,0,0,16,170,0,0,23,0,0,0,0,388,0,0,39
168,R,115,H R 4335,7-May-2018,7:09 PM,"On Motion to Suspend the Rules and Pass, as Amended",Servicemember Family Burial Act,Passed,217,0,0,18,172,0,0,21,0,0,0,0,389,0,0,39
169,R,115,H RES 872,8-May-2018,1:29 PM,On Ordering the Previous Question,"Providing for consideration of H.R. 5645, the Standard Merger and Acquisition Reviews Through Equal Rules Act of 2018; H.R. 2152, the Citizens’ Right to Know Act; and S.J.Res. 57, providing for congressional disapproval of the rule relating to Indirect Auto Lending and Compliance with the Equal Credit Opportunity Act",Passed,226,0,0,9,0,177,0,16,0,0,0,0,226,177,0,25
170,R,115,H RES 872,8-May-2018,1:38 PM,On Agreeing to the Resolution,"Providing for consideration of H.R. 5645, the Standard Merger and Acquisition Reviews Through Equal Rules Act of 2018; H.R. 2152, the Citizens’ Right to Know Act; and S.J.Res. 57, providing for congressional disapproval of the rule relating to Indirect Auto Lending and Compliance with the Equal Credit Opportunity Act",Passed,226,0,0,9,1,181,0,11,0,0,0,0,227,181,0,20
171,R,115,S J RES 57,8-May-2018,4:48 PM,On Passage,"Providing for congressional disapproval under chapter 8 of title 5, United States Code, of the rule submitted by Bureau of Consumer Financial Protection relating to “Indirect Auto Lending and Compliance with the Equal Credit Opportunity Act”",Passed,223,1,1,10,11,174,0,8,0,0,0,0,234,175,1,18
172,R,115,H RES 878,8-May-2018,5:14 PM,On Motion to Table,None,Passed,223,1,0,11,0,181,0,12,0,0,0,0,223,182,0,23
173,R,115,H RES 879,9-May-2018,1:33 PM,On Ordering the Previous Question,"Providing for consideration of the bill (H.R. 3053) to amend the Nuclear Waste Policy Act of 1982, and for other purposes",Passed,223,0,0,12,0,189,0,4,0,0,0,0,223,189,0,16
174,R,115,H RES 879,9-May-2018,1:41 PM,On Agreeing to the Resolution,"Providing for consideration of the bill (H.R. 3053) to amend the Nuclear Waste Policy Act of 1982, and for other purposes",Passed,221,0,1,13,3,184,0,6,0,0,0,0,224,184,1,19
175,R,115,H R 2152,9-May-2018,4:11 PM,On Passage,Citizens’ Right to Know Act,Passed,219,8,0,8,2,189,0,2,0,0,0,0,221,197,0,10
176,R,115,H R 5645,9-May-2018,4:19 PM,On Motion to Recommit with Instructions,Standard Merger and Acquisition Reviews Through Equal Rules Act,Failed,2,220,0,13,191,0,0,2,0,0,0,0,193,220,0,15
177,R,115,H R 5645,9-May-2018,4:25 PM,On Passage,Standard Merger and Acquisition Reviews Through Equal Rules Act,Passed,226,1,0,8,4,184,0,5,0,0,0,0,230,185,0,13
178,R,115,H R 3053,10-May-2018,11:15 AM,On Agreeing to the Amendment,None,Failed,1,225,0,9,79,107,0,7,0,0,0,0,80,332,0,16
179,R,115,H R 3053,10-May-2018,11:24 AM,On Passage,Nuclear Waste Policy Amendments Act,Passed,221,5,0,9,119,67,0,7,0,0,0,0,340,72,0,16
180,R,115,JOURNAL,10-May-2018,11:31 AM,On Approving the Journal,None,Passed,127,85,1,22,80,94,1,18,0,0,0,0,207,179,2,40
181,R,115,H R 613,15-May-2018,6:54 PM,On Motion to Suspend the Rules and Pass,Lieutenant Osvaldo Albarati Correctional Officer Self-Protection Act,Passed,214,0,0,20,164,0,0,29,0,0,0,0,378,0,0,49
182,R,115,H R 4854,15-May-2018,7:02 PM,On Motion to Suspend the Rules and Pass,"To amend the DNA Analysis Backlog Elimination Act of 2000 to provide additional resources to State and local prosecutors, and for other purposes",Passed,213,1,0,20,164,0,0,29,0,0,0,0,377,1,0,49
183,R,115,H RES 285,15-May-2018,7:09 PM,On Motion to Suspend the Rules and Agree,Expressing the sense of the United States House of Representatives that Congress and the President should empower the creation of police and community alliances designed to enhance and improve communication and collaboration between members of the law enforcment community and the public they serve,Passed,213,2,0,19,164,0,0,29,0,0,0,0,377,2,0,48
184,R,115,H RES 891,16-May-2018,1:16 PM,On Consideration of the Resolution,"Providing for consideration of the bill (H.R. 5698), Protect and Serve Act; providing for consideration of the bill (S. 2372), Veterans Cemetery Benefit Correction Act; and providing for consideration of the bill (H.R. 2), Agriculture and Nutrition Act",Passed,223,2,0,9,0,179,0,14,0,0,0,0,223,181,0,23
185,R,115,H RES 891,16-May-2018,2:49 PM,On Ordering the Previous Question,"Providing for consideration of the bill (H.R. 5698), Protect and Serve Act; providing for consideration of the bill (S. 2372), Veterans Cemetery Benefit Correction Act; and providing for consideration of the bill (H.R. 2), Agriculture and Nutrition Act",Passed,230,1,0,3,0,183,0,10,0,0,0,0,230,184,0,13
186,R,115,H RES 891,16-May-2018,2:57 PM,On Agreeing to the Resolution,"Providing for consideration of the bill (H.R. 5698), Protect and Serve Act; providing for consideration of the bill (S. 2372), Veterans Cemetery Benefit Correction Act; and providing for consideration of the bill (H.R. 2), Agriculture and Nutrition Act",Passed,228,1,0,5,1,184,0,8,0,0,0,0,229,185,0,13
187,R,115,S 35,16-May-2018,3:09 PM,On Motion to Suspend the Rules and Pass,Black Hills National Cemetery Boundary Expansion Act,Passed,223,0,0,11,184,0,0,9,0,0,0,0,407,0,0,20
188,R,115,H R 5698,16-May-2018,6:35 PM,On Passage,Protect and Serve Act of 2018,Passed,220,11,0,3,162,24,0,7,0,0,0,0,382,35,0,10
189,R,115,S 2372,16-May-2018,6:42 PM,On Passage,Veterans Cemetery Benefit Correction Act,Passed,231,0,0,3,116,70,0,7,0,0,0,0,347,70,0,10
190,R,115,H RES 900,17-May-2018,1:56 PM,On Ordering the Previous Question,"Providing for further consideration of H.R. 2, the Agriculture and Nutrition Act",Passed,228,1,0,5,0,188,0,5,0,0,0,0,228,189,0,10
191,R,115,H RES 900,17-May-2018,2:04 PM,On Agreeing to the Resolution,"Providing for further consideration of H.R. 2, the Agriculture and Nutrition Act",Passed,228,0,0,6,0,188,0,5,0,0,0,0,228,188,0,11
192,R,115,JOURNAL,17-May-2018,2:17 PM,On Approving the Journal,None,Passed,141,80,1,12,76,108,1,8,0,0,0,0,217,188,2,20
193,R,115,H R 2,17-May-2018,5:53 PM,On Agreeing to the Amendment,None,Failed,96,132,0,6,41,146,0,6,0,0,0,0,137,278,0,12
194,R,115,H R 2,17-May-2018,5:58 PM,On Agreeing to the Amendment,None,Failed,34,194,0,6,0,186,0,7,0,0,0,0,34,380,0,13
195,R,115,H R 2,17-May-2018,6:02 PM,On Agreeing to the Amendment,None,Failed,83,145,0,6,0,185,0,8,0,0,0,0,83,330,0,14
196,R,115,H R 2,17-May-2018,6:06 PM,On Agreeing to the Amendment,None,Agreed to,222,6,0,6,0,186,0,7,0,0,0,0,222,192,0,13
197,R,115,H R 2,17-May-2018,6:11 PM,On Agreeing to the Amendment,None,Failed,74,154,0,6,1,186,0,6,0,0,0,0,75,340,0,12
198,R,115,H R 2,17-May-2018,6:16 PM,On Agreeing to the Amendment,None,Agreed to,220,8,0,6,4,183,0,6,0,0,0,0,224,191,0,12
199,R,115,H R 2,17-May-2018,6:29 PM,On Agreeing to the Amendment,None,Agreed to,206,23,0,5,2,184,0,7,0,0,0,0,208,207,0,12
200,R,115,H R 2,18-May-2018,11:18 AM,On Agreeing to the Amendment,None,Failed,53,175,0,6,1,181,0,11,0,0,0,0,54,356,0,17
201,R,115,H R 2,18-May-2018,11:23 AM,On Agreeing to the Amendment,None,Failed,72,156,0,6,7,175,0,11,0,0,0,0,79,331,0,17
202,R,115,H R 2,18-May-2018,11:29 AM,On Agreeing to the Amendment,None,Agreed to,204,23,0,7,155,28,0,10,0,0,0,0,359,51,0,17
203,R,115,H R 2,18-May-2018,11:36 AM,On Agreeing to the Amendment,None,Agreed to,225,3,0,6,13,170,0,10,0,0,0,0,238,173,0,16
204,R,115,H R 2,18-May-2018,11:55 AM,On Motion to Recommit with Instructions,Agriculture and Nutrition Act of 2018,Failed,0,226,0,8,183,0,0,10,0,0,0,0,183,226,0,18
205,R,115,H R 2,18-May-2018,12:03 PM,On Passage,Agriculture and Nutrition Act of 2018,Failed,198,30,0,7,0,183,0,10,0,0,0,0,198,213,0,17
206,R,115,JOURNAL,18-May-2018,12:23 PM,On Approving the Journal,None,Passed,142,60,0,32,41,103,1,48,0,0,0,0,183,163,1,80
207,R,115,H R 4830,21-May-2018,6:56 PM,"On Motion to Suspend the Rules and Pass, as Amended",Servicemembers Improved Transition through Reforms for Ensuring Progress Act,Passed,212,0,0,22,170,0,0,23,0,0,0,0,382,0,0,45
208,R,115,H R 4451,21-May-2018,7:08 PM,"On Motion to Suspend the Rules and Pass, as Amended",Homeless Veterans’ Reintegration Programs Reauthorization Act of 2018,Passed,210,0,0,24,167,1,0,25,0,0,0,0,377,1,0,49
209,R,115,H R 3832,21-May-2018,7:16 PM,"On Motion to Suspend the Rules and Pass, as Amended",Veterans Opioid Abuse Prevention Act,Passed,208,2,0,24,169,0,0,24,0,0,0,0,377,2,0,48
210,R,115,H RES 905,22-May-2018,12:44 PM,On Ordering the Previous Question,"Providing for consideration of H.R. 5515, NDAA FY, 2019; providing for consideration of S. 204, Trickett Wendler, Frank Mongiello, Jordan McLinn, and Matthew Bellina Right to Try Act of 2017, and providing for consideration of S. 2155, the Economic Growth, Regulatory Relief, and Consumer Protection Act",Passed,222,1,0,11,0,183,0,10,0,0,0,0,222,184,0,21
211,R,115,H RES 905,22-May-2018,12:52 PM,On Agreeing to the Resolution,"Providing for consideration of H.R. 5515, NDAA FY, 2019; providing for consideration of S. 204, Trickett Wendler, Frank Mongiello, Jordan McLinn, and Matthew Bellina Right to Try Act of 2017, and providing for consideration of S. 2155, the Economic Growth, Regulatory Relief, and Consumer Protection Act",Passed,222,2,0,10,5,178,0,10,0,0,0,0,227,180,0,20
212,R,115,JOURNAL,22-May-2018,1:01 PM,On Approving the Journal,None,Passed,142,78,0,14,77,101,1,14,0,0,0,0,219,179,1,28
213,R,115,S 204,22-May-2018,5:17 PM,On Motion to Recommit with Instructions,"Trickett Wendler, Frank Mongiello, Jordan McLinn, and Matthew Bellina Right to Try Act",Failed,0,227,0,7,187,4,0,2,0,0,0,0,187,231,0,9
214,R,115,S 204,22-May-2018,5:25 PM,On Passage,"Trickett Wendler, Frank Mongiello, Jordan McLinn, and Matthew Bellina Right to Try Act",Passed,228,0,0,6,22,169,0,2,0,0,0,0,250,169,0,8
215,R,115,H R 5682,22-May-2018,5:32 PM,"On Motion to Suspend the Rules and Pass, as Amended",FIRST STEP Act,Passed,226,2,0,6,134,57,0,2,0,0,0,0,360,59,0,8
216,R,115,S 2155,22-May-2018,5:41 PM,On Passage,"Economic Growth, Regulatory Relief, and Consumer Protection Act",Passed,225,1,0,8,33,158,0,2,0,0,0,0,258,159,0,10
217,R,115,H RES 908,23-May-2018,1:55 PM,On Ordering the Previous Question,"Providing for consideration of the bill (H.R. 5515) National Defense Authorization Act for Fiscal Year 2019, and for providing for proceedings during the period from May 25, 2018, through June 4, 2018",Passed,222,0,0,12,0,189,0,4,0,0,0,0,222,189,0,16
218,R,115,H RES 908,23-May-2018,2:03 PM,On Agreeing to the Resolution,"Providing for consideration of the bill (H.R. 5515) National Defense Authorization Act for Fiscal Year 2019, and for providing for proceedings during the period from May 25, 2018, through June 4, 2018",Passed,223,1,0,10,6,182,0,5,0,0,0,0,229,183,0,15
219,R,115,H R 5515,23-May-2018,2:10 PM,On Agreeing to the Amendment,None,Failed,7,217,0,10,55,134,0,4,0,0,0,0,62,351,0,14
220,R,115,H R 5515,23-May-2018,2:14 PM,On Agreeing to the Amendment,None,Failed,8,217,0,9,52,138,0,3,0,0,0,0,60,355,0,12
221,R,115,H R 5515,23-May-2018,2:19 PM,On Agreeing to the Amendment,None,Failed,9,216,0,9,189,1,0,3,0,0,0,0,198,217,0,12
222,R,115,H R 5515,23-May-2018,2:25 PM,On Agreeing to the Amendment,None,Failed,5,219,0,10,183,7,0,3,0,0,0,0,188,226,0,13
223,R,115,H R 5515,23-May-2018,4:22 PM,On Agreeing to the Amendment,None,Agreed to,224,1,0,9,5,182,0,6,0,0,0,0,229,183,0,15
224,R,115,H R 5515,23-May-2018,4:27 PM,On Agreeing to the Amendment,None,Agreed to,221,1,0,12,187,0,0,6,0,0,0,0,408,1,0,18
225,R,115,H R 5515,23-May-2018,4:34 PM,On Agreeing to the Amendment,None,Failed,36,188,0,10,124,64,0,5,0,0,0,0,160,252,0,15
226,R,115,H R 5515,23-May-2018,4:39 PM,On Agreeing to the Amendment,None,Failed,47,177,0,10,127,62,0,4,0,0,0,0,174,239,0,14
227,R,115,H R 5515,23-May-2018,4:43 PM,On Agreeing to the Amendment,None,Agreed to,194,30,0,10,188,0,0,5,0,0,0,0,382,30,0,15
228,R,115,H R 5515,23-May-2018,4:49 PM,On Agreeing to the Amendment,None,Failed,8,216,0,10,166,23,0,4,0,0,0,0,174,239,0,14
229,R,115,H R 5515,24-May-2018,10:22 AM,Table the Appeal of the Ruling of the Chair,National Defense Authorization Act FY 2019,Passed,223,3,0,8,1,188,0,4,0,0,0,0,224,191,0,12
230,R,115,H R 5515,24-May-2018,10:31 AM,On Passage,National Defense Authorization Act FY 2019,Passed,220,7,0,7,131,59,0,3,0,0,0,0,351,66,0,10
231,R,115,H R 5005,5-Jun-2018,6:55 PM,On Motion to Suspend the Rules and Pass,"To direct the Secretary of the Interior to conduct a special resource study to determine the suitability and feasibility of establishing the birthplace of James Weldon Johnson in Jacksonville, Florida, as a unit of the National Park System",Passed,212,5,0,17,162,0,0,31,0,0,0,0,374,5,0,48
232,R,115,H R 2991,5-Jun-2018,7:05 PM,"On Motion to Suspend the Rules and Pass, as Amended",Susquehanna National Heritage Area Act,Passed,211,9,0,14,162,0,0,31,0,0,0,0,373,9,0,45
233,R,115,H R 5655,5-Jun-2018,7:13 PM,On Motion to Suspend the Rules and Pass,Camp Nelson Heritage National Monument Act,Passed,214,4,0,16,162,0,0,31,0,0,0,0,376,4,0,47
234,R,115,H RES 918,6-Jun-2018,1:44 PM,On Ordering the Previous Question,Providing for consideration of the Senate amendment to the bill (H.R. 3249) Project Safe Neighborhoods Grant Program; providing for consideration of (H.R. 8) the Water Resources Development Act; and providing for consideration of (H.R. 5895) Energy and Water Development and Related Agencies Appropriations Act,Passed,224,0,0,10,0,176,0,17,0,0,0,0,224,176,0,27
235,R,115,H RES 918,6-Jun-2018,1:50 PM,On Agreeing to the Resolution,Providing for consideration of the Senate amendment to the bill (H.R. 3249) Project Safe Neighborhoods Grant Program; providing for consideration of (H.R. 8) the Water Resources Development Act; and providing for consideration of (H.R. 5895) Energy and Water Development and Related Agencies Appropriations Act,Passed,220,3,0,11,3,172,0,18,0,0,0,0,223,175,0,29
236,R,115,JOURNAL,6-Jun-2018,1:57 PM,On Approving the Journal,None,Passed,141,79,0,14,78,98,1,16,0,0,0,0,219,177,1,30
237,R,115,H R 8,6-Jun-2018,9:25 PM,On Motion to Recommit with Instructions,Water Resources Development Act of 2018,Failed,1,227,0,6,179,0,0,14,0,0,0,0,180,227,0,20
238,R,115,H R 8,6-Jun-2018,9:32 PM,On Passage,Water Resources Development Act of 2018,Passed,227,2,0,5,181,0,0,12,0,0,0,0,408,2,0,17
239,R,115,H R 3249,6-Jun-2018,9:38 PM,On Motion to Concur in the Senate Amendment,Project Safe Neighborhoods Grant Program Authorization Act of 2018,Passed,216,13,0,5,178,0,2,13,0,0,0,0,394,13,2,18
240,R,115,H RES 923,7-Jun-2018,1:57 PM,On Ordering the Previous Question,Providing for further consideration of the bill (H.R. 5895) making appropriations for energy and water development and related agencies; and providing for consideration of the bill (H.R. 3) the Spending Cuts to Expired and Unnecessary Programs Act,Passed,227,1,0,6,0,184,0,9,0,0,0,0,227,185,0,15
241,R,115,H RES 923,7-Jun-2018,2:05 PM,On Agreeing to the Resolution,Providing for further consideration of the bill (H.R. 5895) making appropriations for energy and water development and related agencies; and providing for consideration of the bill (H.R. 3) the Spending Cuts to Expired and Unnecessary Programs Act,Passed,225,3,0,6,0,184,0,9,0,0,0,0,225,187,0,15
242,R,115,JOURNAL,7-Jun-2018,2:12 PM,On Approving the Journal,None,Passed,133,93,0,8,80,104,1,8,0,0,0,0,213,197,1,16
243,R,115,H R 3,7-Jun-2018,9:17 PM,On Passage,Spending Cuts to Expired and Unnecessary Programs Act,Passed,210,19,0,5,0,187,0,6,0,0,0,0,210,206,0,11
244,R,115,H R 5895,7-Jun-2018,9:23 PM,On Agreeing to the Amendment,None,Failed,23,208,0,3,178,9,0,6,0,0,0,0,201,217,0,9
245,R,115,H R 5895,7-Jun-2018,9:27 PM,On Agreeing to the Amendment,None,Failed,24,207,0,3,180,7,0,6,0,0,0,0,204,214,0,9
246,R,115,H R 5895,7-Jun-2018,9:30 PM,On Agreeing to the Amendment,None,Failed,123,108,0,3,0,187,0,6,0,0,0,0,123,295,0,9
247,R,115,H R 5895,7-Jun-2018,9:33 PM,On Agreeing to the Amendment,None,Failed,5,226,0,3,172,15,0,6,0,0,0,0,177,241,0,9
248,R,115,H R 5895,7-Jun-2018,9:36 PM,On Agreeing to the Amendment,None,Failed,5,226,0,3,174,13,0,6,0,0,0,0,179,239,0,9
249,R,115,H R 5895,7-Jun-2018,9:39 PM,On Agreeing to the Amendment,None,Failed,138,90,2,4,1,186,0,6,0,0,0,0,139,276,2,10
250,R,115,H R 5895,7-Jun-2018,9:42 PM,On Agreeing to the Amendment,None,Failed,9,222,0,3,186,1,0,6,0,0,0,0,195,223,0,9
251,R,115,H R 5895,7-Jun-2018,9:46 PM,On Agreeing to the Amendment,None,Failed,154,77,0,3,1,185,0,7,0,0,0,0,155,262,0,10
252,R,115,H R 5895,7-Jun-2018,9:50 PM,On Agreeing to the Amendment,None,Failed,127,103,0,4,1,186,0,6,0,0,0,0,128,289,0,10
253,R,115,H R 5895,8-Jun-2018,11:10 AM,On Agreeing to the Amendment,None,Agreed to,210,16,0,8,2,185,0,6,0,0,0,0,212,201,0,14
254,R,115,H R 5895,8-Jun-2018,11:15 AM,On Agreeing to the Amendment,None,Agreed to,202,22,0,10,5,179,0,9,0,0,0,0,207,201,0,19
255,R,115,H R 5895,8-Jun-2018,11:20 AM,On Agreeing to the Amendment,None,Failed,15,211,0,8,180,6,0,7,0,0,0,0,195,217,0,15
256,R,115,H R 5895,8-Jun-2018,11:36 AM,On Motion to Recommit with Instructions,"Making appropriations for energy and water development and related agencies for the fiscal year ending September 30, 2019, and for other purposes",Failed,2,225,0,7,185,0,0,8,0,0,0,0,187,225,0,15
257,R,115,H R 5895,8-Jun-2018,11:43 AM,On Passage,"Making appropriations for energy and water development and related agencies for the fiscal year ending September 30, 2019, and for other purposes",Passed,212,16,0,6,23,163,0,7,0,0,0,0,235,179,0,13
258,R,115,H R 5327,12-Jun-2018,6:58 PM,"On Motion to Suspend the Rules and Pass, as Amended",Comprehensive Opioid Recovery Centers Act,Passed,204,13,0,17,179,0,0,14,0,0,0,0,383,13,0,31
259,R,115,H R 5041,12-Jun-2018,7:05 PM,"On Motion to Suspend the Rules and Pass, as Amended",Safe Disposal of Unused Medication Act,Passed,219,0,0,15,179,0,0,14,0,0,0,0,398,0,0,29
260,R,115,JOURNAL,12-Jun-2018,7:13 PM,On Approving the Journal,None,Passed,130,79,0,25,94,80,1,18,0,0,0,0,224,159,1,43
261,R,115,H RES 934,13-Jun-2018,1:43 PM,On Ordering the Previous Question,Providing for consideration of the bill (H.R. 2851) Stop the Importation and Trafficking of Synthetic Analogues Act; providing for consideration of the bill (H.R. 5735) THRIVE Act; and providing for consideration of (H.R. 5788) Securing the International Mail Against Opioids Act,Passed,230,0,0,4,0,183,0,10,0,0,0,0,230,183,0,14
262,R,115,H RES 934,13-Jun-2018,1:50 PM,On Agreeing to the Resolution,Providing for consideration of the bill (H.R. 2851) Stop the Importation and Trafficking of Synthetic Analogues Act; providing for consideration of the bill (H.R. 5735) THRIVE Act; and providing for consideration of (H.R. 5788) Securing the International Mail Against Opioids Act,Passed,229,0,0,5,4,175,0,14,0,0,0,0,233,175,0,19
263,R,115,H R 5890,13-Jun-2018,4:32 PM,On Motion to Suspend the Rules and Pass,Assisting States’ Implementation of Plans of Safe Care Act,Passed,222,3,0,9,184,0,0,9,0,0,0,0,406,3,0,18
264,R,115,H R 5891,13-Jun-2018,4:40 PM,On Motion to Suspend the Rules and Pass,Improving the Federal Response to Families Impacted by Substance Use Disorder Act,Passed,223,8,0,3,186,0,0,7,0,0,0,0,409,8,0,10
265,R,115,H R 5788,14-Jun-2018,4:27 PM,On Passage,Securing the International Mail Against Opioids Act,Passed,222,3,0,9,131,49,0,13,0,0,0,0,353,52,0,22
266,R,115,H R 5735,14-Jun-2018,4:36 PM,On Passage,THRIVE Act,Passed,218,7,0,9,12,166,0,15,0,0,0,0,230,173,0,24
267,R,115,H R 2851,15-Jun-2018,11:13 AM,On Agreeing to the Amendment,None,Agreed to,203,6,0,25,20,152,0,21,0,0,0,0,223,158,0,46
268,R,115,H R 2851,15-Jun-2018,11:24 AM,On Passage,Stop the Importation and Trafficking of Synthetic Analogues Act,Passed,197,12,0,25,42,130,0,21,0,0,0,0,239,142,0,46
269,R,115,H R 5687,19-Jun-2018,6:57 PM,"On Motion to Suspend the Rules and Pass, as Amended",Securing Opioids and Unused Narcotics with Deliberate Disposal and Packaging Act of 2018,Passed,190,13,0,31,152,0,0,41,0,0,0,0,342,13,0,72
270,R,115,H R 5676,19-Jun-2018,7:05 PM,"On Motion to Suspend the Rules and Pass, as Amended",Stop Excessive Narcotics in our Retirement Communities Protection Act of 2018,Passed,203,3,0,28,153,0,0,40,0,0,0,0,356,3,0,68
271,R,115,JOURNAL,19-Jun-2018,7:14 PM,On Approving the Journal,None,Passed,125,75,0,34,70,77,1,45,0,0,0,0,195,152,1,79
272,R,115,MOTION,20-Jun-2018,11:49 AM,On Motion to Fix the Convening Time,None,Passed,221,1,0,12,1,183,1,8,0,0,0,0,222,184,1,20
273,R,115,H RES 949,20-Jun-2018,11:57 AM,On Ordering the Previous Question,Providing for consideration of the bill (H.R. 6) Substance Use-Disorder Prevention that Promotes Opioid Recovery and Treatment for Patients and Communities Act;providing for consideration of the bill (H.R. 5797) IMD CARE Act;providing for consideration of the bill (H.R. 6082) Overdose Prevention and Patient Safety Act,Passed,221,0,0,13,0,185,0,8,0,0,0,0,221,185,0,21
274,R,115,H RES 949,20-Jun-2018,12:04 PM,On Agreeing to the Resolution,Providing for consideration of the bill (H.R. 6) Substance Use-Disorder Prevention that Promotes Opioid Recovery and Treatment for Patients and Communities Act;providing for consideration of the bill (H.R. 5797) IMD CARE Act;providing for consideration of the bill (H.R. 6082) Overdose Prevention and Patient Safety Act,Passed,220,3,0,11,5,177,0,11,0,0,0,0,225,180,0,22
275,R,115,H R 5797,20-Jun-2018,4:12 PM,On Motion to Recommit with Instructions,Individuals in Medicaid Deserve Care that is Appropriate and Responsible in its Execution Act,Failed,0,226,0,8,190,0,0,3,0,0,0,0,190,226,0,11
276,R,115,H R 5797,20-Jun-2018,4:20 PM,On Passage,Individuals in Medicaid Deserve Care that is Appropriate and Responsible in its Execution Act,Passed,211,15,0,8,50,140,0,3,0,0,0,0,261,155,0,11
277,R,115,H R 6082,20-Jun-2018,4:33 PM,On Motion to Recommit with Instructions,Overdose Prevention and Patient Safety Act,Failed,0,225,0,9,175,15,0,3,0,0,0,0,175,240,0,12
278,R,115,H R 6082,20-Jun-2018,4:44 PM,On Passage,Overdose Prevention and Patient Safety Act,Passed,217,7,0,10,140,50,0,3,0,0,0,0,357,57,0,13
279,R,115,H RES 954,21-Jun-2018,12:07 PM,On Ordering the Previous Question,"Providing for consideration of H.R. 4760, the Securing America’s Future Act of 2018",Passed,231,0,0,3,1,190,0,2,0,0,0,0,232,190,0,5
280,R,115,H RES 954,21-Jun-2018,12:14 PM,On Agreeing to the Resolution,"Providing for consideration of H.R. 4760, the Securing America’s Future Act of 2018",Passed,226,5,0,3,0,190,0,3,0,0,0,0,226,195,0,6
281,R,115,H R 4760,21-Jun-2018,2:04 PM,On Motion to Recommit with Instructions,Securing America’s Future Act of 2018,Failed,0,234,0,0,191,0,0,2,0,0,0,0,191,234,0,2
282,R,115,H R 4760,21-Jun-2018,2:11 PM,On Passage,Securing America’s Future Act of 2018,Failed,193,41,0,0,0,190,0,3,0,0,0,0,193,231,0,3
283,R,115,H R 2,21-Jun-2018,3:52 PM,On Motion to Reconsider,Agriculture and Nutrition Act of 2018,Passed,233,0,0,1,0,191,0,2,0,0,0,0,233,191,0,3
284,R,115,H R 2,21-Jun-2018,3:59 PM,On Passage,Agriculture and Nutrition Act of 2018,Passed,213,20,0,2,0,191,0,2,0,0,0,0,213,211,0,4
285,R,115,H RES 953,21-Jun-2018,4:05 PM,On Ordering the Previous Question,"Providing for consideration of the bill (H.R. 6136) to amend the immigration laws and provide for border security, and for other purposes",Passed,233,0,0,1,0,191,0,2,0,0,0,0,233,191,0,3
286,R,115,H RES 953,21-Jun-2018,4:13 PM,On Agreeing to the Resolution,"Providing for consideration of the bill (H.R. 6136) to amend the immigration laws and provide for border security, and for other purposes",Passed,227,5,0,2,0,190,0,3,0,0,0,0,227,195,0,5
287,R,115,H R 6,22-Jun-2018,11:52 AM,On Motion to Recommit with Instructions,Substance Use-Disorder Prevention that Promotes Opioid Recovery and Treatment for Patients and Communities Act,Failed,1,226,0,7,184,0,0,9,0,0,0,0,185,226,0,16
288,R,115,H R 6,22-Jun-2018,12:01 PM,On Passage,Substance Use-Disorder Prevention that Promotes Opioid Recovery and Treatment for Patients and Communities Act,Passed,214,13,0,7,182,1,0,10,0,0,0,0,396,14,0,17
289,R,115,H R 299,25-Jun-2018,6:53 PM,"On Motion to Suspend the Rules and Pass, as Amended",Blue Water Navy Vietnam Veterans Act,Passed,221,0,0,13,161,0,0,32,0,0,0,0,382,0,0,45
290,R,115,H R 5783,25-Jun-2018,7:02 PM,"On Motion to Suspend the Rules and Pass, as Amended",Cooperate with Law Enforcement Agencies and Watch Act of 2018,Passed,217,4,0,13,162,0,0,31,0,0,0,0,379,4,0,44
291,R,115,H RES 961,26-Jun-2018,1:20 PM,On Ordering the Previous Question,"Providing for consideration of the bill H.R. 6157, making appropriations for the Department of Defense for the fiscal year ending September 30, 2019, and for other purposes; and the bill H.R. 2083, the Endangered Salmon and Fisheries Predation Prevention Act.",Passed,217,0,0,17,2,172,0,19,0,0,0,0,219,172,0,36
292,R,115,H RES 961,26-Jun-2018,1:29 PM,On Agreeing to the Resolution,"Providing for consideration of the bill H.R. 6157, making appropriations for the Department of Defense for the fiscal year ending September 30, 2019, and for other purposes; and the bill H.R. 2083, the Endangered Salmon and Fisheries Predation Prevention Act.",Passed,215,3,0,16,7,169,0,17,0,0,0,0,222,172,0,33
293,R,115,H R 4294,26-Jun-2018,1:39 PM,"On Motion to Suspend the Rules and Pass, as Amended",Prevention of Private Information Dissemination Act of 2017,Passed,216,2,0,16,176,0,0,17,0,0,0,0,392,2,0,33
294,R,115,H R 2083,26-Jun-2018,3:52 PM,On Passage,Endangered Salmon and Fisheries Predation Prevention Act,Passed,220,5,0,9,68,111,0,14,0,0,0,0,288,116,0,23
295,R,115,H R 5841,26-Jun-2018,4:01 PM,"On Motion to Suspend the Rules and Pass, as Amended",Foreign Investment Risk Review Modernization Act,Passed,222,2,0,10,178,0,0,15,0,0,0,0,400,2,0,25
296,R,115,H R 6136,27-Jun-2018,1:43 PM,On Motion to Recommit with Instructions,Border Security and Immigration Reform Act of 2018,Failed,1,230,0,3,189,0,0,4,0,0,0,0,190,230,0,7
297,R,115,H R 6136,27-Jun-2018,1:50 PM,On Passage,Border Security and Immigration Reform Act of 2018,Failed,121,112,0,2,0,189,0,4,0,0,0,0,121,301,0,6
298,R,115,H RES 964,27-Jun-2018,1:58 PM,On Ordering the Previous Question,"Providing for further consideration of the bill (H.R. 6157) making appropriations for the Department of Defense for the fiscal year ending September 30, 2019, and for other purposes, and providing for proceedings during the period from June 29, 2018, through July 9, 2018",Passed,231,0,0,3,0,188,0,5,0,0,0,0,231,188,0,8
299,R,115,H RES 964,27-Jun-2018,2:09 PM,On Agreeing to the Resolution,"Providing for further consideration of the bill (H.R. 6157) making appropriations for the Department of Defense for the fiscal year ending September 30, 2019, and for other purposes, and providing for proceedings during the period from June 29, 2018, through July 9, 2018",Passed,225,3,0,6,5,182,0,6,0,0,0,0,230,185,0,12
300,R,115,H R 5515,27-Jun-2018,3:47 PM,On Motion to Instruct Conferees,National Defense Authorization Act FY 2019,Failed,0,231,0,3,188,0,0,5,0,0,0,0,188,231,0,8
301,R,115,H R 5515,27-Jun-2018,3:55 PM,On Closing Portions of the Conference,National Defense Authorization Act FY 2019,Passed,227,3,0,4,176,12,0,5,0,0,0,0,403,15,0,9
302,R,115,H R 6157,27-Jun-2018,4:02 PM,On Agreeing to the Amendment,None,Failed,87,141,0,6,101,87,0,5,0,0,0,0,188,228,0,11
303,R,115,H R 6157,27-Jun-2018,4:08 PM,On Agreeing to the Amendment,None,Failed,156,73,0,5,19,168,0,6,0,0,0,0,175,241,0,11
304,R,115,H RES 971,28-Jun-2018,10:11 AM,On Ordering the Previous Question,"Providing for consideration of H.Res. 970, insisting that the Department of Justice fully comply with the requests, including subpoenas, of the Permanent Select Committee on Intelligence and the subpoena issued by the Committee on the Judiciary relating to potential violations of FISA",Passed,224,0,0,10,0,186,0,7,0,0,0,0,224,186,0,17
305,R,115,H RES 971,28-Jun-2018,10:19 AM,On Agreeing to the Resolution,"Providing for consideration of H.Res. 970, insisting that the Department of Justice fully comply with the requests, including subpoenas, of the Permanent Select Committee on Intelligence and the subpoena issued by the Committee on the Judiciary relating to potential violations of FISA",Passed,224,0,0,10,0,184,0,9,0,0,0,0,224,184,0,19
306,R,115,H RES 970,28-Jun-2018,11:54 AM,On Agreeing to the Resolution,"Insisting that the Department of Justice fully comply with the requests, including subpoenas, of the Permanent Select Committee on Intelligence and the subpoena issued by the Committee on the Judiciary relating to potential violations of FISA by personnel of the Department of Justice and related matters",Passed,226,0,1,7,0,183,0,10,0,0,0,0,226,183,1,17
307,R,115,H R 6157,28-Jun-2018,12:00 PM,On Agreeing to the Amendment,None,Failed,90,138,0,6,26,158,0,9,0,0,0,0,116,296,0,15
308,R,115,H R 6157,28-Jun-2018,12:03 PM,On Agreeing to the Amendment,None,Failed,90,137,0,7,25,159,0,9,0,0,0,0,115,296,0,16
309,R,115,H R 6157,28-Jun-2018,12:07 PM,On Agreeing to the Amendment,None,Agreed to,96,132,0,6,156,25,0,12,0,0,0,0,252,157,0,18
310,R,115,H R 6157,28-Jun-2018,12:11 PM,On Agreeing to the Amendment,None,Failed,0,227,0,7,160,24,0,9,0,0,0,0,160,251,0,16
311,R,115,H R 6157,28-Jun-2018,12:15 PM,On Agreeing to the Amendment,None,Failed,50,177,0,7,94,90,0,9,0,0,0,0,144,267,0,16
312,R,115,H R 6157,28-Jun-2018,12:31 PM,On Motion to Recommit with Instructions,"Making appropriations for the Department of Defense for the fiscal year ending September 30, 2019, and for other purposes",Failed,2,224,0,8,184,0,0,9,0,0,0,0,186,224,0,17
313,R,115,H R 6157,28-Jun-2018,12:38 PM,On Passage,"Making appropriations for the Department of Defense for the fiscal year ending September 30, 2019, and for other purposes",Passed,222,3,0,9,137,46,0,10,0,0,0,0,359,49,0,19
314,R,115,H R 5793,10-Jul-2018,6:54 PM,On Motion to Suspend the Rules and Pass,Housing Choice Voucher Mobility Demonstration Act,Passed,195,19,0,20,173,0,0,20,0,0,0,0,368,19,0,40
315,R,115,H R 5749,10-Jul-2018,7:11 PM,"On Motion to Suspend the Rules and Pass, as Amended",Options Markets Stability Act,Passed,213,0,0,22,172,0,0,21,0,0,0,0,385,0,0,43
316,R,115,H RES 965,11-Jul-2018,2:08 PM,On Ordering the Previous Question,Providing for consideration of the bill (H.R. 200) Strengthening Fishing Communities and Increasing Flexibility in Fisheries Management Act,Passed,225,1,0,9,0,185,0,8,0,0,0,0,225,186,0,17
317,R,115,H RES 965,11-Jul-2018,2:18 PM,On Agreeing to the Resolution,Providing for consideration of the bill (H.R. 200) Strengthening Fishing Communities and Increasing Flexibility in Fisheries Management Act,Passed,227,0,0,8,0,184,0,9,0,0,0,0,227,184,0,17
318,R,115,H RES 985,11-Jul-2018,2:30 PM,On Ordering the Previous Question,Providing for consideration of the bill (H.R. 50) Unfunded Mandates Information and Transparency Act and providing for consideration of the bill (H.R. 3281) Reclamation Title Transfer and Non-Federal Infrastructure Incentivization Act,Passed,228,0,0,7,0,184,0,9,0,0,0,0,228,184,0,16
319,R,115,H RES 985,11-Jul-2018,2:37 PM,On Agreeing to the Resolution,Providing for consideration of the bill (H.R. 50) Unfunded Mandates Information and Transparency Act and providing for consideration of the bill (H.R. 3281) Reclamation Title Transfer and Non-Federal Infrastructure Incentivization Act,Passed,229,0,0,6,0,183,0,10,0,0,0,0,229,183,0,16
320,R,115,H R 200,11-Jul-2018,5:45 PM,On Motion to Recommit with Instructions,Strengthening Fishing Communities and Increasing Flexibility in Fisheries Management Act,Failed,1,227,0,7,186,1,0,6,0,0,0,0,187,228,0,13
321,R,115,H R 200,11-Jul-2018,5:53 PM,On Passage,Strengthening Fishing Communities and Increasing Flexibility in Fisheries Management Act,Passed,213,15,0,7,9,178,0,6,0,0,0,0,222,193,0,13
322,R,115,H RES 989,12-Jul-2018,1:26 PM,On Ordering the Previous Question,"Providing for consideration of the bill (H.R. 6237) to authorize appropriations for fiscal years 2018 and 2019 for intelligence and intelligence-related activities of the United States Government, Community Management Account, and the Central Intelligence Agency Retirement and Disability System, and for other purposes",Passed,229,0,0,6,0,182,0,11,0,0,0,0,229,182,0,17
323,R,115,H RES 989,12-Jul-2018,1:35 PM,On Agreeing to the Resolution,"Providing for consideration of the bill (H.R. 6237) to authorize appropriations for fiscal years 2018 and 2019 for intelligence and intelligence-related activities of the United States Government, Community Management Account, and the Central Intelligence Agency Retirement and Disability System, and for other purposes",Passed,228,1,0,6,7,177,0,9,0,0,0,0,235,178,0,15
324,R,115,H R 3281,12-Jul-2018,5:15 PM,On Motion to Recommit with Instructions,Reclamation Title Transfer and Non-Federal Infrastructure Incentivization Act,Failed,1,229,0,5,186,1,0,6,0,0,0,0,187,230,0,11
325,R,115,H R 3281,12-Jul-2018,5:23 PM,On Passage,Reclamation Title Transfer and Non-Federal Infrastructure Incentivization Act,Passed,224,6,0,5,9,178,0,6,0,0,0,0,233,184,0,11
326,R,115,H R 6237,12-Jul-2018,5:30 PM,On Passage,Matthew Young Pollard Intelligence Authorization Act for Fiscal Years 2018 and 2019,Passed,222,8,0,5,141,46,0,6,0,0,0,0,363,54,0,11
327,R,115,H R 50,13-Jul-2018,10:52 AM,On Motion to Recommit with Instructions,Unfunded Mandates Information and Transparency Act,Failed,1,219,0,15,179,0,0,14,0,0,0,0,180,219,0,29
328,R,115,H R 50,13-Jul-2018,10:59 AM,On Passage,Unfunded Mandates Information and Transparency Act,Passed,220,0,0,15,10,168,0,15,0,0,0,0,230,168,0,30
329,R,115,H R 4946,16-Jul-2018,6:56 PM,On Motion to Suspend the Rules and Pass,"To designate the facility of the United States Postal Service located at 1075 North Tustin Street in Orange, California, as the “Specialist Trevor A. Win’E Post Office",Passed,211,0,0,24,157,0,0,36,0,0,0,0,368,0,0,60
330,R,115,H R 4960,16-Jul-2018,7:04 PM,On Motion to Suspend the Rules and Pass,"To designate the facility of the United States Postal Service located at 511 East Walnut Street in Columbia, Missouri, as the “Spc. Sterling William Wyatt Post Office Building”.",Passed,212,0,0,23,156,0,0,37,0,0,0,0,368,0,0,60
331,R,115,H RES 996,17-Jul-2018,1:36 PM,On Ordering the Previous Question,"Providing for consideration of the bill (H.R. 6147) making appropriations for the Department of the Interior, environment, and related agencies for the fiscal year ending September 30, 2019, and for other purposes",Passed,230,0,0,5,0,183,0,10,0,0,0,0,230,183,0,15
332,R,115,H RES 996,17-Jul-2018,1:44 PM,On Agreeing to the Resolution,"Providing for consideration of the bill (H.R. 6147) making appropriations for the Department of the Interior, environment, and related agencies for the fiscal year ending September 30, 2019, and for other purposes",Passed,229,3,0,3,0,181,0,12,0,0,0,0,229,184,0,15
333,R,115,S 488,17-Jul-2018,6:41 PM,"On Motion to Suspend the Rules and Pass, as Amended",JOBS and Investor Confidence Act of 2018,Passed,227,2,0,6,179,2,0,12,0,0,0,0,406,4,0,18
334,R,115,H R 3030,17-Jul-2018,6:48 PM,"On Motion to Suspend the Rules and Pass, as Amended",Elie Wiesel Genocide and Atrocities Prevention Act of 2018,Passed,224,5,0,6,182,0,0,11,0,0,0,0,406,5,0,17
335,R,115,H R 4989,17-Jul-2018,6:56 PM,On Motion to Suspend the Rules and Pass,Protecting Diplomats from Surveillance Through Consumer Devices Act,Passed,227,0,0,8,185,0,0,8,0,0,0,0,412,0,0,16
336,R,115,H R 2,18-Jul-2018,3:20 PM,On Motion to Instruct Conferees,Agriculture and Nutrition Act of 2018,Passed,207,20,0,8,185,0,0,8,0,0,0,0,392,20,0,16
337,R,115,H RES 990,18-Jul-2018,3:29 PM,"On Motion to Suspend the Rules and Agree, as Amended",Supporting the officers and personnel who carry out the important mission of the United States Immigration and Customs Enforcement,Passed,226,1,0,8,18,34,133,8,0,0,0,0,244,35,133,16
338,R,115,H R 1037,18-Jul-2018,3:37 PM,"On Motion to Suspend the Rules and Pass, as Amended","To authorize the National Emergency Medical Services Memorial Foundation to establish a commemorative work in the District of Columbia and its environs, and for other purposes",Passed,228,0,0,7,186,0,0,7,0,0,0,0,414,0,0,14
339,R,115,H RES 1001,18-Jul-2018,3:43 PM,On Ordering the Previous Question,"Providing for consideration of H.Con.Res. 119, expressing the sense of Congress that a carbon tax would be detrimental to the United States economy",Passed,226,0,0,9,0,186,0,7,0,0,0,0,226,186,0,16
340,R,115,H RES 1001,18-Jul-2018,3:50 PM,On Agreeing to the Resolution,"Providing for consideration of H.Con.Res. 119, expressing the sense of Congress that a carbon tax would be detrimental to the United States economy",Passed,226,0,0,9,3,183,0,7,0,0,0,0,229,183,0,16
341,R,115,H R 6147,18-Jul-2018,3:56 PM,On Agreeing to the Amendment,None,Failed,172,52,1,10,0,185,0,8,0,0,0,0,172,237,1,18
342,R,115,H R 6147,18-Jul-2018,4:01 PM,On Agreeing to the Amendment,None,Failed,5,222,0,8,185,1,0,7,0,0,0,0,190,223,0,15
343,R,115,H R 6147,18-Jul-2018,4:05 PM,On Agreeing to the Amendment,None,Agreed to,31,196,0,8,186,0,0,7,0,0,0,0,217,196,0,15
344,R,115,H R 6147,18-Jul-2018,4:10 PM,On Agreeing to the Amendment,None,Failed,8,218,0,9,186,0,0,7,0,0,0,0,194,218,0,16
345,R,115,H R 6147,18-Jul-2018,4:15 PM,On Agreeing to the Amendment,None,Failed,113,112,0,10,1,185,0,7,0,0,0,0,114,297,0,17
346,R,115,H R 6147,18-Jul-2018,10:03 PM,On Agreeing to the Amendment,None,Agreed to,213,16,0,6,2,178,0,13,0,0,0,0,215,194,0,19
347,R,115,H R 6147,18-Jul-2018,10:07 PM,On Agreeing to the Amendment,None,Agreed to,213,16,0,6,2,183,0,8,0,0,0,0,215,199,0,14
348,R,115,H R 6147,18-Jul-2018,10:10 PM,On Agreeing to the Amendment,None,Agreed to,223,7,0,5,4,178,0,11,0,0,0,0,227,185,0,16
349,R,115,H R 6147,18-Jul-2018,10:13 PM,On Agreeing to the Amendment,None,Agreed to,213,17,0,5,0,185,0,8,0,0,0,0,213,202,0,13
350,R,115,H R 6147,18-Jul-2018,10:16 PM,On Agreeing to the Amendment,None,Agreed to,210,19,0,6,3,182,0,8,0,0,0,0,213,201,0,14
351,R,115,H R 6147,18-Jul-2018,10:19 PM,On Agreeing to the Amendment,None,Agreed to,211,19,0,5,2,183,0,8,0,0,0,0,213,202,0,13
352,R,115,H R 6147,18-Jul-2018,10:22 PM,On Agreeing to the Amendment,None,Failed,19,211,0,5,184,1,0,8,0,0,0,0,203,212,0,13
353,R,115,H R 6147,18-Jul-2018,10:25 PM,On Agreeing to the Amendment,None,Failed,206,24,0,5,0,185,0,8,0,0,0,0,206,209,0,13
354,R,115,H R 6147,18-Jul-2018,10:27 PM,On Agreeing to the Amendment,None,Agreed to,215,15,0,5,1,184,0,8,0,0,0,0,216,199,0,13
355,R,115,H R 6147,18-Jul-2018,10:31 PM,On Agreeing to the Amendment,None,Failed,193,35,0,7,0,185,0,8,0,0,0,0,193,220,0,15
356,R,115,H R 6147,18-Jul-2018,10:33 PM,On Agreeing to the Amendment,None,Failed,173,57,0,5,1,183,0,9,0,0,0,0,174,240,0,14
357,R,115,H R 6147,18-Jul-2018,10:36 PM,On Agreeing to the Amendment,None,Agreed to,215,14,0,6,0,185,0,8,0,0,0,0,215,199,0,14
358,R,115,H R 6147,18-Jul-2018,10:39 PM,On Agreeing to the Amendment,None,Failed,6,223,0,6,184,1,0,8,0,0,0,0,190,224,0,14
359,R,115,H R 6147,18-Jul-2018,10:43 PM,On Agreeing to the Amendment,None,Agreed to,226,4,0,5,0,185,0,8,0,0,0,0,226,189,0,13
360,R,115,H R 6147,18-Jul-2018,10:46 PM,On Agreeing to the Amendment,None,Agreed to,222,8,0,5,1,184,0,8,0,0,0,0,223,192,0,13
361,R,115,H R 6147,18-Jul-2018,10:48 PM,On Agreeing to the Amendment,None,Agreed to,230,0,0,5,1,184,0,8,0,0,0,0,231,184,0,13
362,R,115,H R 6147,18-Jul-2018,10:52 PM,On Agreeing to the Amendment,None,Failed,201,28,0,6,0,184,0,9,0,0,0,0,201,212,0,15
363,R,115,H CON RES 119,19-Jul-2018,10:37 AM,On Agreeing to the Resolution,Expressing the sense of Congress that a carbon tax would be detrimental to the United States economy,Passed,222,6,1,6,7,174,1,11,0,0,0,0,229,180,2,17
364,R,115,H R 6147,19-Jul-2018,10:55 AM,On Motion to Recommit with Instructions,"Making appropriations for the Department of the Interior, environment, and related agencies for the fiscal year ending September 30, 2019, and for other purposes",Failed,0,232,0,3,182,0,0,11,0,0,0,0,182,232,0,14
365,R,115,H R 6147,19-Jul-2018,11:03 AM,On Passage,"Making appropriations for the Department of the Interior, environment, and related agencies for the fiscal year ending September 30, 2019, and for other purposes",Passed,217,15,0,3,0,184,0,9,0,0,0,0,217,199,0,12
366,R,115,H R 2345,23-Jul-2018,6:53 PM,"On Motion to Suspend the Rules and Pass, as Amended",National Suicide Hotline Improvement Act,Passed,211,1,0,23,168,0,0,25,0,0,0,0,379,1,0,48
367,R,115,H R 4881,23-Jul-2018,7:01 PM,"On Motion to Suspend the Rules and Pass, as Amended",Precision Agriculture Connectivity Act,Passed,210,4,0,21,168,0,0,25,0,0,0,0,378,4,0,46
368,R,115,H RES 1012,24-Jul-2018,2:12 PM,On Ordering the Previous Question,"Providing for consideration of H.R. 6199, the Restoring Access to Medication and Modernizing Health Savings Accounts Act of 2018; providing for proceedings during the period from July 27, 2018, through September 3, 2018",Passed,224,0,0,11,0,184,0,9,0,0,0,0,224,184,0,20
369,R,115,H RES 1012,24-Jul-2018,2:20 PM,On Agreeing to the Resolution,"Providing for consideration of H.R. 6199, the Restoring Access to Medication and Modernizing Health Savings Accounts Act of 2018; providing for proceedings during the period from July 27, 2018, through September 3, 2018",Passed,223,0,0,12,6,179,0,8,0,0,0,0,229,179,0,20
370,R,115,H RES 1011,24-Jul-2018,2:29 PM,On Ordering the Previous Question,"Providing for consideration for H.R. 184, the Protect Medical Innovation Act of 2017; and H.R. 6311, the Increasing Access to Lower Premium Plans and Expanding Health Savings Accounts Act of 2018",Passed,223,1,0,11,0,187,0,6,0,0,0,0,223,188,0,17
371,R,115,H RES 1011,24-Jul-2018,2:36 PM,On Agreeing to the Resolution,"Providing for consideration for H.R. 184, the Protect Medical Innovation Act of 2017; and H.R. 6311, the Increasing Access to Lower Premium Plans and Expanding Health Savings Accounts Act of 2018",Passed,223,0,0,12,2,184,0,7,0,0,0,0,225,184,0,19
372,R,115,H R 184,24-Jul-2018,5:15 PM,On Passage,Protect Medical Innovation Act,Passed,226,1,0,8,57,131,0,5,0,0,0,0,283,132,0,13
373,R,115,S 1182,25-Jul-2018,2:11 PM,"On Motion to Suspend the Rules and Pass, as Amended",The American Legion 100th Anniversary Commemorative Coin Act,Passed,179,51,0,5,187,1,0,5,0,0,0,0,366,52,0,10
374,R,115,H R 5864,25-Jul-2018,2:20 PM,"On Motion to Suspend the Rules and Pass, as Amended",VA Hospitals Establishing Leadership Performance Act,Passed,229,0,0,6,188,0,0,5,0,0,0,0,417,0,0,11
375,R,115,H R 6311,25-Jul-2018,6:07 PM,On Motion to Recommit with Instructions,Increasing Access to Lower Premium Plans and Expanding Health Savings Accounts Act of 2018,Failed,2,227,0,6,185,2,0,6,0,0,0,0,187,229,0,12
376,R,115,H R 6311,25-Jul-2018,6:13 PM,On Passage,Increasing Access to Lower Premium Plans and Expanding Health Savings Accounts Act of 2018,Passed,230,1,0,4,12,175,0,6,0,0,0,0,242,176,0,10
377,R,115,H R 6199,25-Jul-2018,6:20 PM,On Passage,Restoring Access to Medication Act,Passed,231,1,0,3,46,141,0,6,0,0,0,0,277,142,0,9
378,R,115,H RES 1027,26-Jul-2018,10:25 AM,On Ordering the Previous Question,"Providing for consideration of the conference report to accompany H.R. 5515, to authorize appropriations for fiscal year 2019 for military activities of the Department of Defense, military construction, and for defense activities of the Department of Energy, to prescribe military personnel strengths for the fiscal year",Passed,224,0,0,11,2,183,0,8,0,0,0,0,226,183,0,19
379,R,115,H R 5515,26-Jul-2018,12:10 PM,On Agreeing to the Conference Report,National Defense Authorization Act FY 2019,Passed,220,5,0,10,139,49,0,5,0,0,0,0,359,54,0,15
380,R,115,H R 6157,4-Sep-2018,6:53 PM,On Motion to Instruct Conferees,"Making appropriations for the Department of Defense for the fiscal year ending September 30, 2019, and for other purposes",Failed,0,221,0,14,171,0,0,22,0,0,0,0,171,221,0,36
381,R,115,H R 6439,4-Sep-2018,7:01 PM,On Motion to Suspend the Rules and Pass,Biometric Identification Transnational Migration Alert Program Authorization Act,Passed,213,8,0,14,59,111,0,23,0,0,0,0,272,119,0,37
382,R,115,H RES 1049,5-Sep-2018,1:29 PM,On Ordering the Previous Question,Providing for consideration of the bill (H.R. 1635) Empowering Students Through Enhanced Financial Counseling Act and providing for consideration of the bill (H.R. 4606) Ensuring Small Scale LNG Certainty and Access Act,Passed,221,0,0,14,0,186,0,7,0,0,0,0,221,186,0,21
383,R,115,H RES 1049,5-Sep-2018,1:36 PM,On Agreeing to the Resolution,Providing for consideration of the bill (H.R. 1635) Empowering Students Through Enhanced Financial Counseling Act and providing for consideration of the bill (H.R. 4606) Ensuring Small Scale LNG Certainty and Access Act,Passed,222,0,0,13,2,180,0,11,0,0,0,0,224,180,0,24
384,R,115,H R 1635,5-Sep-2018,5:31 PM,On Motion to Recommit with Instructions,Empowering Students Through Enhanced Financial Counseling Act,Failed,2,224,0,9,185,0,0,8,0,0,0,0,187,224,0,17
385,R,115,H R 1635,5-Sep-2018,5:51 PM,On Passage,Empowering Students Through Enhanced Financial Counseling Act,Passed,222,4,0,10,184,0,0,9,0,0,0,0,406,4,0,19
386,R,115,H RES 1051,6-Sep-2018,1:26 PM,On Ordering the Previous Question,"Providing for consideration of the bill (H.R. 6691) to amend title 18, United States Code, to clarify the definition of “crime of violence”, and for other purposes, and providing for consideration of motions to suspend the rules",Passed,224,0,0,12,0,181,0,12,0,0,0,0,224,181,0,24
387,R,115,H RES 1051,6-Sep-2018,1:34 PM,On Agreeing to the Resolution,"Providing for consideration of the bill (H.R. 6691) to amend title 18, United States Code, to clarify the definition of “crime of violence”, and for other purposes, and providing for consideration of motions to suspend the rules",Passed,223,2,0,11,2,177,0,14,0,0,0,0,225,179,0,25
388,R,115,H R 6147,6-Sep-2018,3:28 PM,On Motion to Instruct Conferees,"Making appropriations for the Department of the Interior, environment, and related agencies for the fiscal year ending September 30, 2019, and for other purposes",Failed,5,218,0,13,182,0,0,11,0,0,0,0,187,218,0,24
389,R,115,H R 4606,6-Sep-2018,3:35 PM,On Agreeing to the Amendment,None,Failed,1,222,0,13,175,5,0,13,0,0,0,0,176,227,0,26
390,R,115,H R 4606,6-Sep-2018,3:41 PM,On Agreeing to the Amendment,None,Failed,14,209,0,13,181,1,0,11,0,0,0,0,195,210,0,24
391,R,115,H R 4606,6-Sep-2018,3:58 PM,On Motion to Recommit with Instructions,Ensuring Small Scale LNG Certainty and Access Act,Failed,1,226,0,9,177,5,0,11,0,0,0,0,178,231,0,20
392,R,115,H R 4606,6-Sep-2018,4:09 PM,On Passage,Ensuring Small Scale LNG Certainty and Access Act,Passed,223,3,0,10,37,143,0,13,0,0,0,0,260,146,0,23
393,R,115,H R 6691,7-Sep-2018,10:49 AM,On Passage,Community Safety and Security Act,Passed,218,4,0,14,29,148,2,14,0,0,0,0,247,152,2,28
394,R,115,H R 5923,12-Sep-2018,6:56 PM,"On Motion to Suspend the Rules and Pass, as Amended",Walnut Grove Land Exchange Act,Passed,208,3,0,24,171,0,0,22,0,0,0,0,379,3,0,46
395,R,115,H R 3186,12-Sep-2018,7:09 PM,"On Motion to Suspend the Rules and Pass, as Amended",Every Kid Outdoors Act,Passed,211,2,0,22,172,0,0,21,0,0,0,0,383,2,0,43
396,R,115,H R 4689,12-Sep-2018,7:19 PM,On Motion to Suspend the Rules and Pass,To authorize early repayment of obligations to the Bureau of Reclamation within the Northport Irrigation District in the State of Nebraska,Passed,209,1,0,25,169,0,0,24,0,0,0,0,378,1,0,49
397,R,115,H RES 1059,13-Sep-2018,1:00 PM,On Agreeing to the Resolution,"Providing for consideration of H.R. 3798, the Save American Workers Act of 2017; and the conference report to accompany H.R. 5895, making appropriations for energy and water development and related agencies for the fiscal year ending September 30, 2019, and for other purposes; and for other purposes",Passed,218,0,0,17,4,171,0,18,0,0,0,0,222,171,0,35
398,R,115,H R 1911,13-Sep-2018,1:08 PM,"On Motion to Suspend the Rules and Pass, as Amended",Special Envoy to Monitor and Combat Anti-Semitism Act,Passed,218,1,0,16,175,1,0,17,0,0,0,0,393,2,0,33
399,R,115,H R 5895,13-Sep-2018,3:57 PM,On Agreeing to the Conference Report,"Making appropriations for energy and water development and related agencies for the fiscal year ending September 30, 2019, and for other purposes",Passed,202,18,0,15,175,2,0,16,0,0,0,0,377,20,0,31
400,R,115,H R 6368,25-Sep-2018,6:59 PM,On Motion to Suspend the Rules and Pass,Encouraging Small Business Innovators,Passed,214,6,0,15,175,0,0,18,0,0,0,0,389,6,0,33
401,R,115,H R 6369,25-Sep-2018,7:11 PM,"On Motion to Suspend the Rules and Pass, as Amended",Expanding Contracting Opportunities for Small Business Act of 2018,Passed,216,5,0,14,176,0,0,17,0,0,0,0,392,5,0,31
402,R,115,H RES 1077,26-Sep-2018,1:41 PM,On Ordering the Previous Question,"Providing for consideration for the conference report to accompany H.R. 6157, making appropriations for the Department of Defense for FY ending September 30, 2019; and H.Res. 1071, recognizing allowing illegal immigrants the right to vote devalues the franchise and diminishes the voting power of U.S. citizens",Passed,230,0,0,5,0,188,0,5,0,0,0,0,230,188,0,10
403,R,115,H RES 1077,26-Sep-2018,1:49 PM,On Agreeing to the Resolution,"Providing for consideration for the conference report to accompany H.R. 6157, making appropriations for the Department of Defense for FY ending September 30, 2019; and H.Res. 1071, recognizing allowing illegal immigrants the right to vote devalues the franchise and diminishes the voting power of U.S. citizens",Passed,223,8,0,4,7,180,0,6,0,0,0,0,230,188,0,10
404,R,115,H R 5420,26-Sep-2018,1:56 PM,"On Motion to Suspend the Rules and Pass, as Amended",FDR Historic Preservation Act,Passed,216,15,0,4,178,0,0,15,0,0,0,0,394,15,0,19
405,R,115,H R 6157,26-Sep-2018,5:26 PM,On Agreeing to the Conference Report,"Making appropriations for the Department of Defense for the fiscal year ending September 30, 2019, and for other purposes",Passed,176,56,0,3,185,5,0,3,0,0,0,0,361,61,0,6
406,R,115,H RES 1071,26-Sep-2018,5:34 PM,On Agreeing to the Resolution,Recognizing that allowing illegal immigrants the right to vote devalues the franchise and diminishes the voting power of the United States citizens,Passed,230,1,0,4,49,71,69,4,0,0,0,0,279,72,69,8
407,R,115,H RES 1082,26-Sep-2018,5:41 PM,On Motion to Suspend the Rules and Agree,FAA Reauthorization Act of 2018,Passed,211,20,0,4,187,3,0,3,0,0,0,0,398,23,0,7
408,R,115,H R 6729,26-Sep-2018,5:50 PM,On Motion to Suspend the Rules and Pass,Empowering Financial Institutions to Fight Human Trafficking Act,Passed,202,29,0,4,95,95,0,3,0,0,0,0,297,124,0,7
409,R,115,H RES 1084,27-Sep-2018,1:52 PM,On Ordering the Previous Question,"Providing for consideration of the bill (H.R 6756), the American Innovation Act; consideration of the bill (H.R. 6757), the Family Savings Act; consideration of the bill (H.R. 6760), the Protecting Family and Small Business Tax Cuts Act; providing for proceedings during the period from October 1 through November 12",Passed,227,0,0,8,0,189,0,4,0,0,0,0,227,189,0,12
410,R,115,H RES 1084,27-Sep-2018,2:01 PM,On Agreeing to the Resolution,"Providing for consideration of the bill (H.R 6756), the American Innovation Act; consideration of the bill (H.R. 6757), the Family Savings Act; consideration of the bill (H.R. 6760), the Protecting Family and Small Business Tax Cuts Act; providing for proceedings during the period from October 1 through November 12",Passed,226,1,0,8,0,188,0,5,0,0,0,0,226,189,0,13
411,R,115,H R 6757,27-Sep-2018,4:10 PM,On Passage,Family Savings Act of 2018,Passed,230,0,0,5,10,177,0,6,0,0,0,0,240,177,0,11
412,R,115,H R 6756,27-Sep-2018,4:19 PM,On Passage,American Innovation Act of 2018,Passed,229,0,0,6,31,156,0,6,0,0,0,0,260,156,0,12
413,R,115,H R 6760,28-Sep-2018,11:57 AM,On Motion to Recommit with Instructions,Protecting Family and Small Business Tax Cuts Act of 2018,Failed,0,226,0,9,184,0,0,9,0,0,0,0,184,226,0,18
414,R,115,H R 6760,28-Sep-2018,12:06 PM,On Passage,Protecting Family and Small Business Tax Cuts Act of 2018,Passed,217,10,0,9,3,181,0,9,0,0,0,0,220,191,0,18
415,R,115,H RES 1099,28-Sep-2018,12:22 PM,On Motion to Suspend the Rules and Agree,"Providing for the concurrence by the House in the Senate amendment to H.R. 6, with an amendment",Passed,215,8,0,12,178,0,0,15,0,0,0,0,393,8,0,27
416,R,115,H R 6064,13-Nov-2018,6:57 PM,On Motion to Suspend the Rules and Pass,To rename the Oyster Bay National Wildlife Refuge as the Congressman Lester Wolff National Wildlife Refuge,Passed,209,4,2,19,176,0,0,17,0,0,0,0,385,4,2,36
417,R,115,H R 2615,13-Nov-2018,7:24 PM,On Motion to Suspend the Rules and Concur in the Senate Amendment,Gulf Islands National Seashore Land Exchange Act,Passed,206,1,0,28,169,0,0,26,0,0,0,0,375,1,0,54
418,R,115,H RES 1142,14-Nov-2018,5:07 PM,On Agreeing to the Resolution,"Providing for consideration of H.R. 6784, the Manage our Wolves Act; and providing for proceedings during the period from November 19, 2018, through November 26, 2018",Passed,195,15,0,25,6,172,0,17,0,0,0,0,201,187,0,42
419,R,115,H R 5787,16-Nov-2018,10:49 AM,"On Motion to Suspend the Rules and Pass, as Amended",Strengthening Coastal Communities Act,Passed,198,1,0,36,177,0,0,18,0,0,0,0,375,1,0,54
420,R,115,H R 6784,16-Nov-2018,11:06 AM,On Passage,Manage our Wolves Act,Passed,187,12,0,36,9,168,0,18,0,0,0,0,196,180,0,54
421,R,115,H R 5273,27-Nov-2018,7:08 PM,"On Motion to Suspend the Rules and Pass, as Amended",Global Fragility and Violence Reduction Act of 2018,Passed,193,16,0,26,183,0,0,12,0,0,0,0,376,16,0,38
422,R,115,H R 6207,27-Nov-2018,7:31 PM,"On Motion to Suspend the Rules and Pass, as Amended",Democratic Republic of the Congo Democracy and Accountability Act of 2018,Passed,194,11,0,30,180,0,0,16,0,0,0,0,374,11,0,46
423,R,115,H RES 1160,29-Nov-2018,6:54 PM,On Agreeing to the Resolution,"Providing for consideration of the Senate amendment to the bill (H.R. 88) to modify the boundary of the Shiloh National Military Park located in Tennessee and Mississippi, to establish Parker’s Crossroads Battlefield as an affiliated area of the National Park System, and for other purposes",Passed,219,1,0,15,0,180,0,17,0,0,0,0,219,181,0,32
424,R,115,H R 7187,29-Nov-2018,7:04 PM,On Motion to Suspend the Rules and Pass,National Flood Insurance Program Further Extension Act,Passed,172,46,0,17,178,0,0,19,0,0,0,0,350,46,0,36
425,R,115,H R 6901,30-Nov-2018,10:26 AM,"On Motion to Suspend the Rules and Pass, as Amended",Federal CIO Authorization Act of 2018,Passed,212,0,0,23,179,0,0,18,0,0,0,0,391,0,0,41
426,R,115,H RES 792,10-Dec-2018,6:53 PM,"On Motion to Suspend the Rules and Agree, as Amended","Urging the Secretary of the Interior to recognize the historical significance of Roberto Clemente’s place of death near Pinones in Loiza, Puerto Rico, by adding it to the National Register of Historic Places",Passed,209,1,2,23,176,0,0,21,0,0,0,0,385,1,2,44
427,R,115,H R 3008,10-Dec-2018,7:02 PM,On Motion to Suspend the Rules and Pass,George W. Bush Childhood Home Study Act,Passed,206,4,2,23,176,0,0,21,0,0,0,0,382,4,2,44
428,R,115,H R 7217,11-Dec-2018,4:46 PM,On Motion to Suspend the Rules and Pass,Improving Medicaid Programs and Opportunities for Eligible Beneficiaries Act,Passed,212,11,0,12,188,0,0,9,0,0,0,0,400,11,0,21
429,R,115,S 3029,11-Dec-2018,4:57 PM,On Motion to Suspend the Rules and Pass,PREEMIE Reauthorization Act,Passed,218,3,0,14,188,0,0,9,0,0,0,0,406,3,0,23
430,R,115,S 825,11-Dec-2018,5:06 PM,On Motion to Suspend the Rules and Pass,Southeast Alaska Regional Health Consortium Land Transfer Act of 2017,Passed,216,3,0,16,187,0,0,10,0,0,0,0,403,3,0,26
431,R,115,H RES 1176,12-Dec-2018,2:00 PM,On Ordering the Previous Question,"Providing for consideration of the conference report to accompany H.R. 2, the Agriculture and Nutrition Act of 2018, and for other purposes",Passed,220,0,0,15,0,191,0,6,0,0,0,0,220,191,0,21
432,R,115,H RES 1176,12-Dec-2018,2:08 PM,On Agreeing to the Resolution,"Providing for consideration of the conference report to accompany H.R. 2, the Agriculture and Nutrition Act of 2018, and for other purposes",Passed,201,18,0,17,5,185,0,7,0,0,0,0,206,203,0,24
433,R,115,JOURNAL,12-Dec-2018,2:16 PM,On Approving the Journal,None,Passed,138,77,1,19,88,92,3,14,0,0,0,0,226,169,4,33
434,R,115,H R 2,12-Dec-2018,4:13 PM,On Agreeing to the Conference Report,Agriculture and Nutrition Act of 2018,Passed,182,44,0,9,187,3,0,7,0,0,0,0,369,47,0,16
435,R,115,H RES 1091,13-Dec-2018,11:11 AM,"On Motion to Suspend the Rules and Agree, as Amended","Calling on the Government of Burma to release Burmese journalists Wa Lone and Kyaw Soe Oo sentenced to seven years imprisonment after investigating attacks against civilians by Burma’s military and security forces, and for other purposes",Passed,211,1,0,23,183,0,0,14,0,0,0,0,394,1,0,37
436,R,115,H R 1222,19-Dec-2018,6:57 PM,On Motion to Suspend the Rules and Concur in the Senate Amendment,Congenital Heart Futures Reauthorization Act of 2017,Passed,188,7,0,40,167,0,0,30,0,0,0,0,355,7,0,70
437,R,115,H R 6615,19-Dec-2018,7:05 PM,On Motion to Suspend the Rules and Concur in the Senate Amendment,Traumatic Brain Injury Program Reauthorization Act,Passed,185,6,0,44,167,0,0,30,0,0,0,0,352,6,0,74
438,R,115,S 2076,19-Dec-2018,7:11 PM,On Motion to Suspend the Rules and Pass,BOLD Infrastructure for Alzheimer’s Act,Passed,195,3,0,37,166,0,0,31,0,0,0,0,361,3,0,68
439,R,115,S 2278,19-Dec-2018,7:18 PM,On Motion to Suspend the Rules and Pass,State Offices of Rural Health Reauthorization Act,Passed,191,4,0,40,166,0,0,31,0,0,0,0,357,4,0,71
440,R,115,H R 7327,19-Dec-2018,7:25 PM,On Motion to Suspend the Rules and Pass,SECURE Technology Act,Passed,198,1,0,36,164,0,0,33,0,0,0,0,362,1,0,69
441,R,115,H R 7279,19-Dec-2018,7:31 PM,On Motion to Suspend the Rules and Pass,Water Infrastructure Improvement Act,Passed,186,10,0,39,165,0,0,32,0,0,0,0,351,10,0,71
442,R,115,H R 6227,19-Dec-2018,7:38 PM,On Motion to Suspend the Rules and Concur in the Senate Amendment,National Quantum Initiative Act,Passed,185,11,0,39,163,0,0,34,0,0,0,0,348,11,0,73
443,R,115,H R 6652,19-Dec-2018,7:44 PM,"On Motion to Suspend the Rules and Pass, as Amended","To direct the Secretary of the Interior to convey certain facilities, easements, and rights-of-way to the Kennewick Irrigation District, and for other purposes",Passed,197,1,0,37,162,0,0,35,0,0,0,0,359,1,0,72
444,R,115,S 1520,19-Dec-2018,7:50 PM,On Motion to Suspend the Rules and Pass,Modernizing Recreational Fisheries Management Act,Passed,189,10,0,36,161,1,0,35,0,0,0,0,350,11,0,71
445,R,115,S 3530,19-Dec-2018,7:57 PM,On Motion to Suspend the Rules and Pass,Museum and Library Services Act,Passed,170,28,0,37,161,0,0,36,0,0,0,0,331,28,0,73
446,R,115,H RES 1180,20-Dec-2018,10:41 AM,On Agreeing to the Resolution,"Providing for consideration of the Senate amendment to the bill (H.R. 88); and providing for proceedings during the period from December 24, 2018, through January 3, 2019",Passed,207,0,0,28,0,170,0,27,0,0,0,0,207,170,0,55
447,R,115,H RES 1181,20-Dec-2018,10:52 AM,On Agreeing to the Resolution,"Waiving a requirement of clause 6(a) of rule XIII with respect to consideration of certain resolutions reported from the Committee on Rules, and providing for consideration of motions to suspend the rules",Passed,185,24,0,26,165,6,0,26,0,0,0,0,350,30,0,52
448,R,115,S 756,20-Dec-2018,1:58 PM,On Motion to Suspend the Rules and Concur in the Senate Amendment to House Amendment,First Step Act of 2018,Passed,182,36,0,17,176,0,0,21,0,0,0,0,358,36,0,38
449,R,115,H R 7328,20-Dec-2018,2:02 PM,On Motion to Suspend the Rules and Pass,Pandemic and All-Hazards Preparedness and Advancing Innovation Act of 2018,Passed,201,9,0,25,166,0,0,31,0,0,0,0,367,9,0,56
450,R,115,H R 5075,20-Dec-2018,2:05 PM,On Motion to Suspend the Rules and Concur in the Senate Amendment,Ashanti Alert Act of 2018,Passed,211,2,0,22,175,0,0,22,0,0,0,0,386,2,0,44
451,R,115,H R 7093,20-Dec-2018,2:08 PM,On Motion to Suspend the Rules and Pass,Clean Up the Code Act of 2018,Passed,215,0,0,20,171,5,0,21,0,0,0,0,386,5,0,41
452,R,115,S 2896,20-Dec-2018,2:11 PM,On Motion to Suspend the Rules and Pass,Justice Against Corruption on K Street Act,Passed,216,0,0,19,175,0,0,22,0,0,0,0,391,0,0,41
453,R,115,S 2961,20-Dec-2018,2:14 PM,On Motion to Suspend the Rules and Pass,Victims of Child Abuse Act Reauthorization Act,Passed,213,2,0,20,175,0,0,22,0,0,0,0,388,2,0,42
454,R,115,S 2679,20-Dec-2018,2:17 PM,On Motion to Suspend the Rules and Pass,Veterans Small Business Enhancement Act,Passed,213,1,0,21,176,0,0,21,0,0,0,0,389,1,0,42
455,R,115,H R 7227,20-Dec-2018,2:20 PM,"On Motion to Suspend the Rules and Pass, as Amended",Taxpayer First Act,Passed,203,11,0,21,175,0,0,22,0,0,0,0,378,11,0,43
456,R,115,H R 4227,20-Dec-2018,2:23 PM,On Motion to Suspend the Rules and Concur in the Senate Amendments,Vehicular Terrorism Prevention Act of 2018,Passed,211,2,0,22,177,0,0,20,0,0,0,0,388,2,0,42
457,R,115,S 2652,20-Dec-2018,2:26 PM,On Motion to Suspend the Rules and Pass,Stephen Michael Gleason Congressional Gold Medal Act,Passed,212,2,0,21,178,0,0,19,0,0,0,0,390,2,0,40
458,R,115,S 2765,20-Dec-2018,2:30 PM,On Motion to Suspend the Rules and Pass,RBIC Advisers Relief Act,Passed,213,0,0,22,176,0,0,21,0,0,0,0,389,0,0,43
459,R,115,H R 5509,20-Dec-2018,2:34 PM,On Motion to Suspend the Rules and Concur in the Senate Amendment,"Innovations in Mentoring, Training, and Apprenticeships",Passed,200,13,0,22,178,0,0,19,0,0,0,0,378,13,0,41
460,R,115,S 7,20-Dec-2018,2:37 PM,On Motion to Suspend the Rules and Pass,NASA Enhanced Use Leasing Extension Act,Passed,212,0,0,23,178,0,0,19,0,0,0,0,390,0,0,42
461,R,115,S 2200,20-Dec-2018,2:40 PM,On Motion to Suspend the Rules and Pass,National Integrated Drought Information System Reauthorization Act,Passed,204,9,0,22,175,0,0,22,0,0,0,0,379,9,0,44
462,R,115,H R 767,20-Dec-2018,2:43 PM,On Motion to Suspend the Rules and Concur in the Senate Amendment,"Stop, Observe, Ask, and Respond to Health and Wellness Act",Passed,208,6,0,21,178,0,0,19,0,0,0,0,386,6,0,40
463,R,115,S 2322,20-Dec-2018,2:48 PM,On Motion to Suspend the Rules and Pass,Codifying Useful Regulatory Definitions Act,Failed,194,20,0,21,36,142,0,19,0,0,0,0,230,162,0,40
464,R,115,H R 6418,20-Dec-2018,2:51 PM,"On Motion to Suspend the Rules and Pass, as Amended",VA Website Accessibility Act,Passed,210,0,0,25,177,0,0,20,0,0,0,0,387,0,0,45
465,R,115,S 3444,20-Dec-2018,2:54 PM,On Motion to Suspend the Rules and Pass,Community-based outpatient clinic of the Department of Veterans Affairs as the “Douglas Fournet Department of Veterans Affairs Clinic”,Passed,211,0,0,24,177,0,0,20,0,0,0,0,388,0,0,44
466,R,115,S 3777,20-Dec-2018,2:57 PM,On Motion to Suspend the Rules and Pass,Forever GI Bill Housing Payment Fulfillment Act,Passed,212,0,0,23,177,0,0,20,0,0,0,0,389,0,0,43
467,R,115,MOTION,20-Dec-2018,3:31 PM,On Motion to Table,None,Passed,187,0,0,48,0,170,0,27,0,0,0,0,187,170,0,75
468,R,115,H RES 1183,20-Dec-2018,5:50 PM,On Ordering the Previous Question,"Providing for consideration of the Senate amendment to the House amendment to the Senate amendment to H.R. 695, the Department of Defense Appropriations Act, 2018",Passed,223,0,0,12,0,178,0,19,0,0,0,0,223,178,0,31
469,R,115,H RES 1183,20-Dec-2018,6:00 PM,On Agreeing to the Resolution,"Providing for consideration of the Senate amendment to the House amendment to the Senate amendment to H.R. 695, the Department of Defense Appropriations Act, 2018",Passed,221,0,0,14,0,179,0,18,0,0,0,0,221,179,0,32
470,R,115,H R 88,20-Dec-2018,6:16 PM,On Motion to Concur in the Senate Amendment with an Amendment,Shiloh National Military Park Boundary Adjustment and Parker’s Crossroads Battlefield Designation Act,Passed,220,3,0,12,0,180,0,17,0,0,0,0,220,183,0,29
471,R,115,H R 2606,20-Dec-2018,6:24 PM,On Motion to Suspend the Rules and Concur in the Senate Amendments,Stigler Act Amendments,Passed,220,0,0,15,179,0,0,18,0,0,0,0,399,0,0,33
472,R,115,H R 695,20-Dec-2018,7:56 PM,On Motion to Concur in the Senate Adt to the House Adt to the Senate Adt with Adt,Child Protection Improvements Act of 2017,Passed,217,8,0,11,0,177,0,20,0,0,0,0,217,185,0,31
473,R,115,H R 6602,20-Dec-2018,8:04 PM,On Motion to Suspend the Rules and Pass,"To reauthorize the New Jersey Coastal Heritage Trail Route, and for other purposes",Passed,211,9,0,15,171,0,0,26,0,0,0,0,382,9,0,41
474,R,115,H RES 1063,21-Dec-2018,10:12 AM,On Motion to Suspend the Rules and Agree,Designating room H-226 of the United States Capitol as the “Lincoln Room”,Passed,203,0,0,32,163,0,0,34,0,0,0,0,366,0,0,66
475,R,115,H R 7318,21-Dec-2018,10:17 AM,On Motion to Suspend the Rules and Pass,"To amend the Federal Assets Sale and Transfer Act of 2016 to ensure that the Public Buildings Reform Board has adequate time to carry out the responsibilities of the Board, and for other purposes",Passed,203,1,0,31,169,1,0,27,0,0,0,0,372,2,0,58
476,R,115,H R 7319,21-Dec-2018,10:20 AM,On Motion to Suspend the Rules and Pass,"To amend the Federal Assets Sale and Transfer Act of 2016 to provide flexibility with respect to the leaseback of certain Federal real property, and for other purposes",Passed,204,0,0,31,168,1,0,28,0,0,0,0,372,1,0,59
477,R,115,H R 7329,21-Dec-2018,10:24 AM,On Motion to Suspend the Rules and Pass,"To make technical corrections to provisions of law enacted by the Frank LoBiondo Coast Guard Authorization Act of 2018, and for other purposes",Passed,205,1,0,29,173,1,0,23,0,0,0,0,378,2,0,52
478,R,115,S 3367,21-Dec-2018,10:27 AM,On Motion to Suspend the Rules and Pass,Department of Transportation Reports Harmonization Act,Passed,207,1,0,27,174,1,0,22,0,0,0,0,381,2,0,49
479,R,115,H R 7293,21-Dec-2018,10:32 AM,On Motion to Suspend the Rules and Pass,"To designate the facility of the United States Postal Service located at 770 Ayrault Road in Fairport, New York, as the “Louise and Bob Slaughter Post Office”",Passed,200,6,2,27,175,0,0,22,0,0,0,0,375,6,2,49
480,R,115,S 2276,21-Dec-2018,10:36 AM,On Motion to Suspend the Rules and Pass,GAO-IG Act,Passed,208,2,0,25,174,0,0,23,0,0,0,0,382,2,0,48
481,R,115,S 3031,21-Dec-2018,10:39 AM,On Motion to Suspend the Rules and Pass,Federal Personal Property Management Act,Passed,208,1,0,26,175,0,0,22,0,0,0,0,383,1,0,48
482,R,115,S 3191,21-Dec-2018,10:43 AM,On Motion to Suspend the Rules and Pass,Civil Rights Cold Case Records Collection Act,Passed,203,6,0,26,173,0,0,24,0,0,0,0,376,6,0,50
483,R,115,H CON RES 149,21-Dec-2018,4:09 PM,On Motion to Suspend the Rules and Agree,Directing the Clerk of the House of Representatives to make certain corrections in the enrollment of H.R. 4174,Passed,188,12,0,35,174,0,0,23,0,0,0,0,362,12,0,58
484,R,115,H R 4174,21-Dec-2018,4:14 PM,On Motion to Suspend the Rules and Concur in the Senate Amendment,Foundations for Evidence-Based Policymaking Act,Passed,182,17,0,36,174,0,0,23,0,0,0,0,356,17,0,59
485,R,115,S 3277,21-Dec-2018,4:18 PM,On Motion to Suspend the Rules and Pass,Space Frontier Act of 2019,Failed,194,7,0,34,45,130,0,22,0,0,0,0,239,137,0,56
486,R,115,S 3661,21-Dec-2018,4:21 PM,"On Motion to Suspend the Rules and Pass, as Amended",75th Anniversary of World War II Commemoration Act,Passed,201,0,0,34,169,0,0,28,0,0,0,0,370,0,0,62
487,R,115,H R 2200,21-Dec-2018,4:24 PM,On Motion to Suspend the Rules and Concur in the Senate Amendment,Frederick Douglass Trafficking Victims Prevention and Protection Reauthorization Act,Passed,194,7,0,34,174,0,0,23,0,0,0,0,368,7,0,57
488,R,115,S 1023,21-Dec-2018,4:27 PM,On Motion to Suspend the Rules and Pass,Tropical Forest Conservation Reauthorization Act,Passed,157,43,0,35,175,0,0,22,0,0,0,0,332,43,0,57
489,R,115,S 1158,21-Dec-2018,4:31 PM,On Motion to Suspend the Rules and Pass,Elie Wiesel Genocide and Atrocities Prevention Act,Passed,194,4,0,37,173,0,0,24,0,0,0,0,367,4,0,61
490,R,115,S 1580,21-Dec-2018,4:34 PM,On Motion to Suspend the Rules and Pass,Protecting Girls’ Access to Education in Vulnerable Settings Act,Passed,188,5,0,42,174,0,0,23,0,0,0,0,362,5,0,65
491,R,115,S 1862,21-Dec-2018,4:38 PM,On Motion to Suspend the Rules and Pass,Trafficking Victims Protection Reauthorization Act,Passed,197,0,0,38,173,0,0,24,0,0,0,0,370,0,0,62
492,R,115,S 3247,21-Dec-2018,4:43 PM,On Motion to Suspend the Rules and Pass,Women’s Entrepreneurship and Economic and Empowerment Act,Passed,178,18,0,39,174,0,0,23,0,0,0,0,352,18,0,62
493,R,115,S 512,21-Dec-2018,4:46 PM,On Motion to Suspend the Rules and Pass,Nuclear Energy Innovation and Modernization Act,Passed,192,6,0,37,169,4,0,24,0,0,0,0,361,10,0,61
494,R,115,S 1934,21-Dec-2018,4:50 PM,On Motion to Suspend the Rules and Pass,Alaska Remote Generator Reliability and Protection Act,Failed,195,5,0,35,7,166,0,24,0,0,0,0,202,171,0,59
495,R,115,H R 6287,21-Dec-2018,4:56 PM,On Motion to Suspend the Rules and Concur in the Senate Amendment,9/11 Memorial Act,Passed,198,3,0,34,173,0,0,24,0,0,0,0,371,3,0,58
496,R,115,S 3456,21-Dec-2018,5:00 PM,On Motion to Suspend the Rules and Pass,"To redesignate Hobe Sound National Wildlife Refuge as the Nathaniel P. Reed Hobe Sound National Wildlife Refuge, and for other purposes",Passed,192,5,2,36,173,0,0,24,0,0,0,0,365,5,2,60
497,R,115,H R 7388,21-Dec-2018,5:06 PM,On Motion to Suspend the Rules and Pass,National Flood Insurance Program Competition and Extension Act of 2018,Failed,146,55,0,34,2,171,0,24,0,0,0,0,148,226,0,58
498,R,115,MOTION,21-Dec-2018,5:23 PM,On Motion to Fix the Convening Time,None,Passed,186,12,0,37,1,172,0,24,0,0,0,0,187,184,0,61
499,R,115,H CON RES 148,21-Dec-2018,6:14 PM,On Motion to Suspend the Rules and Agree,Correct Enrollment to S. 3628,Passed,175,25,0,35,169,0,0,28,0,0,0,0,344,25,0,63
500,R,115,S 3628,21-Dec-2018,6:21 PM,On Motion to Suspend the Rules and Pass,National Flood Insurance Program Extention Act,Passed,152,47,0,36,163,1,0,33,0,0,0,0,315,48,0,69
