Roll Call,Majority,Congress Num,Legislation Number,Date,Time,Question,Description,Result,Republican Yes,Republican No,Republican Present,Republican Not Voting,Democrat Yes,Democrat No,Democrat Present,Democrat Not Voting,Independent Yes,Independent No,Independent Present,Independent Not Voting,Total Yes,Total No,Total Present,Total Not Voting
1,D,101,QUORUM 1,23-Jan-1990,12:31 PM,Call of the House,None,Passed,0,0,151,24,0,0,225,30,0,0,0,0,0,0,376,54
2,D,101,MOTION,24-Jan-1990,2:25 PM,On Approving the Journal,None,Passed,78,87,2,8,234,2,1,19,0,0,0,0,312,89,3,27
3,D,101,H R 2712,24-Jan-1990,4:05 PM,REFER BILL AND VETO JOINTLY TO FOREIGN AFFAIRS AND JUD.,WITH INSTRUCTIONS CHINESE ADJUSTMENT OF STATUS FACILITATION ACT,Failed,137,32,0,6,0,244,0,12,0,0,0,0,137,276,0,18
4,D,101,H R 2712,24-Jan-1990,5:24 PM,ON PRESIDENTIAL VETO,CHINESE ADJUSTMENT OF STATUS FACILITATION ACT,Passed,145,25,0,5,245,0,0,11,0,0,0,0,390,25,0,16
5,D,101,MOTION,31-Jan-1990,12:21 PM,On Approving the Journal,None,Passed,75,94,0,6,226,6,1,23,0,0,0,0,301,100,1,29
6,D,101,H RES 309,31-Jan-1990,2:24 PM,On Agreeing to the Resolution,"PROVIDING FOR THE CONSIDERATION OF H.R. 2190, NATIONAL VOTER REGISTRATION ACT OF 1989",Passed,6,166,0,3,248,0,0,8,0,0,0,0,254,166,0,11
7,D,101,H R 2061,6-Feb-1990,2:39 PM,On Motion to Suspend the Rules and Pass,MAGNUSON FISHERIES CONSERVATION AND MANAGEMENT ACT,Passed,151,17,0,7,245,4,0,7,0,0,0,0,396,21,0,14
8,D,101,H CON RES 254,6-Feb-1990,2:50 PM,SUSPEND THE RULES AND AGREE,EXPRESSING THE SENSE OF CONGRESS CONCERNING NEGOTIATIONS FOR A POLITICAL SETTLEMENT IN CAMBODIA,Passed,168,0,0,7,245,0,0,11,0,0,0,0,413,0,0,18
9,D,101,H R 2190,6-Feb-1990,5:28 PM,ON AGREEING TO THE AMENDMENTS,None,Failed,128,41,0,6,1,250,0,5,0,0,0,0,129,291,0,11
10,D,101,H R 2190,6-Feb-1990,5:59 PM,On Motion to Recommit with Instructions,NATIONAL VOTER REGISTRATION ACT OF 1989,Failed,155,14,0,6,1,251,0,4,0,0,0,0,156,265,0,10
11,D,101,H R 2190,6-Feb-1990,6:16 PM,On Passage,NATIONAL VOTER REGISTRATION ACT OF 1989,Passed,61,108,0,6,228,24,0,4,0,0,0,0,289,132,0,10
12,D,101,H CON RES 262,7-Feb-1990,2:51 PM,SUSPEND THE RULES AND AGREE,EXPRESS SENSE OF CONGRESS CONCERNING OPERATION JUST CAUSE IN PANAMA,Passed,174,0,0,1,215,26,2,13,0,0,0,0,389,26,2,14
13,D,101,H RES 330,7-Feb-1990,3:25 PM,ON AGREEING TO THE RESOLUTION,A RESOLUTION CONCERNING THE CONGRESSIONAL RECORD,Passed,170,0,3,2,203,30,13,10,0,0,0,0,373,30,16,12
14,D,101,H R 1465,7-Feb-1990,4:26 PM,MOTION TO INSTRUCT CONFEREES,"OIL POLLUTION PREVENTION, RESPONSE, LIABILITY, AND COMPENSATION ACT",Passed,150,21,0,4,226,16,0,14,0,0,0,0,376,37,0,18
15,D,101,H RES 338,21-Feb-1990,2:04 PM,On Agreeing to the Resolution,"PROVIDING FOR THE CONSIDERATION OF H.R. 2570, ARIZONA DESERT WILDERNESS ACT OF 1989",Passed,156,0,0,19,230,0,0,26,0,0,0,0,386,0,0,45
16,D,101,H R 2742,27-Feb-1990,4:05 PM,SUSPEND RULES AND AGREE TO CONFERENCE REPORT,LIBRARY SERVICES AND CONSTRUCTION ACT AMENDMENTS,Passed,158,4,0,13,243,0,0,13,0,0,0,0,401,4,0,26
17,D,101,H CON RES 87,27-Feb-1990,4:14 PM,SUSPEND THE RULES AND AGREE,CONCERNING IRANIAN PERSECUTION OF THE BAHAâ€™IS,Passed,162,0,0,13,242,0,0,14,0,0,0,0,404,0,0,27
18,D,101,H R 2570,28-Feb-1990,2:33 PM,On Passage,ARIZONA DESERT WILDERNESS ACT OF 1989,Passed,127,38,0,10,229,7,0,20,0,0,0,0,356,45,0,30
19,D,101,MOTION,6-Mar-1990,12:24 PM,On Approving the Journal,None,Passed,66,95,0,14,218,6,0,32,0,0,0,0,284,101,0,46
20,D,101,H R 1109,6-Mar-1990,2:40 PM,On Motion to Suspend the Rules and Pass,CALIFORNIA NATIONAL HISTORIC TRAIL AND PONY EXPRESS NATIONAL TRAIL,Passed,171,0,0,4,245,0,0,11,0,0,0,0,416,0,0,15
21,D,101,H R 1243,6-Mar-1990,2:49 PM,On Motion to Suspend the Rules and Pass,REQUIRING THE SECRETARY OF ENERGY TO ESTABLISH THREE CENTERS FOR METAL CASTING COMPETITIVENESS RESEARCH,Passed,144,26,0,5,238,1,0,17,0,0,0,0,382,27,0,22
22,D,101,H R 1231,7-Mar-1990,2:45 PM,ON PRESIDENTIAL VETO,ESTABLISH COMMISSION TO INVESTIGATE EASTERN AIRLINES DISPUTE,Failed,25,147,1,2,236,13,0,7,0,0,0,0,261,160,1,9
23,D,101,QUORUM 23,14-Mar-1990,2:25 PM,Call of the House,None,Passed,0,0,170,5,0,0,230,26,0,0,0,0,0,0,400,31
24,D,101,H RES 355,14-Mar-1990,4:10 PM,On Agreeing to the Resolution,PROVIDING FOR THE CONSIDERATION OF H.R. 3581; RURAL ECONOMIC DEVELOPMENT ACT OF 1990,Passed,74,96,0,5,241,3,0,12,0,0,0,0,315,99,0,17
25,D,101,MOTION,15-Mar-1990,11:29 AM,On Approving the Journal,None,Passed,67,93,0,15,225,5,1,25,0,0,0,0,292,98,1,40
26,D,101,QUORUM 26,15-Mar-1990,2:57 PM,Call of the House,None,Passed,0,0,160,15,0,0,224,32,0,0,0,0,0,0,384,47
27,D,101,H R 3581,15-Mar-1990,3:06 PM,On Agreeing to the Amendment,None,Agreed to,68,96,0,11,136,97,0,23,0,0,0,0,204,193,0,34
28,D,101,MOTION,20-Mar-1990,12:28 PM,On Approving the Journal,None,Passed,47,115,0,13,211,6,1,38,0,0,0,0,258,121,1,51
29,D,101,H R 4167,20-Mar-1990,2:25 PM,On Motion to Suspend the Rules and Pass,TO PROVIDE FOR SHORT TERM EXTENSION OF THE STRATEGIC PETROLEUM RESERVE,Passed,165,0,0,10,232,0,0,24,0,0,0,0,397,0,0,34
30,D,101,H R 2692,20-Mar-1990,2:34 PM,On Motion to Suspend the Rules and Pass,AMENDING THE WOODROW WILSON MEMORIAL ACT,Passed,165,0,0,10,234,0,0,22,0,0,0,0,399,0,0,32
31,D,101,S 1091,20-Mar-1990,2:43 PM,On Motion to Suspend the Rules and Pass,COAST GUARD BICENTENNIAL MEDAL ACT,Passed,167,0,0,8,235,0,0,21,0,0,0,0,402,0,0,29
32,D,101,H R 3182,20-Mar-1990,2:51 PM,On Motion to Suspend the Rules and Pass,YOSEMITE NATIONAL PARK CENTENNIAL MEDAL ACT,Passed,168,0,0,7,233,0,0,23,0,0,0,0,401,0,0,30
33,D,101,H R 3834,20-Mar-1990,2:58 PM,On Motion to Suspend the Rules and Pass,SELMA TO MONTGOMERY NATIONAL TRAIL STUDY ACT,Passed,166,0,0,9,234,0,0,22,0,0,0,0,400,0,0,31
34,D,101,H R 2566,20-Mar-1990,3:06 PM,On Motion to Suspend the Rules and Pass,"TO DISCLAIM ANY INTEREST OF THE UNITED STATES IN CERTAIN LANDS ON SAN JUAN ISLAND, WASHINGTON",Passed,167,0,0,8,234,0,0,22,0,0,0,0,401,0,0,30
35,D,101,MOTION,21-Mar-1990,2:24 PM,On Approving the Journal,None,Passed,50,118,0,7,232,6,0,18,0,0,0,0,282,124,0,25
36,D,101,H RES 346,21-Mar-1990,4:51 PM,On Agreeing to the Resolution,PROVIDING EXPENSES FOR INVESTIGATIONS AND STUDIES BY STANDING AND SELECT COMMITTEES OF THE HOUSE,Passed,102,70,0,3,247,1,0,8,0,0,0,0,349,71,0,11
37,D,101,H RES 362,22-Mar-1990,12:27 PM,On Ordering the Previous Question,QUESTION OF PRIVILEGE OF THE HOUSE,Failed,166,0,0,9,37,204,0,15,0,0,0,0,203,204,0,24
38,D,101,H RES 362,22-Mar-1990,1:55 PM,ON MOTION TO REFER TO THE JUDICIARY COMMITTEE,QUESTION OF PRIVILEGE OF THE HOUSE,Failed,0,167,0,8,176,66,0,14,0,0,0,0,176,233,0,22
39,D,101,H RES 362,22-Mar-1990,2:16 PM,On Agreeing to the Resolution,QUESTION OF PRIVILEGE OF THE HOUSE,Passed,167,0,0,8,142,101,0,13,0,0,0,0,309,101,0,21
40,D,101,H R 3581,22-Mar-1990,3:19 PM,On Passage,RURAL ECONOMIC DEVELOPMENT ACT,Passed,123,42,0,10,237,3,0,16,0,0,0,0,360,45,0,26
41,D,101,QUORUM 41,27-Mar-1990,2:09 PM,Call of the House,None,Passed,0,0,165,10,0,0,233,23,0,0,0,0,0,0,398,33
42,D,101,H R 4328,27-Mar-1990,4:45 PM,On Motion to Suspend the Rules and Pass,TRADE AGENCY AUTHORIZATION ACT,Passed,172,0,0,4,252,0,0,4,0,0,0,0,424,0,0,8
43,D,101,H R 2209,27-Mar-1990,4:54 PM,On Motion to Suspend the Rules and Pass,"SOYBEAN PROMOTION, RESEARCH, AND CONSUMER INFORMATION ACT",Passed,165,8,0,3,251,1,0,4,0,0,0,0,416,9,0,7
44,D,101,H R 908,27-Mar-1990,5:02 PM,On Motion to Suspend the Rules and Pass,FERC MEMBER TERM ACT OF 1989,Passed,173,0,0,3,253,0,0,3,0,0,0,0,426,0,0,6
45,D,101,H R 3386,27-Mar-1990,5:10 PM,On Motion to Suspend the Rules and Pass,SAFE TRANSPORTATION OF FOOD ACT,Passed,157,15,0,4,253,0,0,3,0,0,0,0,410,15,0,7
46,D,101,H J RES 471,27-Mar-1990,5:21 PM,On Motion to Suspend the Rules and Pass,"REGARDING COMMERCE, JUSTICE, AND STATE APPROPRIATIONS FOR FY 1990",Failed,87,85,0,4,189,64,0,3,0,0,0,0,276,149,0,7
47,D,101,MOTION,28-Mar-1990,12:22 PM,On Approving the Journal,None,Passed,61,103,1,11,238,5,1,12,0,0,0,0,299,108,2,23
48,D,101,QUORUM 48,28-Mar-1990,3:39 PM,Call of the House,None,Passed,0,0,169,7,0,0,244,13,0,0,0,0,0,0,413,20
49,D,101,H R 3847,28-Mar-1990,5:00 PM,On Agreeing to the Amendment,None,Failed,136,38,0,2,25,228,0,4,0,0,0,0,161,266,0,6
50,D,101,H R 3847,28-Mar-1990,5:21 PM,On Passage,DEPARTMENT OF ENVIRONMENTAL PROTECTION ACT,Passed,132,42,0,2,239,13,0,5,0,0,0,0,371,55,0,7
51,D,101,H R 1463,28-Mar-1990,7:11 PM,On Agreeing to the Amendment,None,Agreed to,169,0,0,7,236,3,0,18,0,0,0,0,405,3,0,25
52,D,101,H R 1463,28-Mar-1990,7:27 PM,On Passage,NATIONAL CAPITAL TRANSPORTATION AMENDMENTS,Passed,46,123,0,7,214,27,0,16,0,0,0,0,260,150,0,23
53,D,101,H RES 368,29-Mar-1990,11:30 AM,On Ordering the Previous Question,PROVIDING FOR THE CONSIDERATION OF H.R. 3; CHILDHOOD EDUCATION AND DEVELOPMENT ACT OF 1989,Passed,0,170,0,6,251,1,0,5,0,0,0,0,251,171,0,11
54,D,101,H RES 368,29-Mar-1990,11:46 AM,On Agreeing to the Resolution,PROVIDING FOR THE CONSIDERATION OF H.R. 3; CHILDHOOD EDUCATION AND DEVELOPMENT ACT OF 1989,Passed,0,171,0,5,246,5,0,6,0,0,0,0,246,176,0,11
55,D,101,H R 3,29-Mar-1990,3:18 PM,On Agreeing to the Amendment,None,Failed,10,163,0,3,172,80,0,5,0,0,0,0,182,243,0,8
56,D,101,H R 3,29-Mar-1990,4:35 PM,On Agreeing to the Amendment,None,Failed,11,160,0,5,114,137,0,6,0,0,0,0,125,297,0,11
57,D,101,H R 3,29-Mar-1990,6:14 PM,On Agreeing to the Amendment,None,Failed,157,14,0,5,38,211,0,8,0,0,0,0,195,225,0,13
58,D,101,H R 3,29-Mar-1990,6:34 PM,On Agreeing to the Amendment,None,Agreed to,39,132,0,5,224,26,0,7,0,0,0,0,263,158,0,12
59,D,101,H R 3,29-Mar-1990,6:58 PM,COMMIT WITH INSTRUCTIONS,CHILDHOOD EDUCATION AND DEVELOPMENT ACT OF 1989,Failed,151,16,0,9,1,243,0,13,0,0,0,0,152,259,0,22
60,D,101,H R 3,29-Mar-1990,7:16 PM,On Passage,CHILDHOOD EDUCATION AND DEVELOPMENT ACT OF 1989,Passed,47,119,0,10,218,26,0,13,0,0,0,0,265,145,0,23
61,D,101,H R 4404,3-Apr-1990,3:00 PM,ON AGREEING TO THE AMENDMENT,None,Failed,10,163,0,3,28,216,0,13,0,0,0,0,38,379,0,16
62,D,101,H R 4404,3-Apr-1990,4:23 PM,On Agreeing to the Amendment,None,Failed,20,152,0,4,44,202,0,11,0,0,0,0,64,354,0,15
63,D,101,H R 4404,3-Apr-1990,4:51 PM,On Agreeing to the Amendment,None,Failed,25,148,0,3,47,198,0,12,0,0,0,0,72,346,0,15
64,D,101,H R 4404,3-Apr-1990,5:16 PM,On Agreeing to the Amendment,None,Failed,0,172,0,4,2,246,0,9,0,0,0,0,2,418,0,13
65,D,101,H R 4404,3-Apr-1990,6:02 PM,On Passage,"DIRE EMERGENCY SUPPLEMENTAL APPROPRIATION, 1990",Passed,139,34,0,3,223,25,0,9,0,0,0,0,362,59,0,12
66,D,101,H R 1048,4-Apr-1990,1:30 PM,SUSPEND THE RULES AND AGREE TO SENATE AMENDMENT,HATE CRIMES STATISTICS ACT,Passed,156,18,0,2,246,0,0,11,0,0,0,0,402,18,0,13
67,D,101,H CON RES 289,4-Apr-1990,1:37 PM,SUSPEND THE RULES AND AGREE,RIGHTS OF THE LITHUANIAN PEOPLE,Passed,173,0,0,3,243,3,0,11,0,0,0,0,416,3,0,14
68,D,101,H R 2015,4-Apr-1990,4:14 PM,On Passage,PUBLIC WORKS AND ECONOMIC DEVELOPMENT ACT AMENDMENTS,Passed,97,78,0,1,243,4,0,10,0,0,0,0,340,82,0,11
69,D,101,H RES 373,18-Apr-1990,2:23 PM,On Ordering the Previous Question,"PROVIDING FOR THE CONSIDERATION OF H.R. 1236, PRICE FIXING PREVENTION ACT",Passed,0,156,0,20,235,1,0,21,0,0,0,0,235,157,0,41
70,D,101,QUORUM 70,18-Apr-1990,4:14 PM,Call of the House,None,Passed,0,0,160,16,0,0,235,22,0,0,0,0,0,0,395,38
71,D,101,H R 1236,18-Apr-1990,4:24 PM,On Agreeing to the Amendment,None,Failed,136,25,0,15,19,217,0,21,0,0,0,0,155,242,0,36
72,D,101,H R 1236,18-Apr-1990,5:16 PM,On Agreeing to the Amendment,None,Failed,156,4,0,16,36,200,0,21,0,0,0,0,192,204,0,37
73,D,101,H R 1236,18-Apr-1990,5:52 PM,On Agreeing to the Amendment,None,Failed,153,3,0,20,37,196,0,24,0,0,0,0,190,199,0,44
74,D,101,H R 1236,18-Apr-1990,6:13 PM,On Passage,PRICE FIXING PREVENTION ACT,Passed,23,134,0,19,212,23,0,22,0,0,0,0,235,157,0,41
75,D,101,H R 644,19-Apr-1990,1:34 PM,On Passage,JEMEZ AND PECOS RIVERS WILD AND SCENIC RIVER ADDITION ACT OF 1989,Passed,156,1,0,19,235,0,0,22,0,0,0,0,391,1,0,41
76,D,101,H RES 354,24-Apr-1990,3:10 PM,SUSPEND THE RULES AND AGREE,REGARDING HUMAN RIGHTS IN LIBERIA,Passed,170,0,0,6,247,0,0,10,0,0,0,0,417,0,0,16
77,D,101,H CON RES 290,24-Apr-1990,3:19 PM,SUSPEND THE RULES AND AGREE,CONCERNING JERUSALEM AND THE PEACE PROCESS,Passed,157,10,3,6,221,24,3,9,0,0,0,0,378,34,6,15
78,D,101,H R 3961,24-Apr-1990,3:28 PM,On Motion to Suspend the Rules and Pass,ROBERT S. VANCE FEDERAL BUILDING,Passed,169,0,0,7,248,0,0,9,0,0,0,0,417,0,0,16
79,D,101,QUORUM 79,25-Apr-1990,3:01 PM,Call of the House,None,Passed,0,0,162,14,0,0,240,17,0,0,0,0,0,0,402,31
80,D,101,H R 3848,25-Apr-1990,3:12 PM,On Agreeing to the Amendment,None,Agreed to,30,132,0,14,177,68,0,12,0,0,0,0,207,200,0,26
81,D,101,H R 3848,25-Apr-1990,4:32 PM,On Agreeing to the Amendment,None,Failed,6,158,0,12,121,125,0,11,0,0,0,0,127,283,0,23
82,D,101,H R 3848,25-Apr-1990,4:56 PM,On Passage,DEPOSITORY INSTITUTION MONEY LAUNDERING AMENDMENTS OF 1990,Passed,163,0,0,13,243,0,1,13,0,0,0,0,406,0,1,26
83,D,101,QUORUM 83,26-Apr-1990,2:38 PM,Call of the House,None,Passed,0,0,167,9,0,0,240,17,0,0,0,0,0,0,407,26
84,D,101,H CON RES 310,26-Apr-1990,2:48 PM,On Agreeing to the Amendment,None,Failed,79,89,0,8,27,216,0,14,0,0,0,0,106,305,0,22
85,D,101,H CON RES 310,26-Apr-1990,3:49 PM,On Agreeing to the Amendment,None,Failed,42,119,0,15,6,235,0,16,0,0,0,0,48,354,0,31
86,D,101,H R 743,1-May-1990,1:44 PM,On Motion to Suspend the Rules and Pass,NEGOTIATED RULEMAKING ACT OF 1990,Passed,165,0,1,10,246,0,0,11,0,0,0,0,411,0,1,21
87,D,101,S 1485,1-May-1990,1:53 PM,On Motion to Suspend the Rules and Pass,QUAD CITIES INTERSTATE METROPOLITAN AUTHORITY COMPACT,Passed,165,0,0,11,248,0,0,9,0,0,0,0,413,0,0,20
88,D,101,H CON RES 310,1-May-1990,4:15 PM,On Agreeing to the Amendment,None,Failed,0,174,0,2,90,160,0,7,0,0,0,0,90,334,0,9
89,D,101,H CON RES 310,1-May-1990,5:28 PM,On Agreeing to the Resolution,"BUDGET FOR UNITED STATES GOVERNMENT FOR FISCAL YEARS 1991, 1992, 1993, 1994, AND 1995",Passed,0,174,0,2,218,34,0,5,0,0,0,0,218,208,0,7
90,D,101,H RES 379,2-May-1990,1:27 PM,On Agreeing to the Resolution,PROVIDING FOR CONSIDERATION OF H. R. 4380; SUPERCONDUCTING SUPER COLLIDER PROJECT AUTHORIZATION ACT OF 1990,Passed,169,0,0,7,237,0,0,20,0,0,0,0,406,0,0,27
91,D,101,QUORUM 91,2-May-1990,3:32 PM,Call of the House,None,Passed,0,0,171,5,0,0,245,12,0,0,0,0,0,0,416,17
92,D,101,H R 4380,2-May-1990,3:40 PM,On Agreeing to the Amendment,None,Agreed to,171,0,0,5,249,0,0,8,0,0,0,0,420,0,0,13
93,D,101,H R 4380,2-May-1990,5:19 PM,On Agreeing to the Amendment,None,Agreed to,139,32,0,5,117,131,0,9,0,0,0,0,256,163,0,14
94,D,101,H R 4380,2-May-1990,5:49 PM,On Passage,SUPERCONDUCTING SUPER COLLIDER PROJECT AUTHORIZATION ACT OF 1990,Passed,115,57,0,4,194,52,0,11,0,0,0,0,309,109,0,15
95,D,101,MOTION,3-May-1990,11:24 AM,On Approving the Journal,None,Passed,59,101,0,16,224,5,0,28,0,0,0,0,283,106,0,44
96,D,101,H R 4404,3-May-1990,12:35 PM,MOTION TO INSTRUCT CONFEREES,"DIRE EMERGENCY SUPPLEMENTAL APPROPRIATION, 1990",Passed,163,1,0,12,225,7,0,25,0,0,0,0,388,8,0,37
97,D,101,MOTION,8-May-1990,12:24 PM,On Approving the Journal,None,Passed,56,100,0,20,207,6,1,43,0,0,0,0,263,106,1,63
98,D,101,H R 4522,8-May-1990,2:50 PM,On Motion to Suspend the Rules and Pass,IMPROVING INFORMATION AVAILABLE TO EMERGENCY RESPONSE PERSONNEL IN THE FIELD,Passed,169,0,0,7,241,0,0,16,0,0,0,0,410,0,0,23
99,D,101,H R 237,8-May-1990,2:58 PM,On Motion to Suspend the Rules and Pass,BIOLOGICAL WEAPONS ACT OF 1989,Passed,169,0,0,7,239,0,0,18,0,0,0,0,408,0,0,25
100,D,101,MOTION,9-May-1990,2:22 PM,On Approving the Journal,None,Passed,64,102,0,10,234,6,0,17,0,0,0,0,298,108,0,27
101,D,101,MOTION,9-May-1990,3:37 PM,ON MOTION TO PROCEED IN ORDER,None,Passed,0,167,0,9,246,0,1,10,0,0,0,0,246,167,1,19
102,D,101,H R 3,9-May-1990,4:18 PM,MOTION TO INSTRUCT CONFEREES,CHILDHOOD EDUCATION AND DEVELOPMENT ACT OF 1989,Passed,166,0,1,9,245,0,0,12,0,0,0,0,411,0,1,21
103,D,101,H R 2364,9-May-1990,5:53 PM,On Agreeing to the Conference Report,AMTRAK REAUTHORIZATION AND IMPROVEMENT ACT OF 1989,Passed,84,83,0,9,238,10,0,9,0,0,0,0,322,93,0,18
104,D,101,H RES 388,9-May-1990,7:22 PM,On Agreeing to the Resolution,PROVIDING FOR THE CONSIDERATION OF H.R. 770; FAMILY AND MEDICAL LEAVE ACT OF 1989,Passed,18,146,0,12,233,5,0,19,0,0,0,0,251,151,0,31
105,D,101,H R 770,10-May-1990,12:36 PM,On Agreeing to the Amendment,None,Agreed to,47,123,0,6,212,34,0,11,0,0,0,0,259,157,0,17
106,D,101,H R 770,10-May-1990,1:07 PM,On Motion to Recommit with Instructions,FAMILY AND MEDICAL LEAVE ACT OF 1989,Failed,129,39,0,8,26,225,0,6,0,0,0,0,155,264,0,14
107,D,101,H R 770,10-May-1990,1:25 PM,On Passage,FAMILY AND MEDICAL LEAVE ACT OF 1989,Passed,39,133,0,4,198,54,0,5,0,0,0,0,237,187,0,9
108,D,101,H RES 381,15-May-1990,3:04 PM,SUSPEND THE RULES AND AGREE,RELATING TO HUMAN RIGHTS ABUSES BY THE GOVERNMENT OF CUBA,Passed,162,0,0,14,229,2,0,26,0,0,0,0,391,2,0,40
109,D,101,MOTION,16-May-1990,10:22 AM,On Approving the Journal,None,Passed,56,108,0,12,211,5,0,40,0,0,0,0,267,113,0,52
110,D,101,H RES 392,16-May-1990,11:44 AM,On Agreeing to the Resolution,PROVIDING FOR THE CONSIDERATION OF H.R. 4151; HUMAN SERVICES REAUTHORIZATION ACT OF 1990,Passed,171,0,0,5,237,0,0,19,0,0,0,0,408,0,0,24
111,D,101,H R 4151,16-May-1990,1:32 PM,On Passage,HUMAN SERVICES REAUTHORIZATION ACT OF 1990,Passed,156,14,0,6,248,0,0,8,0,0,0,0,404,14,0,14
112,D,101,MOTION,17-May-1990,10:23 AM,On Approving the Journal,None,Passed,60,99,0,17,225,4,0,27,0,0,0,0,285,103,0,44
113,D,101,H RES 394,17-May-1990,12:43 PM,On Ordering the Previous Question,PROVIDING FOR THE CONSIDERATION OF H.R. 2273; AMERICANS WITH DISABILITIES ACT OF 1990,Passed,7,160,0,9,244,2,0,10,0,0,0,0,251,162,0,19
114,D,101,H RES 394,17-May-1990,1:01 PM,On Agreeing to the Resolution,PROVIDING FOR THE CONSIDERATION OF H.R. 2273; AMERICANS WITH DISABILITIES ACT OF 1990,Passed,14,154,0,8,223,18,0,15,0,0,0,0,237,172,0,23
115,D,101,QUORUM 115,17-May-1990,3:54 PM,Call of the House,None,Passed,0,0,152,24,0,0,245,11,0,0,0,0,0,0,397,35
116,D,101,H R 2273,17-May-1990,4:02 PM,On Agreeing to the Amendment,None,Agreed to,153,0,0,23,248,0,0,8,0,0,0,0,401,0,0,31
117,D,101,H R 2273,17-May-1990,5:23 PM,On Agreeing to the Amendment,None,Failed,119,39,0,18,68,174,0,14,0,0,0,0,187,213,0,32
118,D,101,H R 2273,17-May-1990,6:48 PM,On Agreeing to the Amendment,None,Agreed to,120,31,0,25,79,156,0,21,0,0,0,0,199,187,0,46
119,D,101,H R 2273,22-May-1990,11:31 AM,On Agreeing to the Amendment,None,Failed,87,78,0,11,23,212,0,21,0,0,0,0,110,290,0,32
120,D,101,H R 2273,22-May-1990,12:37 PM,On Agreeing to the Amendment,None,Failed,116,54,0,6,32,212,0,12,0,0,0,0,148,266,0,18
121,D,101,H R 2273,22-May-1990,2:12 PM,On Agreeing to the Amendment,None,Failed,146,24,0,6,46,203,0,7,0,0,0,0,192,227,0,13
122,D,101,H R 2273,22-May-1990,2:53 PM,On Motion to Recommit with Instructions,AMERICANS WITH DISABILITIES ACT OF 1990,Failed,135,37,0,4,8,243,0,5,0,0,0,0,143,280,0,9
123,D,101,H R 2273,22-May-1990,3:00 PM,On Passage,AMERICANS WITH DISABILITIES ACT OF 1990,Passed,155,17,0,4,248,3,0,5,0,0,0,0,403,20,0,9
124,D,101,S 286,22-May-1990,3:25 PM,SUSPEND RULES AND PASSAS AMENDED,PETROGLYPH NATIONAL MONUMENT ESTABLISHMENT ACT OF 1989,Passed,169,0,0,7,246,0,0,10,0,0,0,0,415,0,0,17
125,D,101,H RES 395,22-May-1990,4:10 PM,On Agreeing to the Resolution,"PROVIDING FOR CONSIDERATION OF H.R. 4636, SUPPLEMENTAL ASSISTANCE FOR EMERGING DEMOCRACIES ACT OF 1990.",Passed,66,103,0,7,239,5,0,12,0,0,0,0,305,108,0,19
126,D,101,H R 4636,22-May-1990,7:24 PM,On Agreeing to the Amendment,None,Failed,152,18,0,6,23,225,0,8,0,0,0,0,175,243,0,14
127,D,101,H R 4636,22-May-1990,8:58 PM,On Agreeing to the Amendment,None,Agreed to,31,135,0,10,219,28,0,9,0,0,0,0,250,163,0,19
128,D,101,H R 4636,22-May-1990,9:20 PM,On Passage,SUPPLEMENTAL ASSISTANCE FOR EMERGING DEMOCRACIES ACT OF 1990,Failed,16,150,0,10,155,94,0,7,0,0,0,0,171,244,0,17
129,D,101,H RES 399,23-May-1990,11:41 AM,On Ordering the Previous Question,"PROVIDING FOR THE FURTHER CONSIDERATION OF H.R. 3030, CLEAN AIR ACT AMENDMENTS OF 1990",Passed,94,75,0,7,218,31,0,7,0,0,0,0,312,106,0,14
130,D,101,H RES 399,23-May-1990,11:59 AM,On Agreeing to the Resolution,"PROVIDING FOR THE FURTHER CONSIDERATION OF H.R. 3030, CLEAN AIR ACT AMENDMENTS OF 1990",Passed,98,72,0,6,219,33,0,4,0,0,0,0,317,105,0,10
131,D,101,H R 3030,23-May-1990,2:39 PM,ON AGREEING TO THE AMENDMENTS,None,Failed,75,95,0,6,95,158,0,3,0,0,0,0,170,253,0,9
132,D,101,H R 3030,23-May-1990,4:17 PM,On Agreeing to the Amendment,None,Agreed to,43,126,0,7,231,20,0,5,0,0,0,0,274,146,0,12
133,D,101,H R 3030,23-May-1990,5:10 PM,On Agreeing to the Amendment,None,Agreed to,61,106,0,9,178,74,0,4,0,0,0,0,239,180,0,13
134,D,101,H R 3030,23-May-1990,6:42 PM,On Agreeing to the Amendment,None,Agreed to,170,0,0,6,246,0,0,10,0,0,0,0,416,0,0,16
135,D,101,H R 3030,23-May-1990,8:13 PM,On Agreeing to the Amendment,None,Agreed to,166,4,0,6,245,1,0,10,0,0,0,0,411,5,0,16
136,D,101,H R 3030,23-May-1990,9:20 PM,On Agreeing to the Amendment,None,Agreed to,154,15,0,7,251,0,0,5,0,0,0,0,405,15,0,12
137,D,101,H R 3030,23-May-1990,9:48 PM,On Passage,CLEAN AIR ACT AMENDMENTS OF 1990,Passed,154,16,0,6,247,5,0,4,0,0,0,0,401,21,0,10
138,D,101,H R 4404,24-May-1990,11:52 AM,On Agreeing to the Conference Report,"DIRE EMERGENCY SUPPLEMENTAL APPROPRIATION, 1990",Passed,105,64,0,7,203,44,0,9,0,0,0,0,308,108,0,16
139,D,101,H R 4404,24-May-1990,1:05 PM,RECEDE FROM DISAGREEMENT TO S ADT.#12,"DIRE EMERGENCY SUPPLEMENTAL APPROPRIATION, 1990",Passed,32,130,0,14,214,30,0,12,0,0,0,0,246,160,0,26
140,D,101,H R 4404,24-May-1990,1:58 PM,RECEDE FROM DISAGREEMENT TO S. ADT. #22,"DIRE EMERGENCY SUPPLEMENTAL APPROPRIATION, 1990",Passed,50,116,0,10,234,7,0,15,0,0,0,0,284,123,0,25
141,D,101,H R 4404,24-May-1990,2:50 PM,RECEDE FROM DISAGREEMENT TO S ADT #24,"DIRE EMERGENCY SUPPLEMENTAL APPROPRIATION, 1990",Failed,6,162,0,8,27,214,0,15,0,0,0,0,33,376,0,23
142,D,101,H R 4404,24-May-1990,4:42 PM,RECEDE AND CONCUR WITHADT IN S ADT #81,"DIRE EMERGENCY SUPPLEMENTAL APPROPRIATION, 1990",Passed,156,8,0,12,121,118,0,17,0,0,0,0,277,126,0,29
143,D,101,H R 4404,24-May-1990,5:21 PM,RECEDE FROM DISAGREEMENT TO S. ADT. #84,"DIRE EMERGENCY SUPPLEMENTAL APPROPRIATION, 1990",Passed,28,134,0,14,203,31,0,22,0,0,0,0,231,165,0,36
144,D,101,H R 4404,24-May-1990,6:55 PM,RECEDE AND CONCUR WITHADT. IN S. ADT. #124,"DIRE EMERGENCY SUPPLEMENTAL APPROPRIATION, 1990",Passed,43,119,0,14,187,47,0,22,0,0,0,0,230,166,0,36
145,D,101,H R 4404,24-May-1990,7:54 PM,RECEDE FROM DISAGREEMENT TO S ADT #167,"DIRE EMERGENCY SUPPLEMENTAL, 1990",Passed,0,152,0,24,208,11,0,37,0,0,0,0,208,163,0,61
146,D,101,H R 4404,24-May-1990,9:08 PM,RECEDE AND CONCUR IN SADT #171 WITH ADT,"DIRE EMERGENCY SUPPLEMENTAL APPROPRIATION, 1990",Failed,1,148,0,27,160,60,0,36,0,0,0,0,161,208,0,63
147,D,101,MOTION,6-Jun-1990,10:23 AM,ON APPROVING THE JOURNAL,None,Passed,64,98,1,13,208,6,0,42,0,0,0,0,272,104,1,55
148,D,101,H R 4653,6-Jun-1990,1:07 PM,On Agreeing to the Amendment,None,Failed,107,63,0,6,10,228,0,18,0,0,0,0,117,291,0,24
149,D,101,H R 4653,6-Jun-1990,2:10 PM,ON AGREEING TO THE AMENDMENT,None,Agreed to,165,5,0,6,225,19,0,12,0,0,0,0,390,24,0,18
150,D,101,H R 4653,6-Jun-1990,2:42 PM,On Agreeing to the Amendment,None,Agreed to,147,25,0,4,205,37,0,14,0,0,0,0,352,62,0,18
151,D,101,H R 4653,6-Jun-1990,3:17 PM,On Agreeing to the Amendment,None,Agreed to,164,7,0,5,229,8,1,18,0,0,0,0,393,15,1,23
152,D,101,H R 4653,6-Jun-1990,3:50 PM,On Agreeing to the Amendment,None,Agreed to,170,0,0,6,239,0,0,17,0,0,0,0,409,0,0,23
153,D,101,H R 4653,6-Jun-1990,5:21 PM,On Agreeing to the Amendment,None,Failed,115,58,0,3,21,223,0,12,0,0,0,0,136,281,0,15
154,D,101,H R 4653,6-Jun-1990,6:48 PM,On Agreeing to the Amendment,None,Failed,44,127,0,5,3,238,0,15,0,0,0,0,47,365,0,20
155,D,101,H R 4653,6-Jun-1990,7:15 PM,On Agreeing to the Amendment,None,Agreed to,125,41,0,10,223,4,0,29,0,0,0,0,348,45,0,39
156,D,101,H R 4653,6-Jun-1990,7:55 PM,On Agreeing to the Amendment,None,Failed,73,93,0,10,5,222,0,29,0,0,0,0,78,315,0,39
157,D,101,H R 4653,6-Jun-1990,8:23 PM,On Agreeing to the Amendment,None,Agreed to,165,0,0,11,223,2,0,31,0,0,0,0,388,2,0,42
158,D,101,H R 4653,6-Jun-1990,8:58 PM,On Agreeing to the Amendment,None,Failed,85,82,0,9,5,222,0,29,0,0,0,0,90,304,0,38
159,D,101,H R 4653,6-Jun-1990,10:43 PM,On Motion to Recommit with Instructions,EXPORT FACILITATION ACT OF 1990,Failed,133,36,0,7,10,216,0,30,0,0,0,0,143,252,0,37
160,D,101,H R 4653,6-Jun-1990,10:50 PM,On Passage,EXPORT FACILITATION ACT OF 1990,Passed,87,82,0,7,225,4,0,27,0,0,0,0,312,86,0,34
161,D,101,MOTION,7-Jun-1990,10:23 AM,On Approving the Journal,None,Passed,61,101,0,14,222,5,0,29,0,0,0,0,283,106,0,43
162,D,101,H R 2364,7-Jun-1990,12:47 PM,ON PRESIDENTIAL VETO,AMTRAK REAUTHORIZATION AND IMPROVEMENT ACT OF 1989,Passed,58,116,0,2,236,7,0,13,0,0,0,0,294,123,0,15
163,D,101,H R 20,12-Jun-1990,4:40 PM,SUSPEND THE RULES AND AGREE TO SENATE AMENDMENT,FEDERAL EMPLOYEES POLITICAL ACTIVITIES ACT OF 1989,Passed,90,84,0,2,244,3,0,9,0,0,0,0,334,87,0,11
164,D,101,H RES 408,13-Jun-1990,11:10 AM,On Agreeing to the Resolution,PROVIDING FOR THE CONSIDERATION OF H.R. 4785; AIDS PREVENTION ACT OF 1990,Passed,61,109,0,6,247,0,0,9,0,0,0,0,308,109,0,15
165,D,101,H RES 409,13-Jun-1990,12:27 PM,On Agreeing to the Resolution,PROVIDING FOR THE CONSIDERATION OF H.R. 2567; RECLAMATION PROJECTS AUTHORIZATION AND ADJUSTMENT ACT OF 1989,Passed,30,140,1,5,220,27,0,9,0,0,0,0,250,167,1,14
166,D,101,H R 4785,13-Jun-1990,3:32 PM,On Agreeing to the Amendment,None,Agreed to,70,103,0,3,242,10,0,4,0,0,0,0,312,113,0,7
167,D,101,H R 4785,13-Jun-1990,3:50 PM,On Agreeing to the Amendment,None,Agreed to,171,1,0,4,251,0,0,5,0,0,0,0,422,1,0,9
168,D,101,H R 4785,13-Jun-1990,4:11 PM,On Passage,AIDS PREVENTION ACT OF 1990,Passed,159,14,0,3,249,0,0,7,0,0,0,0,408,14,0,10
169,D,101,H R 2567,14-Jun-1990,2:12 PM,On Agreeing to the Amendment,None,Failed,75,93,0,8,43,204,0,9,0,0,0,0,118,297,0,17
170,D,101,H R 2567,14-Jun-1990,2:41 PM,ON AGREEING TO THE AMENDMENT,None,Agreed to,107,64,0,5,209,33,0,14,0,0,0,0,316,97,0,19
171,D,101,H R 2567,14-Jun-1990,4:38 PM,On Agreeing to the Amendment,None,Agreed to,124,38,0,14,214,17,0,25,0,0,0,0,338,55,0,39
172,D,101,MOTION,19-Jun-1990,12:27 PM,On Approving the Journal,None,Passed,54,110,0,12,226,5,0,25,0,0,0,0,280,115,0,37
173,D,101,H RES 413,19-Jun-1990,2:19 PM,On Ordering the Previous Question,WAIVING CERTAIN POINTS OF ORDER AGAINST H.R. 5019; ENERGY AND WATER DEVELOPMENT APPROPRIATION FOR 1991,Passed,14,155,0,7,246,2,0,8,0,0,0,0,260,157,0,15
174,D,101,H RES 413,19-Jun-1990,2:38 PM,On Agreeing to the Resolution,WAIVING CERTAIN POINTS OF ORDER AGAINST H.R. 5019; ENERGY AND WATER DEVELOPMENT APPROPRIATION FOR 1991,Passed,32,134,1,9,244,2,0,10,0,0,0,0,276,136,1,19
175,D,101,H R 5019,19-Jun-1990,4:58 PM,On Agreeing to the Amendment,None,Failed,32,139,0,5,110,139,0,7,0,0,0,0,142,278,0,12
176,D,101,H R 5019,19-Jun-1990,5:24 PM,On Agreeing to the Amendment,None,Agreed to,166,6,0,4,247,1,0,8,0,0,0,0,413,7,0,12
177,D,101,H R 5019,19-Jun-1990,6:41 PM,On Agreeing to the Amendment,None,Failed,98,70,0,8,42,207,0,7,0,0,0,0,140,277,0,15
178,D,101,H R 5019,19-Jun-1990,7:17 PM,On Agreeing to the Amendment,None,Failed,86,85,0,5,12,229,0,15,0,0,0,0,98,314,0,20
179,D,101,H R 5019,19-Jun-1990,7:42 PM,On Agreeing to the Amendment,None,Failed,99,72,0,5,25,213,0,18,0,0,0,0,124,285,0,23
180,D,101,H R 5019,19-Jun-1990,8:16 PM,On Agreeing to the Amendment,None,Failed,126,42,0,8,49,190,0,17,0,0,0,0,175,232,0,25
181,D,101,H R 5019,19-Jun-1990,8:36 PM,On Passage,"ENERGY AND WATER DEVELOPMENT APPROPRIATION, FY 1991",Passed,121,48,0,7,234,11,0,11,0,0,0,0,355,59,0,18
182,D,101,H R 3859,19-Jun-1990,8:53 PM,On Motion to Suspend the Rules and Pass,WASHINGTON CENTERS FOR INTERNSHIPS AND ACADEMIC SEMINARS,Failed,10,157,0,9,81,156,0,19,0,0,0,0,91,313,0,28
183,D,101,MOTION,20-Jun-1990,10:23 AM,On Approving the Journal,None,Passed,55,116,0,5,226,5,0,25,0,0,0,0,281,121,0,30
184,D,101,H R 20,20-Jun-1990,12:37 PM,ON PRESIDENTIAL VETO,FEDERAL EMPLOYEES POLITICAL ACTIVITIES ACT OF 1989,Passed,84,90,0,2,243,3,0,10,0,0,0,0,327,93,0,12
185,D,101,H R 3,20-Jun-1990,2:06 PM,MOTION TO INSTRUCT CONFEREES,CHILDHOOD EDUCATION AND DEVELOPMENT ACT OF 1989,Passed,174,1,0,1,210,35,0,11,0,0,0,0,384,36,0,12
186,D,101,H R 3,20-Jun-1990,2:53 PM,MOTION TO INSTRUCT CONFEREES,CHILDHOOD EDUCATION AND DEVELOPMENT ACT OF 1989,Passed,173,0,0,3,243,0,0,13,0,0,0,0,416,0,0,16
187,D,101,H R 5021,20-Jun-1990,5:07 PM,On Agreeing to the Amendment,None,Agreed to,173,1,0,2,247,0,0,9,0,0,0,0,420,1,0,11
188,D,101,H R 5021,20-Jun-1990,6:16 PM,On Agreeing to the Amendment,None,Failed,8,166,0,2,103,140,0,13,0,0,0,0,111,306,0,15
189,D,101,MOTION,21-Jun-1990,10:24 AM,On Approving the Journal,None,Passed,59,108,0,9,227,6,0,23,0,0,0,0,286,114,0,32
190,D,101,H RES 417,21-Jun-1990,12:03 PM,On Ordering the Previous Question,PROVIDING FOR THE CONSIDERATION OF H.J. RES 350; CONSTITUTIONAL AMENDMENT TO BAN PHYSICAL DESECRATION OF THE FLAG OF THE UNITED STATES,Passed,0,176,0,0,232,15,0,9,0,0,0,0,232,191,0,9
191,D,101,H RES 417,21-Jun-1990,12:20 PM,On Agreeing to the Resolution,PROVIDING FOR THE CONSIDERATION OF H.J. RES 350; CONSTITUTIONAL AMENDMENT TO BAN PHYSICAL DESECRATION OF THE FLAG OF THE UNITED STATES,Passed,1,174,0,1,230,18,0,8,0,0,0,0,231,192,0,9
192,D,101,H J RES 350,21-Jun-1990,6:52 PM,On Motion to Suspend the Rules and Pass,CONSTITUTIONAL AMENDMENT TO BAN PHYSICAL DESECRATION OF THE FLAG OF THE UNITED STATES,Failed,159,17,0,0,95,160,0,2,0,0,0,0,254,177,0,2
193,D,101,H R 5091,21-Jun-1990,8:02 PM,On Motion to Suspend the Rules and Pass,FLAG PROTECTION ACT OF 1990,Failed,17,154,0,5,162,82,0,12,0,0,0,0,179,236,0,17
194,D,101,QUORUM 194,26-Jun-1990,1:45 PM,Call of the House,None,Passed,0,0,168,8,0,0,233,23,0,0,0,0,0,0,401,31
195,D,101,H R 5021,26-Jun-1990,1:52 PM,On Agreeing to the Amendment,None,Failed,75,94,0,7,13,229,0,14,0,0,0,0,88,323,0,21
196,D,101,H R 5021,26-Jun-1990,2:42 PM,On Passage,"COMMERCE, JUSTICE, STATE, THE JUDICIARY AND RELATED AGENCIES APPROPRIATION, FY 1991",Passed,121,49,0,6,237,6,0,13,0,0,0,0,358,55,0,19
197,D,101,S 280,26-Jun-1990,5:15 PM,On Agreeing to the Amendment,None,Failed,98,73,0,5,17,229,0,10,0,0,0,0,115,302,0,15
198,D,101,S 280,26-Jun-1990,5:52 PM,On Agreeing to the Amendment,None,Failed,83,89,0,4,10,234,0,12,0,0,0,0,93,323,0,16
199,D,101,S 280,26-Jun-1990,6:12 PM,On Passage,NIOBRARA RIVER SCENIC RIVER DESIGNATION ACT OF 1989,Passed,114,58,0,4,244,1,0,11,0,0,0,0,358,59,0,15
200,D,101,H RES 425,27-Jun-1990,11:35 AM,On Agreeing to the Resolution,"WAIVING CERTAIN POINTS OF ORDER DURING THE CONSIDERATION OF H.R. 5114, FOREIGN ASSISTANCE AND RELATED PROGRAMS APPROPRIATION, 1991",Passed,19,150,0,7,243,7,0,6,0,0,0,0,262,157,0,13
201,D,101,H R 5114,27-Jun-1990,3:15 PM,On Agreeing to the Amendment,None,Agreed to,138,36,0,2,86,162,0,8,0,0,0,0,224,198,0,10
202,D,101,H R 5114,27-Jun-1990,3:33 PM,On Agreeing to the Amendment,None,Agreed to,166,7,0,3,240,4,0,12,0,0,0,0,406,11,0,15
203,D,101,H R 5114,27-Jun-1990,5:00 PM,On Agreeing to the Amendment,None,Agreed to,153,22,0,1,107,141,0,8,0,0,0,0,260,163,0,9
204,D,101,H R 5114,27-Jun-1990,5:58 PM,On Passage,"FOREIGN ASSISTANCE AND RELATED PROGRAMS APPROPRIATION, 1991",Passed,108,67,0,1,200,50,0,6,0,0,0,0,308,117,0,7
205,D,101,H RES 426,28-Jun-1990,11:20 AM,On Agreeing to the Resolution,"WAIVING CERTAIN POINTS OF ORDER DURING CONSIDERATION OF H.R. 5158; VETERANS AFFAIRS, HOUSING, AND URBAN DEVELOPMENT INDEPENDENT AGENCIES APPROPRIATION FOR 1991",Passed,108,59,0,9,243,0,0,13,0,0,0,0,351,59,0,22
206,D,101,QUORUM 206,28-Jun-1990,2:15 PM,Call of the House,None,Passed,0,0,172,4,0,0,237,19,0,0,0,0,0,0,409,23
207,D,101,H R 5158,28-Jun-1990,2:23 PM,On Agreeing to the Amendment,None,Failed,65,105,0,6,7,232,0,17,0,0,0,0,72,337,0,23
208,D,101,H R 5158,28-Jun-1990,2:50 PM,On Agreeing to the Amendment,None,Failed,48,108,0,20,5,235,0,16,0,0,0,0,53,343,0,36
209,D,101,H R 5158,28-Jun-1990,3:24 PM,On Agreeing to the Amendment,None,Failed,124,46,0,6,48,189,0,19,0,0,0,0,172,235,0,25
210,D,101,H R 5158,28-Jun-1990,3:51 PM,On Passage,"VETERANS AFFAIRS, HOUSING AND URBAN DEVELOPMENT INDEPENDENT AGENCIES APPROPRIATION FOR 1991",Passed,128,39,0,9,227,9,3,17,0,0,0,0,355,48,3,26
211,D,101,H R 4834,10-Jul-1990,3:40 PM,On Motion to Suspend the Rules and Pass,VISITOR CENTER FOR THE SALEM MARITIME NATIONAL HISTORIC SITE,Passed,156,8,0,12,237,0,0,19,0,0,0,0,393,8,0,31
212,D,101,S 666,10-Jul-1990,3:50 PM,On Motion to Suspend the Rules and Pass,TO ENROLL TWENTY INDIVIDUALS UNDER THE ALASKA NATIVE CLAIMS SETTLEMENT ACT,Passed,130,35,0,11,231,8,0,17,0,0,0,0,361,43,0,28
213,D,101,H R 988,10-Jul-1990,3:57 PM,On Motion to Suspend the Rules and Pass,CAMP W.G. WILLIAMS LAND EXCHANGE ACT OF 1989,Passed,163,1,0,12,238,0,0,18,0,0,0,0,401,1,0,30
214,D,101,H R 5064,10-Jul-1990,4:07 PM,On Motion to Suspend the Rules and Pass,DRUG ABUSE RESISTANCE EDUCATION (DARE) ACT OF 1990,Passed,148,13,0,15,240,0,0,16,0,0,0,0,388,13,0,31
215,D,101,QUORUM 215,11-Jul-1990,2:18 PM,Call of the House,None,Passed,0,0,173,3,0,0,244,12,0,0,0,0,0,0,417,15
216,D,101,H R 4329,11-Jul-1990,2:37 PM,On Agreeing to the Amendment,None,Agreed to,22,153,0,1,242,7,0,7,0,0,0,0,264,160,0,8
217,D,101,H R 4329,11-Jul-1990,3:30 PM,ON AGREEING TO THE AMENDMENTS,None,Agreed to,1,174,0,1,248,0,0,8,0,0,0,0,249,174,0,9
218,D,101,H R 4329,11-Jul-1990,4:59 PM,On Agreeing to the Amendment,None,Failed,145,29,0,2,5,243,0,8,0,0,0,0,150,272,0,10
219,D,101,H R 4329,11-Jul-1990,5:50 PM,ON AGREEING TO THE AMENDMENTS,None,Agreed to,172,2,0,2,55,193,0,8,0,0,0,0,227,195,0,10
220,D,101,H R 4329,11-Jul-1990,6:14 PM,On Motion to Recommit with Instructions,AMERICAN TECHNOLOGY PREEMINENCE ACT,Failed,158,15,0,3,7,242,0,7,0,0,0,0,165,257,0,10
221,D,101,H R 4329,11-Jul-1990,6:20 PM,On Passage,AMERICAN TECHNOLOGY PREEMINENCE ACT,Passed,83,90,0,3,244,3,0,9,0,0,0,0,327,93,0,12
222,D,101,H RES 430,12-Jul-1990,1:37 PM,On Agreeing to the Resolution,PROVIDING FOR THE CONSIDERATION OF H.R. 5115; TO IMPROVE EDUCATION IN THE UNITED STATES,Passed,25,150,0,1,242,1,0,13,0,0,0,0,267,151,0,14
223,D,101,H R 5229,12-Jul-1990,3:46 PM,On Agreeing to the Amendment,None,Agreed to,160,13,0,3,171,75,0,10,0,0,0,0,331,88,0,13
224,D,101,H R 5229,12-Jul-1990,4:41 PM,On Agreeing to the Amendment,None,Failed,112,62,0,2,21,221,0,14,0,0,0,0,133,283,0,16
225,D,101,H R 5229,12-Jul-1990,5:01 PM,On Passage,"TRANSPORTATION AND RELATED AGENCIES APPROPRIATION, 1991",Passed,142,31,0,3,243,0,0,13,0,0,0,0,385,31,0,16
226,D,101,H RES 427,12-Jul-1990,5:47 PM,On Agreeing to the Resolution,WAIVING CERTAIN POINTS OF ORDER AGAINST CONFERENCE REPORT ON S. 933.,Passed,115,56,0,5,240,2,0,14,0,0,0,0,355,58,0,19
227,D,101,S 933,12-Jul-1990,7:19 PM,RECOMMIT CONFERENCE REPORT WITH INSTRUCTIONS,AMERICANS WITH DISABILITIES ACT,Failed,124,42,0,10,56,182,0,18,0,0,0,0,180,224,0,28
228,D,101,S 933,12-Jul-1990,7:27 PM,On Agreeing to the Conference Report,AMERICANS WITH DISABILITIES ACT,Passed,145,23,0,8,232,5,0,19,0,0,0,0,377,28,0,27
229,D,101,H R 5241,13-Jul-1990,12:36 PM,On Agreeing to the Amendment,None,Agreed to,139,25,0,12,161,66,0,29,0,0,0,0,300,91,0,41
230,D,101,H R 5241,13-Jul-1990,12:55 PM,ON AGREEING TO THE AMENDMENT,None,Agreed to,156,3,0,17,223,4,0,29,0,0,0,0,379,7,0,46
231,D,101,H R 5241,13-Jul-1990,2:02 PM,On Agreeing to the Amendment,None,Failed,103,58,0,15,27,196,0,33,0,0,0,0,130,254,0,48
232,D,101,H R 5241,13-Jul-1990,2:32 PM,On Agreeing to the Amendment,None,Failed,128,29,0,19,50,172,0,34,0,0,0,0,178,201,0,53
233,D,101,H R 5241,13-Jul-1990,2:55 PM,On Passage,"TREASURY, POSTAL SERVICE, AND GENERAL GOVERNMENT APPROPRIATION, 1991",Passed,86,66,0,24,214,6,0,36,0,0,0,0,300,72,0,60
234,D,101,H R 4982,17-Jul-1990,10:38 AM,On Motion to Suspend the Rules and Pass,DWIGHT D. EISENHOWER MATHEMATICS AND SCIENCE EDUCATION AMENDMENTS ACT OF 1990,Passed,131,19,0,26,216,0,0,40,0,0,0,0,347,19,0,66
235,D,101,H RES 434,17-Jul-1990,12:11 PM,On Agreeing to the Resolution,PROVIDING FOR THE CONSIDERATION OF H.J. RES. 268; BALANCED BUDGET FOR THE U.S. GOVERNMENT,Passed,108,56,0,12,240,3,0,13,0,0,0,0,348,59,0,25
236,D,101,H J RES 268,17-Jul-1990,5:06 PM,On Agreeing to the Amendment,None,Failed,149,25,0,2,35,219,0,2,0,0,0,0,184,244,0,4
237,D,101,H J RES 268,17-Jul-1990,6:18 PM,On Agreeing to the Amendment,None,Agreed to,169,4,0,3,107,148,0,1,0,0,0,0,276,152,0,4
238,D,101,H J RES 268,17-Jul-1990,6:35 PM,On Passage,BALANCED BUDGET CONSTITUTIONAL AMENDMENT,Failed,169,5,0,2,110,145,0,1,0,0,0,0,279,150,0,3
239,D,101,H R 5268,18-Jul-1990,1:16 PM,On Agreeing to the Amendment,None,Failed,104,67,0,5,11,238,0,7,0,0,0,0,115,305,0,12
240,D,101,H R 5268,18-Jul-1990,1:46 PM,On Agreeing to the Amendment,None,Failed,102,67,0,7,13,233,0,10,0,0,0,0,115,300,0,17
241,D,101,H R 5268,18-Jul-1990,2:16 PM,On Agreeing to the Amendment,None,Failed,144,26,0,6,58,190,0,8,0,0,0,0,202,216,0,14
242,D,101,H R 5268,18-Jul-1990,3:00 PM,On Agreeing to the Amendment,None,Failed,156,11,2,7,19,203,21,13,0,0,0,0,175,214,23,20
243,D,101,H R 5268,18-Jul-1990,3:19 PM,On Passage,"RURAL DEVELOPMENT, AGRICULTURE, AND RELATED AGENCIES, APPROPRIATIONS, 1991",Passed,96,75,0,5,239,11,0,6,0,0,0,0,335,86,0,11
244,D,101,H RES 433,18-Jul-1990,4:30 PM,On Agreeing to the Resolution,"CONSIDERATION OF H.R. 5258, REQUIRING CONGRESS TO REPORT AND CONSIDER AND THE PRESIDENT TO SUBMIT, A BALANCED BUDGET",Passed,0,172,0,4,251,1,0,4,0,0,0,0,251,173,0,8
245,D,101,H R 5258,18-Jul-1990,6:16 PM,On Motion to Recommit with Instructions,"REQUIRING THE CONGRESS TO REPORT AND CONSIDER, AND THE PRESIDENT TO SUBMIT, A BALANCED BUDGET",Failed,173,0,0,3,8,244,0,4,0,0,0,0,181,244,0,7
246,D,101,H R 5258,18-Jul-1990,6:24 PM,On Passage,"REQUIRING THE CONGRESS TO REPORT AND CONSIDER, AND THE PRESIDENT TO SUBMIT, A BALANCED BUDGET",Passed,42,131,0,3,240,13,0,3,0,0,0,0,282,144,0,6
247,D,101,H R 5257,19-Jul-1990,1:34 PM,On Agreeing to the Amendment,None,Failed,112,50,0,14,3,243,0,10,0,0,0,0,115,293,0,24
248,D,101,H R 5257,19-Jul-1990,2:26 PM,On Agreeing to the Amendment,None,Failed,144,26,0,6,50,194,0,12,0,0,0,0,194,220,0,18
249,D,101,H R 5257,19-Jul-1990,3:34 PM,On Agreeing to the Amendment,None,Failed,83,86,0,7,2,247,0,7,0,0,0,0,85,333,0,14
250,D,101,H R 5257,19-Jul-1990,4:21 PM,On Agreeing to the Amendment,None,Failed,122,43,0,11,38,210,0,8,0,0,0,0,160,253,0,19
251,D,101,H R 5257,19-Jul-1990,4:48 PM,On Agreeing to the Amendment,None,Failed,92,74,0,10,112,138,0,6,0,0,0,0,204,212,0,16
252,D,101,H R 5257,19-Jul-1990,5:10 PM,On Passage,"LABOR, HEALTH AND HUMAN SERVICES, AND EDUCATION APPROPRIATION, 1991",Passed,108,58,0,10,251,0,0,5,0,0,0,0,359,58,0,15
253,D,101,H R 5115,20-Jul-1990,11:44 AM,On Agreeing to the Amendment,None,Agreed to,153,0,0,23,234,0,0,22,0,0,0,0,387,0,0,45
254,D,101,H R 5115,20-Jul-1990,12:47 PM,On Agreeing to the Amendment,None,Failed,101,53,0,22,21,211,0,24,0,0,0,0,122,264,0,46
255,D,101,H R 5115,20-Jul-1990,1:30 PM,On Agreeing to the Amendment,None,Agreed to,148,0,0,28,167,59,0,30,0,0,0,0,315,59,0,58
256,D,101,H R 5115,20-Jul-1990,2:02 PM,On Passage,EQUITY AND EXCELLENCE IN EDUCATION ACT OF 1990,Passed,123,25,0,28,227,0,0,29,0,0,0,0,350,25,0,57
257,D,101,H RES 439,23-Jul-1990,4:34 PM,On Agreeing to the Resolution,"PROVIDING FOR THE CONSIDERATION OF H.R. 3950, FOOD AND AGRICULTURAL RESOURCES ACT OF 1990",Passed,89,58,0,29,194,22,0,40,0,0,0,0,283,80,0,69
258,D,101,H R 3950,24-Jul-1990,1:38 PM,On Agreeing to the Amendment,None,Failed,70,102,0,4,80,169,1,6,0,0,0,0,150,271,1,10
259,D,101,H R 3950,24-Jul-1990,4:04 PM,On Agreeing to the Amendment,None,Failed,10,165,0,1,60,188,0,8,0,0,0,0,70,353,0,9
260,D,101,H R 3950,24-Jul-1990,5:35 PM,On Agreeing to the Amendment,None,Agreed to,150,22,0,4,157,92,0,7,0,0,0,0,307,114,0,11
261,D,101,MOTION,25-Jul-1990,10:23 AM,On Approving the Journal,None,Passed,58,104,0,14,230,7,0,19,0,0,0,0,288,111,0,33
262,D,101,H R 770,25-Jul-1990,12:52 PM,ON PRESIDENTIAL VETO,FAMILY AND MEDICAL LEAVE ACT OF 1989,Failed,38,138,0,0,194,57,0,5,0,0,0,0,232,195,0,5
263,D,101,H R 3950,25-Jul-1990,1:32 PM,On Agreeing to the Amendment,None,Agreed to,87,85,0,4,169,79,0,8,0,0,0,0,256,164,0,12
264,D,101,H R 3950,25-Jul-1990,3:33 PM,On Agreeing to the Amendment,None,Agreed to,152,24,0,0,67,186,0,3,0,0,0,0,219,210,0,3
265,D,101,H R 3950,25-Jul-1990,6:55 PM,On Agreeing to the Amendment,None,Failed,70,106,0,0,104,145,0,7,0,0,0,0,174,251,0,7
266,D,101,H R 3950,25-Jul-1990,7:50 PM,On Agreeing to the Amendment,None,Failed,66,109,1,0,93,154,1,8,0,0,0,0,159,263,2,8
267,D,101,QUORUM 267,26-Jul-1990,10:53 AM,Call of the House,None,Passed,0,0,166,10,0,0,232,24,0,0,0,0,0,0,398,34
268,D,101,H RES 442,26-Jul-1990,12:28 PM,On Agreeing to the Resolution,ON THE EXPULSION OF REPRESENTATIVE BARNEY FRANK,Failed,36,138,1,1,2,252,2,1,0,0,0,0,38,390,3,2
269,D,101,QUORUM 269,26-Jul-1990,2:16 PM,Call of the House,None,Passed,0,0,172,4,0,0,250,6,0,0,0,0,0,0,422,10
270,D,101,H RES 440,26-Jul-1990,3:07 PM,On Motion to Recommit with Instructions,IN THE MATTER OF REPRESENTATIVE BARNEY FRANK,Failed,129,46,1,0,12,241,2,2,0,0,0,0,141,287,3,2
271,D,101,H RES 440,26-Jul-1990,3:25 PM,On Agreeing to the Resolution,IN THE MATTER OF REPRESENTATIVE BARNEY FRANK,Passed,164,11,1,0,244,7,3,3,0,0,0,0,408,18,4,3
272,D,101,H R 5311,26-Jul-1990,5:37 PM,On Agreeing to the Amendment,None,Agreed to,162,12,0,2,135,111,1,9,0,0,0,0,297,123,1,11
273,D,101,H R 5311,26-Jul-1990,6:02 PM,On Agreeing to the Amendment,None,Failed,142,26,0,8,53,193,0,10,0,0,0,0,195,219,0,18
274,D,101,H R 5311,26-Jul-1990,6:33 PM,On Passage,"DISTRICT OF COLUMBIA APPROPRIATIONS, 1991",Passed,37,134,0,5,204,44,0,8,0,0,0,0,241,178,0,13
275,D,101,H RES 435,27-Jul-1990,11:06 AM,On Agreeing to the Resolution,PROVIDING FOR THE CONSIDERATION OF H.R. 1180; HOUSING AND COMMUNITY DEVELOPMENT ACT OF 1990,Passed,67,98,0,11,236,0,0,20,0,0,0,0,303,98,0,31
276,D,101,H R 3950,27-Jul-1990,12:03 PM,On Agreeing to the Amendment,None,Agreed to,84,84,0,8,150,91,0,15,0,0,0,0,234,175,0,23
277,D,101,H R 3950,27-Jul-1990,1:22 PM,On Agreeing to the Amendment,None,Agreed to,109,56,0,11,99,135,0,22,0,0,0,0,208,191,0,33
278,D,101,H R 3950,27-Jul-1990,2:34 PM,On Agreeing to the Amendment,None,Failed,95,68,0,13,83,147,0,26,0,0,0,0,178,215,0,39
279,D,101,H RES 441,30-Jul-1990,5:03 PM,On Ordering the Previous Question,"WAIVING CERTAIN POINTS OF ORDER DURING THE CONSIDERATION OF H.R. 5313, MILITARY CONSTRUCTION APPROPRIATION, FY 1991",Passed,67,92,0,17,222,1,0,33,0,0,0,0,289,93,0,50
280,D,101,H RES 441,30-Jul-1990,5:21 PM,On Agreeing to the Resolution,"WAIVING CERTAIN POINTS OF ORDER DURING THE CONSIDERATION OF H.R. 5313, MILITARY CONSTRUCTION APPROPRIATION, FY 1991",Passed,72,93,0,11,227,0,0,29,0,0,0,0,299,93,0,40
281,D,101,H R 5313,30-Jul-1990,7:45 PM,On Agreeing to the Amendment,None,Failed,112,56,0,8,52,183,0,21,0,0,0,0,164,239,0,29
282,D,101,H R 5313,30-Jul-1990,8:17 PM,On Agreeing to the Amendment,None,Failed,120,40,0,16,60,174,0,22,0,0,0,0,180,214,0,38
283,D,101,H R 5313,30-Jul-1990,8:37 PM,On Passage,"MILITARY CONSTRUCTION APPROPRIATION, FY 1991",Passed,107,54,0,15,205,28,0,23,0,0,0,0,312,82,0,38
284,D,101,H RES 443,31-Jul-1990,11:40 AM,On Agreeing to the Resolution,PPROVIDING FOR THE CONSIDERATION OF H.R. 5355; TO INCREASE THE STATUTORY LIMIT ON THE PUBLIC DEBT,Passed,30,143,0,3,244,5,0,7,0,0,0,0,274,148,0,10
285,D,101,QUORUM 285,31-Jul-1990,1:23 PM,Call of the House,None,Passed,0,0,174,2,0,0,247,9,0,0,0,0,0,0,421,11
286,D,101,H R 5355,31-Jul-1990,1:31 PM,On Agreeing to the Amendment,None,Agreed to,164,10,0,2,249,5,0,2,0,0,0,0,413,15,0,4
287,D,101,H R 5355,31-Jul-1990,1:49 PM,On Passage,TO INCREASE THE STATUTORY LIMIT ON THE PUBLIC DEBT,Passed,46,129,0,1,175,76,0,5,0,0,0,0,221,205,0,6
288,D,101,H R 5401,31-Jul-1990,3:02 PM,On Motion to Suspend the Rules and Pass,BANKING LAW ENFORCEMENT ACT OF 1990,Passed,174,1,0,1,250,3,0,3,0,0,0,0,424,4,0,4
289,D,101,QUORUM 289,31-Jul-1990,6:57 PM,Call of the House,None,Passed,0,0,172,4,0,0,239,17,0,0,0,0,0,0,411,21
290,D,101,H R 1180,31-Jul-1990,7:08 PM,On Agreeing to the Amendment,None,Agreed to,171,1,0,4,247,1,0,8,0,0,0,0,418,2,0,12
291,D,101,H R 1180,31-Jul-1990,8:14 PM,On Agreeing to the Amendment,None,Failed,22,147,0,7,178,64,0,14,0,0,0,0,200,211,0,21
292,D,101,H R 1180,31-Jul-1990,9:34 PM,On Agreeing to the Amendment,None,Agreed to,168,0,0,8,232,12,0,12,0,0,0,0,400,12,0,20
293,D,101,H R 1180,1-Aug-1990,12:11 PM,On Agreeing to the Amendment,None,Failed,62,107,0,7,0,247,0,9,0,0,0,0,62,354,0,16
294,D,101,H R 1180,1-Aug-1990,12:54 PM,On Passage,HOUSING AND COMMUNITY DEVELOPMENT ACT OF 1990,Passed,132,42,0,2,246,1,0,9,0,0,0,0,378,43,0,11
295,D,101,H R 3950,1-Aug-1990,4:40 PM,On Agreeing to the Amendment,None,Failed,81,91,1,3,90,159,0,7,0,0,0,0,171,250,1,10
296,D,101,H R 3950,1-Aug-1990,5:01 PM,On Agreeing to the Amendment,None,Agreed to,150,21,1,4,225,24,0,7,0,0,0,0,375,45,1,11
297,D,101,H R 3950,1-Aug-1990,6:54 PM,ON AGREEING TO THE AMENDMENT,None,Agreed to,42,131,0,3,192,56,0,8,0,0,0,0,234,187,0,11
298,D,101,H R 3950,1-Aug-1990,8:41 PM,On Agreeing to the Amendment,None,Failed,83,89,0,4,0,247,0,9,0,0,0,0,83,336,0,13
299,D,101,H R 3950,1-Aug-1990,9:54 PM,On Passage,FOOD AND AGRICULTURAL RESOURCES ACT OF 1990,Passed,117,54,0,5,210,37,0,9,0,0,0,0,327,91,0,14
300,D,101,MOTION,2-Aug-1990,10:26 AM,On Approving the Journal,None,Passed,59,103,0,14,230,5,1,20,0,0,0,0,289,108,1,34
301,D,101,H R 5170,2-Aug-1990,1:46 PM,On Agreeing to the Amendment,None,Failed,40,134,0,2,131,118,0,7,0,0,0,0,171,252,0,9
302,D,101,H R 5170,2-Aug-1990,2:11 PM,On Passage,AVIATION SAFETY AND CAPACITY EXPANSION ACT OF 1990,Passed,169,5,0,2,236,10,0,10,0,0,0,0,405,15,0,12
303,D,101,H R 5431,2-Aug-1990,2:52 PM,On Passage,TO IMPOSE SANCTIONS ON IRAQ,Passed,173,0,0,3,243,0,1,12,0,0,0,0,416,0,1,15
304,D,101,H RES 449,2-Aug-1990,4:48 PM,ON ORDERING THE PREVIOUS QUESTION,"PROVIDING FOR CONSIDERATION OF H.R. 4000, CIVIL RIGHTS ACT 1990",Passed,2,171,0,3,245,0,2,9,0,0,0,0,247,171,2,12
305,D,101,H RES 449,2-Aug-1990,5:07 PM,On Agreeing to the Resolution,"PROVIDING FOR CONSIDERATION OF H.R. 4000, CIVIL RIGHTS ACT 1990",Passed,3,170,0,3,243,5,1,7,0,0,0,0,246,175,1,10
306,D,101,H R 4000,2-Aug-1990,9:22 PM,On Agreeing to the Amendment,None,Agreed to,148,23,0,5,249,1,0,6,0,0,0,0,397,24,0,11
307,D,101,H R 4000,2-Aug-1990,10:11 PM,On Agreeing to the Amendment,None,Agreed to,80,93,0,3,209,41,0,6,0,0,0,0,289,134,0,9
308,D,101,MOTION,3-Aug-1990,10:27 AM,On Approving the Journal,None,Passed,45,119,0,12,225,7,0,24,0,0,0,0,270,126,0,36
309,D,101,H R 4000,3-Aug-1990,1:48 PM,On Agreeing to the Amendment,None,Failed,160,14,0,2,28,224,0,4,0,0,0,0,188,238,0,6
310,D,101,H R 4000,3-Aug-1990,2:11 PM,On Passage,CIVIL RIGHTS ACT OF 1990,Passed,32,142,0,2,240,12,0,4,0,0,0,0,272,154,0,6
311,D,101,H RES 448,3-Aug-1990,2:43 PM,On Ordering the Previous Question,PROVIDING FOR THE CONSIDERATION OF H.R. 5350; TO PROVIDE FOR A TEMPORARY INCREASE IN THE PUBLIC DEBT LIMIT,Passed,41,128,0,7,243,3,0,10,0,0,0,0,284,131,0,17
312,D,101,H RES 448,3-Aug-1990,3:01 PM,On Agreeing to the Resolution,PROVIDING FOR THE CONSIDERATION OF H.R. 5350; TO PROVIDE FOR A TEMPORARY INCREASE IN THE PUBLIC DEBT LIMIT,Passed,46,123,0,7,239,3,0,14,0,0,0,0,285,126,0,21
313,D,101,H R 5350,3-Aug-1990,3:30 PM,On Passage,TO PROVIDE FOR A TEMPORARY INCREASE IN THE PUBLIC DEBT LIMIT,Passed,46,126,0,4,201,46,0,9,0,0,0,0,247,172,0,13
314,D,101,H RES 453,3-Aug-1990,5:06 PM,On Agreeing to the Resolution,"CONSIDERATION OF H.R. 5400, CAMPAIGN COST REDUCTION AND REFORM ACT OF 1990",Passed,0,171,0,5,232,14,0,10,0,0,0,0,232,185,0,15
315,D,101,ADJOURN,3-Aug-1990,5:26 PM,ON MOTION TO ADJOURN,None,Failed,126,38,0,12,3,237,0,16,0,0,0,0,129,275,0,28
316,D,101,H R 5400,3-Aug-1990,10:43 PM,On Agreeing to the Amendment,None,Failed,166,1,1,8,3,240,0,13,0,0,0,0,169,241,1,21
317,D,101,H R 5400,3-Aug-1990,11:04 PM,On Agreeing to the Amendment,None,Failed,11,9,145,11,111,119,13,13,0,0,0,0,122,128,158,24
318,D,101,H R 5400,3-Aug-1990,11:21 PM,On Passage,CAMPAIGN COST REDUCTION ACT 1990,Passed,15,152,0,9,240,3,0,13,0,0,0,0,255,155,0,22
319,D,101,H RES 452,3-Aug-1990,11:59 PM,On Ordering the Previous Question,"WAIVING CERTAIN POINTS OF ORDER AGAINST CONFERENCE REPORT ON H.R. 1465, OIL POLLUTION PREVENTION, RESPONSE, LIABILITY, AND COMPENSATION ACT OF 1989",Passed,76,79,0,21,205,3,0,48,0,0,0,0,281,82,0,69
320,D,101,H R 1465,3-Aug-1990,11:59 PM,On Agreeing to the Conference Report,"OIL POLLUTION PREVENTION, RESPONSE, LIABILITY, AND COMPENSATION ACT",Passed,155,0,0,21,205,0,0,51,0,0,0,0,360,0,0,72
321,D,101,H R 4739,11-Sep-1990,4:45 PM,On Agreeing to the Amendment,None,Agreed to,169,1,0,6,244,0,0,12,0,0,0,0,413,1,0,18
322,D,101,H R 4739,11-Sep-1990,6:18 PM,On Agreeing to the Amendment,None,Agreed to,163,8,0,5,67,180,0,9,0,0,0,0,230,188,0,14
323,D,101,H RES 461,12-Sep-1990,12:04 PM,On Agreeing to the Resolution,PROVIDING FOR THE FURTHER CONSIDERATION OF H.R. 4739; NATIONAL DEFENSE AUTHORIZATION ACT FOR FISCAL YEAR 1991,Passed,105,59,0,12,222,6,1,27,0,0,0,0,327,65,1,39
324,D,101,H R 4739,12-Sep-1990,4:54 PM,On Agreeing to the Amendment,None,Failed,159,15,0,2,15,234,0,7,0,0,0,0,174,249,0,9
325,D,101,H R 4739,12-Sep-1990,5:32 PM,On Agreeing to the Amendment,None,Agreed to,141,33,0,2,229,20,1,6,0,0,0,0,370,53,1,8
326,D,101,H R 4739,12-Sep-1990,6:06 PM,On Agreeing to the Amendment,None,Failed,13,160,0,3,144,105,0,7,0,0,0,0,157,265,0,10
327,D,101,H R 4739,12-Sep-1990,6:42 PM,On Agreeing to the Amendment,None,Agreed to,45,127,0,4,242,7,0,7,0,0,0,0,287,134,0,11
328,D,101,MOTION,13-Sep-1990,10:31 AM,On Approving the Journal,None,Passed,60,98,1,17,221,5,0,30,0,0,0,0,281,103,1,47
329,D,101,QUORUM 329,13-Sep-1990,2:29 PM,Call of the House,None,Passed,0,0,167,9,0,0,239,17,0,0,0,0,0,0,406,26
330,D,101,H R 4330,13-Sep-1990,2:44 PM,On Agreeing to the Amendment,None,Failed,166,3,0,7,34,209,0,13,0,0,0,0,200,212,0,20
331,D,101,S 2088,13-Sep-1990,5:12 PM,On Agreeing to the Conference Report,ENERGY POLICY AND CONSERVATION ACT AMENDMENTS OF 1990,Passed,162,0,0,14,229,0,0,27,0,0,0,0,391,0,0,41
332,D,101,S 3033,17-Sep-1990,5:32 PM,On Motion to Suspend the Rules and Pass,FREE MAILING FOR TROOPS IN SAUDI ARABIA,Passed,157,0,0,19,211,0,0,45,0,0,0,0,368,0,0,64
333,D,101,H R 5611,17-Sep-1990,5:52 PM,On Motion to Recommit with Instructions,FREE MAILING PRIVILEGES FOR MEMBERS OF THE ARMED FORCES PARTICIPATING IN TEMPORARY OVERSEAS DEPLOYMENT IN ARDUOUS CIRCUMSTANCES,Passed,152,5,0,19,75,137,0,44,0,0,0,0,227,142,0,63
334,D,101,H RES 464,18-Sep-1990,12:30 PM,On Agreeing to the Resolution,PROVIDING FOR AGREEING TO SENATE AMENDMENTS TO THE BILL H.R. 4328; CUSTOMS AND TRADE AGENCIES FISCAL YEARS 1991 AND 1992 AUTHORIZATIONS,Passed,54,116,0,6,239,5,0,12,0,0,0,0,293,121,0,18
335,D,101,H R 4328,18-Sep-1990,3:19 PM,AGREE TO SENATE AMENDMENTS,CUSTOMS AND TRADE AGENCIES FY 1991 AND 1992 AUTHORIZATIONS,Passed,71,101,0,4,200,48,0,8,0,0,0,0,271,149,0,12
336,D,101,H R 4739,18-Sep-1990,4:38 PM,On Agreeing to the Amendment,None,Failed,74,99,0,3,9,239,0,8,0,0,0,0,83,338,0,11
337,D,101,H R 4739,18-Sep-1990,5:22 PM,On Agreeing to the Amendment,None,Failed,5,168,0,3,130,118,0,8,0,0,0,0,135,286,0,11
338,D,101,H R 4739,18-Sep-1990,5:56 PM,On Agreeing to the Amendment,None,Failed,127,45,0,4,14,228,0,14,0,0,0,0,141,273,0,18
339,D,101,H R 4739,18-Sep-1990,6:30 PM,On Agreeing to the Amendment,None,Agreed to,20,150,0,6,205,39,0,12,0,0,0,0,225,189,0,18
340,D,101,H R 4739,18-Sep-1990,9:37 PM,On Agreeing to the Amendment,None,Failed,149,23,0,4,12,230,0,14,0,0,0,0,161,253,0,18
341,D,101,H R 4739,18-Sep-1990,9:54 PM,On Agreeing to the Amendment,None,Agreed to,56,117,0,3,232,11,0,13,0,0,0,0,288,128,0,16
342,D,101,H R 4739,18-Sep-1990,10:05 PM,On Agreeing to the Amendment,None,Failed,35,139,0,2,165,77,0,14,0,0,0,0,200,216,0,16
343,D,101,H R 4739,18-Sep-1990,10:12 PM,On Agreeing to the Amendment,None,Agreed to,36,138,0,2,198,44,0,14,0,0,0,0,234,182,0,16
344,D,101,H R 4739,18-Sep-1990,10:19 PM,On Agreeing to the Amendment,None,Agreed to,113,61,0,2,221,22,0,13,0,0,0,0,334,83,0,15
345,D,101,H R 4739,18-Sep-1990,10:27 PM,On Agreeing to the Amendment,None,Failed,27,147,0,2,126,117,0,13,0,0,0,0,153,264,0,15
346,D,101,H R 4739,18-Sep-1990,10:33 PM,On Agreeing to the Amendment,None,Failed,164,9,1,2,25,219,0,12,0,0,0,0,189,228,1,14
347,D,101,H R 4739,18-Sep-1990,10:44 PM,On Agreeing to the Amendment,None,Failed,43,131,0,2,90,153,0,13,0,0,0,0,133,284,0,15
348,D,101,MOTION,19-Sep-1990,10:24 AM,On Approving the Journal,None,Passed,54,112,0,10,224,3,0,29,0,0,0,0,278,115,0,39
349,D,101,H R 4739,19-Sep-1990,11:10 AM,On Agreeing to the Amendment,None,Agreed to,126,45,0,5,247,0,0,9,0,0,0,0,373,45,0,14
350,D,101,H R 4739,19-Sep-1990,12:16 PM,On Agreeing to the Amendment,None,Agreed to,165,8,0,3,248,2,0,6,0,0,0,0,413,10,0,9
351,D,101,H R 4739,19-Sep-1990,1:39 PM,On Motion to Recommit with Instructions,NATIONAL DEFENSE AUTHORIZATION ACT FOR FISCAL YEAR 1991,Failed,156,12,0,8,0,242,0,14,0,0,0,0,156,254,0,22
352,D,101,H R 4739,19-Sep-1990,1:51 PM,On Passage,NATIONAL DEFENSE AUTHORIZATION ACT FOR FISCAL YEAR 1991,Passed,33,135,0,8,223,20,0,13,0,0,0,0,256,155,0,21
353,D,101,H R 3533,24-Sep-1990,4:19 PM,ON ORDERING A SECOND,EARTHQUAKE HAZARDS REDUCTION ACT OF 1977 AMENDMENTS ACT,Passed,13,149,0,14,225,2,0,29,0,0,0,0,238,151,0,43
354,D,101,H RES 470,24-Sep-1990,5:34 PM,ON ORDERING A SECOND,METAL CASTING COMPETITIVENESS RESEARCH,Passed,12,159,0,5,237,1,0,18,0,0,0,0,249,160,0,23
355,D,101,H R 486,24-Sep-1990,6:30 PM,ON ORDERING A SECOND,DEFENSE PRODUCTION ACT AMENDMENTS OF 1990,Passed,8,159,0,9,235,0,0,21,0,0,0,0,243,159,0,30
356,D,101,H RES 466,24-Sep-1990,7:40 PM,On Ordering the Previous Question,PROVIDING FOR THE CONSIDERATION OF H.R. 4793; SMALL BUSINESS REAUTHORIZATION AND AMENDMENTS ACT OF 1990,Passed,162,9,0,5,238,0,0,18,0,0,0,0,400,9,0,23
357,D,101,H RES 466,24-Sep-1990,7:44 PM,On Agreeing to the Resolution,PROVIDING FOR THE CONSIDERATION OF H.R. 4793; SMALL BUSINESS REAUTHORIZATION AND AMENDMENTS ACT OF 1990,Passed,164,7,0,5,242,0,0,14,0,0,0,0,406,7,0,19
358,D,101,H RES 469,24-Sep-1990,7:50 PM,On Ordering the Previous Question,PROVIDING FOR THE CONSIDERATION OF H.R. 5314; WATER RESOURCES DEVELOPMENT ACT,Passed,138,33,0,5,240,0,0,16,0,0,0,0,378,33,0,21
359,D,101,H RES 469,24-Sep-1990,7:53 PM,On Agreeing to the Resolution,PROVIDING FOR THE CONSIDERATION OF H.R. 5314; WATER RESOURCES DEVELOPMENT ACT,Passed,134,35,0,7,242,0,0,14,0,0,0,0,376,35,0,21
360,D,101,H RES 468,24-Sep-1990,7:57 PM,On Ordering the Previous Question,PROVIDING FOR THE CONSIDERATION OF H.R. 4450; COASTAL ZONE ACT REAUTHORIZATION AMENDMENTS OF 1990,Passed,130,41,0,5,241,1,0,14,0,0,0,0,371,42,0,19
361,D,101,H RES 468,24-Sep-1990,8:00 PM,On Agreeing to the Resolution,PROVIDING FOR THE CONSIDERATION OF H.R. 4450; COASTAL ZONE ACT REAUTHORIZATION AMENDMENTS OF 1990,Passed,127,44,0,5,243,0,0,13,0,0,0,0,370,44,0,18
362,D,101,H R 4279,24-Sep-1990,8:06 PM,On Motion to Suspend the Rules and Pass,CASH MANAGEMENT IMPROVEMENT ACT OF 1990,Passed,170,0,0,6,240,4,0,12,0,0,0,0,410,4,0,18
363,D,101,S 535,24-Sep-1990,8:09 PM,On Motion to Suspend the Rules and Pass,FEDERAL CIVIL PENALTIES ADJUSTMENT ACT OF 1990,Passed,165,5,0,6,242,0,0,14,0,0,0,0,407,5,0,20
364,D,101,S 2075,24-Sep-1990,8:13 PM,On Motion to Suspend the Rules and Pass,INDIAN ENVIRONMENTAL REGULATORY ENHANCEMENT ACT OF 1990,Passed,83,88,0,5,233,11,0,12,0,0,0,0,316,99,0,17
365,D,101,H R 4323,24-Sep-1990,8:17 PM,On Motion to Suspend the Rules and Pass,GREAT LAKES WATER QUALITY IMPROVEMENT ACT OF 1990,Passed,133,37,0,6,243,0,0,13,0,0,0,0,376,37,0,19
366,D,101,H R 5482,24-Sep-1990,8:21 PM,On Motion to Suspend the Rules and Pass,DISTRICT OF COLUMBIA REVENUE BOND ACT OF 1990,Passed,135,36,0,5,236,8,0,12,0,0,0,0,371,44,0,17
367,D,101,H R 5254,24-Sep-1990,8:24 PM,On Motion to Suspend the Rules and Pass,FISH AND WILDLIFE CONSERVATION ACT AUTHORIZATION,Passed,165,6,0,5,243,1,0,12,0,0,0,0,408,7,0,17
368,D,101,H R 5255,24-Sep-1990,8:29 PM,On Motion to Suspend the Rules and Pass,FISH AND WILDLIFE FOUNDATION ESTABLISHMENT ACT AMENDMENTS OF 1990,Passed,130,41,0,5,239,5,0,12,0,0,0,0,369,46,0,17
369,D,101,H R 3533,24-Sep-1990,8:33 PM,On Motion to Suspend the Rules and Pass,EARTHQUAKE HAZARDS REDUCTION ACT OF 1977 AMENDMENTS ACT,Passed,57,114,0,5,226,18,0,12,0,0,0,0,283,132,0,17
370,D,101,H RES 470,24-Sep-1990,8:37 PM,SUSPEND THE RULES AND AGREE,METAL CASTING COMPETITIVENESS RESEARCH,Passed,92,79,0,5,239,5,0,12,0,0,0,0,331,84,0,17
371,D,101,H R 486,24-Sep-1990,8:42 PM,On Motion to Suspend the Rules and Pass,DEFENSE PRODUCTION ACT AMENDMENTS OF 1990,Passed,58,113,0,5,237,6,0,13,0,0,0,0,295,119,0,18
372,D,101,MOTION,25-Sep-1990,10:24 AM,On Approving the Journal,None,Passed,48,118,0,10,218,7,0,31,0,0,0,0,266,125,0,41
373,D,101,H RES 473,25-Sep-1990,12:56 PM,On Ordering the Previous Question,PROVIDING FOR THE CONSIDERATION OF H.R. 5269; TO CONTROL CRIME,Passed,1,173,0,2,213,36,0,7,0,0,0,0,214,209,0,9
374,D,101,H RES 473,25-Sep-1990,1:15 PM,TABLE MOTION TO RECONSIDER,PROVIDING FOR THE CONSIDERATION OF H.R. 5269; TO CONTROL CRIME,Passed,0,175,0,1,244,5,0,7,0,0,0,0,244,180,0,8
375,D,101,H RES 473,25-Sep-1990,1:34 PM,On Agreeing to the Amendment,None,Agreed to,29,146,0,1,193,56,0,7,0,0,0,0,222,202,0,8
376,D,101,H RES 473,25-Sep-1990,1:53 PM,ON AGREEING TO THE RESOLUTION (AS AMENDED),PROVIDING FOR THE CONSIDERATION OF H.R. 5269; TO CONTROL CRIME,Failed,0,174,0,2,166,84,0,6,0,0,0,0,166,258,0,8
377,D,101,QUORUM 377,25-Sep-1990,2:39 PM,Call of the House,None,Passed,0,0,171,5,0,0,239,17,0,0,0,0,0,0,410,22
378,D,101,H R 4793,25-Sep-1990,2:49 PM,On Agreeing to the Amendment,None,Failed,120,52,0,4,30,217,0,9,0,0,0,0,150,269,0,13
379,D,101,H R 4793,25-Sep-1990,3:23 PM,On Agreeing to the Amendment,None,Failed,20,155,0,1,1,244,0,11,0,0,0,0,21,399,0,12
380,D,101,H R 4793,25-Sep-1990,3:46 PM,On Passage,SMALL BUSINESS REAUTHORIZATION AND AMENDMENTS ACT OF 1990,Passed,149,26,0,1,249,0,0,7,0,0,0,0,398,26,0,8
381,D,101,H R 4559,25-Sep-1990,4:15 PM,ON ORDERING A SECOND,None,Passed,171,1,0,4,236,0,0,20,0,0,0,0,407,1,0,24
382,D,101,H R 4019,25-Sep-1990,5:00 PM,ON ORDERING A SECOND,None,Passed,118,53,0,5,224,0,0,32,0,0,0,0,342,53,0,37
383,D,101,H R 4559,25-Sep-1990,5:54 PM,On Motion to Suspend the Rules and Pass,RED ROCK CANYON CONSERVATION AREA,Passed,139,36,0,1,243,2,0,11,0,0,0,0,382,38,0,12
384,D,101,MOTION,26-Sep-1990,10:26 AM,On Approving the Journal,None,Passed,41,122,0,13,234,4,0,18,0,0,0,0,275,126,0,31
385,D,101,H R 5400,26-Sep-1990,1:19 PM,MOTION TO INSTRUCT CONFEREES,CAMPAIGN COST REDUCTION AND REFORM ACT OF 1990,Failed,169,1,0,6,25,224,0,7,0,0,0,0,194,225,0,13
386,D,101,H R 4450,26-Sep-1990,3:15 PM,On Passage,COASTAL ZONE ACT REAUTHORIZATION AMENDMENTS OF 1990,Passed,141,31,0,4,250,1,0,5,0,0,0,0,391,32,0,9
387,D,101,H R 5314,26-Sep-1990,7:21 PM,On Passage,WATER RESOURCES DEVELOPMENT ACT,Passed,116,51,0,9,234,4,0,18,0,0,0,0,350,55,0,27
388,D,101,MOTION,27-Sep-1990,10:23 AM,On Approving the Journal,None,Passed,46,111,0,19,223,4,0,29,0,0,0,0,269,115,0,48
389,D,101,H R 2039,27-Sep-1990,12:58 PM,On Passage,JOB TRAINING PARTNERSHIP ACT AMENDMENTS OF 1990,Passed,169,1,0,6,247,0,0,9,0,0,0,0,416,1,0,15
390,D,101,QUORUM 390,27-Sep-1990,4:58 PM,Call of the House,None,Passed,0,0,157,19,0,0,220,36,0,0,0,0,0,0,377,55
391,D,101,H R 5316,27-Sep-1990,5:22 PM,On Motion to Suspend the Rules and Pass,FEDERAL JUDGESHIP ACT OF 1990,Passed,155,10,0,11,232,8,1,16,0,0,0,0,387,18,1,27
392,D,101,MOTION,28-Sep-1990,10:29 AM,On Approving the Journal,None,Passed,43,78,0,55,196,5,0,56,0,0,0,0,239,83,0,111
393,D,101,H J RES 655,30-Sep-1990,5:31 PM,On Passage,"CONTINUING APPROPRIATIONS, FY 1995",Passed,136,37,0,3,246,4,0,7,0,0,0,0,382,41,0,10
394,D,101,H J RES 658,1-Oct-1990,6:30 PM,On Motion to Suspend the Rules and Pass,SUPPORT ACTIONS THE PRESIDENT HAS TAKEN WITH RESPECT TO IRAQI AGGRESSION AGAINST KUWAIT,Passed,164,0,0,12,216,29,1,11,0,0,0,0,380,29,1,23
395,D,101,H J RES 418,1-Oct-1990,6:40 PM,On Motion to Suspend the Rules and Pass,PROTECTING ANTARCTICA AS A GLOBAL ECOLOGICAL COMMONS,Passed,154,10,0,12,244,1,0,12,0,0,0,0,398,11,0,24
396,D,101,H CON RES 329,1-Oct-1990,6:48 PM,SUSPEND THE RULES AND AGREE,REGARDING COUNTRIES WHICH VIOLATE THE MORATORIUM ON COMMERCIAL WHALING,Passed,166,0,0,10,246,0,0,11,0,0,0,0,412,0,0,21
397,D,101,H R 3954,1-Oct-1990,6:55 PM,On Motion to Suspend the Rules and Pass,ESTABLISHING A PEACE CORPS MEMORIAL,Passed,165,0,0,11,244,0,0,13,0,0,0,0,409,0,0,24
398,D,101,H RES 484,2-Oct-1990,1:04 PM,On Agreeing to the Resolution,PROVIDING FOR THE CONSIDERATION OF H.R. 4300; FAMILY UNITY AND EMPLOYMENT OPPORTUNITY IMMIGRATION ACT OF 1990,Passed,16,152,0,8,229,13,0,15,0,0,0,0,245,165,0,23
399,D,101,H R 4300,2-Oct-1990,3:28 PM,On Agreeing to the Amendment,None,Failed,104,56,0,16,39,210,0,8,0,0,0,0,143,266,0,24
400,D,101,H R 4300,2-Oct-1990,4:15 PM,On Agreeing to the Amendment,None,Failed,6,164,0,6,188,65,0,4,0,0,0,0,194,229,0,10
401,D,101,H R 4300,2-Oct-1990,5:50 PM,On Agreeing to the Amendment,None,Failed,40,130,0,6,13,238,0,6,0,0,0,0,53,368,0,12
402,D,101,H R 4300,2-Oct-1990,6:44 PM,On Agreeing to the Amendment,None,Failed,118,49,0,9,13,236,0,8,0,0,0,0,131,285,0,17
403,D,101,H R 4300,3-Oct-1990,11:16 AM,On Agreeing to the Amendment,None,Failed,73,97,0,6,26,222,0,9,0,0,0,0,99,319,0,15
404,D,101,H R 4300,3-Oct-1990,12:01 PM,On Agreeing to the Amendment,None,Failed,113,58,0,5,52,199,0,6,0,0,0,0,165,257,0,11
405,D,101,H R 4300,3-Oct-1990,12:22 PM,On Motion to Recommit,FAMILY UNITY AND EMPLOYMENT OPPORTUNITY IMMIGRATION ACT,Failed,137,35,0,4,39,213,0,5,0,0,0,0,176,248,0,9
406,D,101,H R 4300,3-Oct-1990,12:32 PM,On Passage,FAMILY UNITY AND EMPLOYMENT OPPORTUNITY IMMIGRATION ACT,Passed,45,127,0,4,186,65,0,6,0,0,0,0,231,192,0,10
407,D,101,S 1511,3-Oct-1990,12:52 PM,On Motion to Suspend the Rules and Pass,OLDER WORKERS BENEFIT PROTECTION ACT,Passed,153,17,0,6,253,0,0,4,0,0,0,0,406,17,0,10
408,D,101,H R 5269,3-Oct-1990,5:09 PM,On Agreeing to the Amendment,None,Agreed to,130,39,0,7,106,150,0,1,0,0,0,0,236,189,0,8
409,D,101,H R 5269,3-Oct-1990,5:20 PM,On Agreeing to the Amendment,None,Agreed to,163,0,0,13,252,3,0,2,0,0,0,0,415,3,0,15
410,D,101,H R 5269,3-Oct-1990,6:06 PM,On Agreeing to the Amendment,None,Failed,6,163,0,7,97,159,0,1,0,0,0,0,103,322,0,8
411,D,101,MOTION,4-Oct-1990,11:29 AM,On Approving the Journal,None,Passed,54,115,0,7,239,6,0,12,0,0,0,0,293,121,0,19
412,D,101,H R 5269,4-Oct-1990,12:52 PM,On Agreeing to the Amendment,None,Failed,10,163,1,2,98,156,0,3,0,0,0,0,108,319,1,5
413,D,101,H R 5269,4-Oct-1990,1:41 PM,On Agreeing to the Amendment,None,Agreed to,165,9,1,1,106,150,0,1,0,0,0,0,271,159,1,2
414,D,101,H R 5269,4-Oct-1990,2:29 PM,On Agreeing to the Amendment,None,Agreed to,165,9,1,1,130,124,0,3,0,0,0,0,295,133,1,4
415,D,101,H R 5269,4-Oct-1990,3:16 PM,On Agreeing to the Amendment,None,Agreed to,162,13,0,1,147,107,0,3,0,0,0,0,309,120,0,4
416,D,101,H R 5269,4-Oct-1990,4:04 PM,On Agreeing to the Amendment,None,Agreed to,141,34,0,1,116,138,0,3,0,0,0,0,257,172,0,4
417,D,101,H R 5269,4-Oct-1990,5:06 PM,On Agreeing to the Amendment,None,Failed,17,156,1,2,172,83,0,2,0,0,0,0,189,239,1,4
418,D,101,H R 5269,4-Oct-1990,5:53 PM,On Agreeing to the Amendment,None,Agreed to,167,7,1,1,118,139,0,0,0,0,0,0,285,146,1,1
419,D,101,H R 5269,4-Oct-1990,6:30 PM,On Agreeing to the Amendment,None,Agreed to,61,113,0,2,165,91,0,1,0,0,0,0,226,204,0,3
420,D,101,H RES 488,4-Oct-1990,10:09 PM,On Agreeing to the Resolution,"PROVIDING FOR THE CONSIDERATION OF THE CONFERENCE REPORT ON H. CON. RES. 310, CONGRESSIONAL BUDGET FOR U.S. GOVERNMENT FOR FISCAL YEARS 1991, 1992, 1993, 1994, AND 1995",Passed,125,51,0,0,214,43,0,0,0,0,0,0,339,94,0,0
421,D,101,H CON RES 310,4-Oct-1990,11:59 PM,On Agreeing to the Conference Report,"CONGRESSIONAL BUDGET FOR U.S. GOVERNMENT FOR FY 1991, 1992, 1993, 1994, AND 1995",Failed,71,105,0,0,108,149,0,1,0,0,0,0,179,254,0,1
422,D,101,H R 5269,5-Oct-1990,11:07 AM,On Agreeing to the Amendment,None,Agreed to,19,150,1,6,199,36,0,22,0,0,0,0,218,186,1,28
423,D,101,H R 5269,5-Oct-1990,12:02 PM,On Agreeing to the Amendment,None,Failed,153,17,1,5,51,199,0,7,0,0,0,0,204,216,1,12
424,D,101,H R 5269,5-Oct-1990,1:32 PM,On Agreeing to the Amendment,None,Agreed to,167,4,0,5,98,153,0,6,0,0,0,0,265,157,0,11
425,D,101,H R 5269,5-Oct-1990,2:08 PM,On Agreeing to the Amendment,None,Agreed to,49,121,0,6,213,39,0,5,0,0,0,0,262,160,0,11
426,D,101,H R 5269,5-Oct-1990,3:26 PM,On Agreeing to the Amendment,None,Agreed to,88,83,0,5,245,3,0,9,0,0,0,0,333,86,0,14
427,D,101,H R 5269,5-Oct-1990,3:55 PM,On Passage,COMPREHENSIVE CRIME CONTROL ACT OF 1990,Passed,170,1,0,5,198,54,0,5,0,0,0,0,368,55,0,10
428,D,101,H R 4739,5-Oct-1990,4:48 PM,ON CLOSING PORTIONS OFCONFERENCE,NATIONAL DEFENSE AUTHORIZATION ACT FOR FISCAL YEAR 1991,Passed,168,0,0,8,242,2,0,13,0,0,0,0,410,2,0,21
429,D,101,S 1430,5-Oct-1990,5:39 PM,MOTION TO INSTRUCT CONFEREES,NATIONAL SERVICE ACT OF 1990,Passed,168,0,0,8,244,0,0,13,0,0,0,0,412,0,0,21
430,D,101,QUORUM 430,5-Oct-1990,6:41 PM,Call of the House,None,Passed,0,0,161,15,0,0,233,24,0,0,0,0,0,0,394,39
431,D,101,H J RES 660,5-Oct-1990,7:25 PM,On Passage,"CONTINUING APPROPRIATIONS, FY 1991",Passed,66,101,0,9,234,12,0,11,0,0,0,0,300,113,0,20
432,D,101,MOTION,6-Oct-1990,3:28 PM,On Approving the Journal,None,Passed,48,96,0,32,216,5,0,36,0,0,0,0,264,101,0,68
433,D,101,H J RES 660,6-Oct-1990,5:03 PM,ON PRESIDENTIAL VETO,"CONTINUING APPROPRIATIONS, FY 1991",Failed,25,129,0,22,235,9,0,14,0,0,0,0,260,138,0,36
434,D,101,H RES 496,6-Oct-1990,5:39 PM,On Agreeing to the Resolution,PROVIDING FOR THE CONSIDERATION OF THE CONFERENCE REPORT ON H. CON. RES. 310,Passed,49,104,0,23,236,1,0,20,0,0,0,0,285,105,0,43
435,D,101,QUORUM 435,7-Oct-1990,11:39 PM,Call of the House,None,Passed,0,0,159,17,0,0,224,33,0,0,0,0,0,0,383,50
436,D,101,H CON RES 310,7-Oct-1990,11:59 PM,AGREEING TO CONFERENCEREPORT,"CONGRESSIONAL BUDGET FOR U.S. GOVERNMENT FOR FY 1991, 1992, 1993, 1994, AND 1995",Passed,32,136,0,8,218,28,0,12,0,0,0,0,250,164,0,20
437,D,101,H J RES 666,7-Oct-1990,11:59 PM,On Agreeing to the Amendment,None,Failed,160,9,0,7,26,215,0,17,0,0,0,0,186,224,0,24
438,D,101,H J RES 666,7-Oct-1990,11:59 PM,On Passage,MAKING FURTHER CONTINUING APPROPRIATIONS FOR THE FISCAL YEAR 1991,Passed,67,102,0,7,238,3,0,17,0,0,0,0,305,105,0,24
439,D,101,H J RES 666,8-Oct-1990,11:59 PM,CONCUR IN SENATE AMENDMENTS NOS. 1 THROUGH 5,MAKING FURTHER CONTINUING APPROPRIATIONS FOR THE FISCAL YEAR 1991,Passed,156,2,0,18,206,1,0,50,0,0,0,0,362,3,0,68
440,D,101,H R 4328,10-Oct-1990,7:55 PM,ON PRESIDENTIAL VETO,"TEXTILE, APPAREL, AND FOOTWEAR TRADE ACT",Failed,70,103,0,3,205,49,0,3,0,0,0,0,275,152,0,6
441,D,101,S 2737,10-Oct-1990,8:07 PM,On Motion to Suspend the Rules and Pass,KOREAN WAR VETERANS MEMORIAL THIRTY EIGHTH ANNIVERSARY COMMEMORATIVE COIN ACT,Passed,172,0,0,4,249,0,0,8,0,0,0,0,421,0,0,12
442,D,101,S 1413,10-Oct-1990,8:15 PM,On Motion to Suspend the Rules and Pass,AROOSTOOK BAND OF MICMACS SETTLEMENT ACT,Failed,46,125,0,5,202,47,0,8,0,0,0,0,248,172,0,13
443,D,101,H R 5311,11-Oct-1990,11:34 AM,PREVIOUS QUESTION ON MOTION TO INSTRUCT CONFEREES TO AGREE,"TO SENATE ADMENDMENT #18 DISTRICT OF COLUMBIA APPROPRIATION, 1991",Passed,44,117,0,15,211,39,0,7,0,0,0,0,255,156,0,22
444,D,101,H RES 477,11-Oct-1990,12:11 PM,On Agreeing to the Resolution,WAIVING ALL POINTS OF ORDER AGAINST THE CONFERENCE REPORT ON S. 2104; CIVIL RIGHTS ACT OF 1990,Passed,165,4,0,7,247,1,0,9,0,0,0,0,412,5,0,16
445,D,101,S 2104,11-Oct-1990,1:47 PM,RECOMMIT CONFERENCE REPORT WITH INSTRUCTIONS,CIVIL RIGHTS ACT OF 1990,Passed,169,0,0,7,206,45,0,6,0,0,0,0,375,45,0,13
446,D,101,H R 4825,11-Oct-1990,5:13 PM,On Agreeing to the Amendment,None,Failed,52,120,0,4,12,241,0,4,0,0,0,0,64,361,0,8
447,D,101,H R 4825,11-Oct-1990,6:15 PM,On Agreeing to the Amendment,None,Failed,114,58,0,4,61,191,0,5,0,0,0,0,175,249,0,9
448,D,101,H R 4825,11-Oct-1990,7:18 PM,On Agreeing to the Amendment,None,Agreed to,142,31,0,3,240,11,0,6,0,0,0,0,382,42,0,9
449,D,101,H R 4825,11-Oct-1990,7:59 PM,On Passage,"ARTS, HUMANITIES, AND MUSEUMS AMENDMENTS OF 1990",Passed,114,59,0,3,235,17,0,5,0,0,0,0,349,76,0,8
450,D,101,S 2830,11-Oct-1990,9:23 PM,MOTION TO INSTRUCT CONFEREES,AGRICULTURAL PRICE SUPPORT AND RELATED PROGRAMS,Failed,41,130,0,5,121,118,0,18,0,0,0,0,162,248,0,23
451,D,101,S 2830,11-Oct-1990,9:31 PM,MOTION TO INSTRUCT CONFEREES,AGRICULTURAL PRICE SUPPORT AND RELATED PROGRAMS,Passed,89,81,0,6,166,73,0,18,0,0,0,0,255,154,0,24
452,D,101,QUORUM 452,12-Oct-1990,11:18 AM,Call of the House,None,Passed,0,0,166,10,0,0,242,15,0,0,0,0,0,0,408,25
453,D,101,H R 5803,12-Oct-1990,11:32 AM,On Agreeing to the Amendment,None,Failed,11,158,0,7,86,161,0,10,0,0,0,0,97,319,0,17
454,D,101,H R 5803,12-Oct-1990,1:45 PM,On Agreeing to the Amendment,None,Failed,58,112,0,6,143,103,0,11,0,0,0,0,201,215,0,17
455,D,101,H R 5803,12-Oct-1990,2:09 PM,On Passage,"DEPARTMENT OF DEFENSE APPROPRIATION, FY 1991",Passed,132,39,0,5,190,58,0,9,0,0,0,0,322,97,0,14
456,D,101,H RES 505,12-Oct-1990,3:37 PM,On Agreeing to the Resolution,"WAIVING CERTAIN POINTS OF ORDER DURING THE CONSIDERATION OF H.R. 5769, INTERIOR AND RELATED AGENCIES APPROPRIATION, FY 1991",Passed,14,152,0,10,231,8,0,18,0,0,0,0,245,160,0,28
457,D,101,QUORUM 457,15-Oct-1990,4:36 PM,Call of the House,None,Passed,0,0,155,21,0,0,220,37,0,0,0,0,0,0,375,58
458,D,101,H R 5769,15-Oct-1990,4:48 PM,On Agreeing to the Amendment,None,Failed,99,61,0,16,5,220,0,32,0,0,0,0,104,281,0,48
459,D,101,H R 5769,15-Oct-1990,5:35 PM,On Agreeing to the Amendment,None,Failed,99,66,0,11,7,229,0,21,0,0,0,0,106,295,0,32
460,D,101,H R 5769,15-Oct-1990,7:12 PM,On Agreeing to the Amendment,None,Agreed to,56,111,0,9,195,44,1,17,0,0,0,0,251,155,1,26
461,D,101,H R 5769,15-Oct-1990,8:41 PM,On Agreeing to the Amendment,None,Agreed to,49,116,0,11,185,55,0,17,0,0,0,0,234,171,0,28
462,D,101,H R 5769,15-Oct-1990,9:02 PM,On Agreeing to the Amendment,None,Agreed to,149,13,2,12,193,45,0,19,0,0,0,0,342,58,2,31
463,D,101,H R 5769,15-Oct-1990,9:37 PM,On Agreeing to the Amendment,None,Failed,129,34,0,13,38,200,0,19,0,0,0,0,167,234,0,32
464,D,101,H R 5769,15-Oct-1990,9:59 PM,On Passage,"INTERIOR AND RELATED AGENCIES APPROPRIATION, FY 1991",Passed,95,70,0,11,232,10,0,15,0,0,0,0,327,80,0,26
465,D,101,H R 3960,15-Oct-1990,11:03 PM,On Agreeing to the Amendment,None,Agreed to,137,0,0,39,214,0,0,43,0,0,0,0,351,0,0,82
466,D,101,H R 3960,15-Oct-1990,11:35 PM,On Agreeing to the Amendment,None,Failed,100,42,0,34,51,162,0,44,0,0,0,0,151,204,0,78
467,D,101,H R 3960,15-Oct-1990,11:59 PM,On Passage,CENTRAL UTAH PROJECTS COMPLETION ACT,Passed,43,99,0,34,168,44,0,45,0,0,0,0,211,143,0,79
468,D,101,MOTION,16-Oct-1990,10:29 AM,On Approving the Journal,None,Passed,41,105,2,28,204,5,1,47,0,0,0,0,245,110,3,75
469,D,101,H RES 487,16-Oct-1990,12:12 PM,On Agreeing to the Resolution,PROVIDING FOR THE CONSIDERATION OF H.R. 5422; INTELLIGENCE AUTHORIZATION FOR FISCAL YEAR 1991,Passed,171,0,0,5,247,0,0,10,0,0,0,0,418,0,0,15
470,D,101,MOTION,16-Oct-1990,12:53 PM,TABLE APPEAL FROM RULING,None,Passed,0,170,0,6,251,1,0,5,0,0,0,0,251,171,0,11
471,D,101,H RES 509,16-Oct-1990,2:27 PM,On Ordering the Previous Question,PROVIDING FOR THE CONSIDERATION OF H.R. 5835; OMNIBUS BUDGET RECONCILIATION,Passed,0,173,0,3,241,11,0,5,0,0,0,0,241,184,0,8
472,D,101,H RES 509,16-Oct-1990,2:44 PM,On Agreeing to the Resolution,PROVIDING FOR THE CONSIDERATION OF H.R. 5835; OMNIBUS BUDGET RECONCILIATION,Passed,0,173,0,3,231,22,0,4,0,0,0,0,231,195,0,7
473,D,101,QUORUM 473,16-Oct-1990,7:08 PM,Call of the House,None,Passed,0,0,168,8,0,0,236,21,0,0,0,0,0,0,404,29
474,D,101,H R 5835,16-Oct-1990,7:56 PM,ON AGREEING TO THE AMENDMENTS,None,Agreed to,10,164,0,2,228,28,0,1,0,0,0,0,238,192,0,3
475,D,101,H R 5835,16-Oct-1990,9:18 PM,On Passage,OMNIBUS BUDGET RECONCILIATION ACT OF 1990,Passed,10,163,0,3,217,40,0,0,0,0,0,0,227,203,0,3
476,D,101,MOTION,17-Oct-1990,10:24 AM,On Approving the Journal,None,Passed,41,119,0,16,224,4,0,29,0,0,0,0,265,123,0,45
477,D,101,H R 5803,17-Oct-1990,10:45 AM,CLOSING PORTIONS OF CONFERENCE,"DEPARTMENT OF DEFENSE APPROPRIATION, FY 1991",Passed,163,0,0,13,238,4,0,15,0,0,0,0,401,4,0,28
478,D,101,S 2104,17-Oct-1990,2:13 PM,On Agreeing to the Conference Report,CIVIL RIGHTS ACT OF 1990,Passed,34,139,0,3,239,15,0,3,0,0,0,0,273,154,0,6
479,D,101,H R 5422,17-Oct-1990,6:47 PM,On Agreeing to the Amendment,None,Failed,4,168,0,4,171,78,0,8,0,0,0,0,175,246,0,12
480,D,101,H R 5422,17-Oct-1990,8:16 PM,On Agreeing to the Amendment,None,Agreed to,20,150,0,6,193,50,0,14,0,0,0,0,213,200,0,20
481,D,101,H R 5422,17-Oct-1990,10:01 PM,On Agreeing to the Amendment,None,Failed,0,168,0,8,70,173,0,14,0,0,0,0,70,341,0,22
482,D,101,H R 5422,17-Oct-1990,10:24 PM,On Agreeing to the Amendment,None,Agreed to,12,156,0,8,195,50,0,13,0,0,0,0,207,206,0,21
483,D,101,H J RES 647,18-Oct-1990,12:25 PM,On Passage,DISAPPROVING THE RECOMMENDATION OF THE PRESIDENT TO EXTEND MOST FAVORED NATION TREATMENT TO THE PRODUCTS OF THE PEOPLEâ€™S REPUBLIC OF CHINA,Passed,81,90,0,5,166,84,0,7,0,0,0,0,247,174,0,12
484,D,101,H R 4939,18-Oct-1990,4:08 PM,ON AGREEING TO THE AMENDMENTS,None,Agreed to,128,44,0,4,219,30,0,8,0,0,0,0,347,74,0,12
485,D,101,H R 4939,18-Oct-1990,4:42 PM,On Agreeing to the Amendment,None,Agreed to,169,2,0,5,240,5,0,12,0,0,0,0,409,7,0,17
486,D,101,H R 4939,18-Oct-1990,5:04 PM,On Passage,REGARDING MOST FAVORED NATION STATUS TO THE TREATMENT OF THE PRODUCTS OF THE PEOPLEâ€™S REPUBLIC OF CHINA,Passed,150,19,0,7,234,11,0,12,0,0,0,0,384,30,0,19
487,D,101,H J RES 677,18-Oct-1990,5:39 PM,On Passage,"MAKING FURTHER CONTINUING APPROPRIATIONS, FY 1991",Passed,138,32,0,6,241,5,0,11,0,0,0,0,379,37,0,17
488,D,101,H RES 512,19-Oct-1990,12:06 PM,On Agreeing to the Resolution,WAIVING THE REQUIREMENT OF CLAUSE XI AGAINST CONSIDERATION OF CERTAIN RESOLUTIONS REPORTED FROM THE COMMITTEE ON RULES,Passed,5,163,0,8,241,0,0,16,0,0,0,0,246,163,0,24
489,D,101,H R 5019,19-Oct-1990,1:03 PM,On Agreeing to the Conference Report,ENERGY AND WATER DEVELOPMENT APPROPRIATION FOR FY 1991,Passed,129,38,0,9,233,13,0,11,0,0,0,0,362,51,0,20
490,D,101,H R 5019,19-Oct-1990,2:10 PM,RECEDE AND CONCUR TO S.ADT. #51 WITH AN AMENDMENT,ENERGY AND WATER DEVELOPMENT APPROPRIATION FOR FY 1991,Passed,70,100,0,6,176,72,0,9,0,0,0,0,246,172,0,15
491,D,101,H R 5019,19-Oct-1990,3:13 PM,RECEDE AND CONCUR TO S.ADT. #53 WITH AN AMENDMENT,ENERGY AND WATER DEVELOPMENT APPROPRIATION FOR FY 1991,Passed,75,93,0,8,233,15,0,9,0,0,0,0,308,108,0,17
492,D,101,H R 5229,19-Oct-1990,4:07 PM,On Agreeing to the Conference Report,"TRANSPORTATION AND RELATED AGENCIES APPROPRIATION, FY 1991",Passed,150,15,0,11,244,2,0,11,0,0,0,0,394,17,0,22
493,D,101,H R 5311,20-Oct-1990,1:47 PM,MOTION TO RECOMITT CONFERENCE REPORT WITHINSTRUCTIONS,"DISTRICT OF COLUMBIA APPROPRIATION, 1991",Failed,134,26,0,16,52,184,0,21,0,0,0,0,186,210,0,37
494,D,101,H R 5311,20-Oct-1990,1:59 PM,On Agreeing to the Conference Report,"DISTRICT OF COLUMBIA APPROPRIATION, 1991",Failed,22,137,0,17,163,74,0,20,0,0,0,0,185,211,0,37
495,D,101,H R 5158,20-Oct-1990,2:45 PM,On Agreeing to the Conference Report,"VETERANS AFFAIRS, HOUSING AND URBAN DEVELOPMENT INDEPENDENT AGENCIES APPROPRIATION FOR FY 1991",Passed,134,26,0,16,232,6,0,19,0,0,0,0,366,32,0,35
496,D,101,H R 5158,20-Oct-1990,3:47 PM,RECEDE AND CONCUR W/AMEND IN SENATE AMENDMENT #18,"VETERANS AFFAIRS, HOUSING AND URBAN DEVELOPMENT INDEPENDENT AGENCIES APPROPRIATION FOR FY 1991",Passed,39,120,0,17,193,47,0,17,0,0,0,0,232,167,0,34
497,D,101,H R 5399,21-Oct-1990,3:37 PM,On Agreeing to the Amendment,None,Agreed to,163,0,0,13,232,1,0,24,0,0,0,0,395,1,0,37
498,D,101,H R 5399,21-Oct-1990,4:46 PM,On Agreeing to the Amendment,None,Agreed to,139,30,0,7,136,109,0,12,0,0,0,0,275,139,0,19
499,D,101,H R 5399,21-Oct-1990,7:12 PM,On Agreeing to the Amendment,None,Failed,147,22,0,7,44,201,0,12,0,0,0,0,191,223,0,19
500,D,101,H R 5399,21-Oct-1990,7:44 PM,On Agreeing to the Amendment,None,Agreed to,158,9,0,9,91,152,0,14,0,0,0,0,249,161,0,23
501,D,101,H R 5399,21-Oct-1990,8:16 PM,On Passage,"LEGISLATIVE BRANCH APPROPRIATION, FY 1991",Passed,64,102,0,10,228,15,0,14,0,0,0,0,292,117,0,24
502,D,101,H RES 517,22-Oct-1990,12:41 PM,On Agreeing to the Resolution,WAIVING THE REQUIREMENT OF CLAUSE 4(B) OF RULE XI AGAINST CONSIDERATION OF CERTAIN RESOLUTIONS REPORTED FROM THE COMMITTEE ON RULES,Passed,2,168,0,6,236,0,0,21,0,0,0,0,238,168,0,27
503,D,101,H R 5400,22-Oct-1990,1:57 PM,MOTION TO INSTRUCT CONFEREES,CAMPAIGN COST REDUCTION AND REFORM ACT OF 1990,Passed,168,0,0,8,235,6,0,16,0,0,0,0,403,6,0,24
504,D,101,H R 5257,22-Oct-1990,3:55 PM,On Agreeing to the Conference Report,"LABOR, HEALTH AND HUMAN SERVICES AND EDUCATION APPROPRIATIONS, 1991",Passed,92,74,0,10,243,0,0,14,0,0,0,0,335,74,0,24
505,D,101,H R 5241,22-Oct-1990,6:09 PM,On Agreeing to the Conference Report,"TREASURY POSTAL APPROPRIATIONS, FY 1991",Passed,104,63,0,9,239,4,0,14,0,0,0,0,343,67,0,23
506,D,101,H R 5021,23-Oct-1990,12:47 PM,On Agreeing to the Conference Report,"COMMERCE, JUSTICE, AND STATE, THE JUDICIARY AND RELATED AGENCIES APPROPRIATION, FY 1991",Passed,141,26,0,9,236,14,0,7,0,0,0,0,377,40,0,16
507,D,101,H R 5021,23-Oct-1990,3:51 PM,CONCUR IN SENATE AMENDMENT #165 WITH AMENDMENT,"COMMERCE, JUSTICE, AND STATE, THE JUDICIARY AND RELATED AGENCIES APPROPRIATION, FY 1991",Passed,166,3,0,7,215,36,0,6,0,0,0,0,381,39,0,13
508,D,101,S 2830,23-Oct-1990,5:48 PM,On Agreeing to the Conference Report,AGRICULTURAL PRICE SUPPORT AND RELATED PROGRAMS,Passed,119,51,0,6,199,51,0,7,0,0,0,0,318,102,0,13
509,D,101,H CON RES 385,23-Oct-1990,6:07 PM,SUSPEND THE RULES AND AGREE,EXPRESSING THE SENSE OF CONGRESS REGARDING HUMAN RIGHTS VIOLATIONS AGAINST THE ETHNIC ALBANIAN MINORITY IN YUGOSLAVIA,Failed,21,148,0,7,34,214,0,9,0,0,0,0,55,362,0,16
510,D,101,H R 4333,23-Oct-1990,6:19 PM,On Motion to Suspend the Rules and Pass,"BEACHES ENVIRONMENTAL ASSESSMENT, CLOSURE, AND HEALTH ACT OF 1990",Passed,94,75,0,7,232,14,0,11,0,0,0,0,326,89,0,18
511,D,101,H CON RES 382,23-Oct-1990,6:30 PM,SUSPEND THE RULES AND AGREE,IRAQâ€™S INVASION AND OCCUPATION OF KUWAIT,Passed,166,1,0,9,240,4,1,12,0,0,0,0,406,5,1,21
512,D,101,S 1430,24-Oct-1990,12:22 PM,On Agreeing to the Conference Report,NATIONAL SERVICE ACT OF 1990,Passed,22,145,0,9,213,41,0,3,0,0,0,0,235,186,0,12
513,D,101,H RES 511,24-Oct-1990,1:42 PM,On Agreeing to the Resolution,"PROVIDING FOR THE CONSIDERATION OF S. 2924, FEDERAL FISH INSPECTION ACT",Passed,62,106,0,7,238,13,0,6,0,0,0,0,300,119,0,13
514,D,101,S 2924,24-Oct-1990,5:04 PM,On Agreeing to the Amendment,None,Agreed to,96,78,0,1,181,75,0,1,0,0,0,0,277,153,0,2
515,D,101,S 2924,24-Oct-1990,5:27 PM,On Passage,FEDERAL FISH INSPECTION ACT,Passed,115,59,0,1,209,47,0,1,0,0,0,0,324,106,0,2
516,D,101,H RES 521,24-Oct-1990,8:19 PM,On Agreeing to the Resolution,WAIVING CERTAIN POINTS OF ORDER AGAINST CONSIDERATION OF THE CONFERENCE REPORT ON H.R. 4739; DEFENSE AUTHORIZATION ACT FOR FY 1991,Passed,1,157,0,17,238,4,0,15,0,0,0,0,239,161,0,32
517,D,101,H R 4739,24-Oct-1990,10:34 PM,On Agreeing to the Conference Report,NATIONAL DEFENSE AUTHORIZATION ACT FOR FISCAL YEAR 1991,Passed,65,109,0,1,206,47,0,4,0,0,0,0,271,156,0,5
518,D,101,H J RES 681,24-Oct-1990,11:12 PM,On Passage,"FURTHER CONTINUING APPRPOPRIATIONS, FY 1991",Passed,136,38,0,1,244,7,0,6,0,0,0,0,380,45,0,7
519,D,101,H RES 527,25-Oct-1990,12:17 PM,On Agreeing to the Resolution,"WAIVING THE REQUIREMENT OF CLAUSE 4(B), RULE XI, AGAINST CONSIDERATION OF CERTAIN RESOLUTIONS REPORTED FROM THE COMMITTEE ON RULES",Passed,8,161,0,6,247,0,0,10,0,0,0,0,255,161,0,16
520,D,101,S 605,25-Oct-1990,12:30 PM,SUSPEND THE RULES AND AGREE TO CONFERENCE REPORT,CONSUMER PRODUCT SAFETY COMMISSION AUTHORIZATION ACT,Passed,137,34,0,4,238,7,0,12,0,0,0,0,375,41,0,16
521,D,101,H R 5112,25-Oct-1990,12:38 PM,SUSPEND THE RULES AND AGREE TO SENATE AMENDMENTS,HEALTH CARE DEMONSTRATION PROJECTS EXTENSION ACT OF 1990,Passed,171,0,0,4,246,1,0,10,0,0,0,0,417,1,0,14
522,D,101,H R 5269,25-Oct-1990,1:32 PM,MOTION TO INSTRUCT CONFEREES,COMPREHENSIVE CRIME CONTROL ACT OF 1990,Passed,162,6,0,7,129,117,0,11,0,0,0,0,291,123,0,18
523,D,101,H R 5311,25-Oct-1990,5:32 PM,On Agreeing to the Conference Report,"DISTRICT OF COLUMBIA APPROPRIATION, 1991",Failed,31,138,0,6,164,73,0,20,0,0,0,0,195,211,0,26
524,D,101,H RES 535,26-Oct-1990,4:07 PM,On Agreeing to the Resolution,"WAIVING CERTAIN POINTS OF ORDER AGAINST CONSIDERATION OF THE CONFERENCE REPORT ON S. 1630, CLEAN AIR ACT AMENDMENTS OF 1990",Passed,148,23,0,4,242,3,0,12,0,0,0,0,390,26,0,16
525,D,101,S 1630,26-Oct-1990,7:06 PM,On Agreeing to the Conference Report,CLEAN AIR ACT AMENDMENTS OF 1990,Passed,153,20,0,2,248,5,0,4,0,0,0,0,401,25,0,6
526,D,101,H RES 531,26-Oct-1990,11:08 PM,On Agreeing to the Resolution,"WAIVING CERTAIN POINTS OF ORDER AGAINST CONSIDERATION OF THE CONFERENCE REPORT ON S. 358, IMMIGRATION ACT OF 1990",Failed,58,112,0,5,128,123,0,6,0,0,0,0,186,235,0,11
527,D,101,H RES 537,26-Oct-1990,11:59 PM,On Agreeing to the Resolution,WAIVING CERTAIN POINTS OF ORDER AGAINST CONSIDERATION OF THE CONFERENCE REPORT ON H.R. 5835; BUDGET RECONCILIATION ACT OF 1990,Passed,29,142,0,4,246,0,0,11,0,0,0,0,275,142,0,15
528,D,101,H R 5835,26-Oct-1990,11:59 PM,On Agreeing to the Conference Report,OMNIBUS BUDGET RECONCILIATION ACT OF 1990,Passed,47,126,0,2,181,74,0,3,0,0,0,0,228,200,0,5
529,D,101,H R 5399,27-Oct-1990,5:33 PM,On Agreeing to the Conference Report,"LEGISLATIVE BRANCH APPROPRIATION, FY 1991",Passed,50,111,0,14,209,18,0,30,0,0,0,0,259,129,0,44
530,D,101,S 358,27-Oct-1990,7:04 PM,On Agreeing to the Conference Report,IMMIGRATION ACT OF 1990,Passed,93,64,0,18,171,54,0,32,0,0,0,0,264,118,0,50
531,D,101,H R 5114,27-Oct-1990,8:59 PM,On Agreeing to the Conference Report,"FOREIGN ASSISTANCE APPROPRIATIONS, 1991",Passed,63,82,0,30,125,80,0,52,0,0,0,0,188,162,0,82
532,D,101,H R 5769,27-Oct-1990,9:57 PM,On Agreeing to the Conference Report,"INTERIOR AND RELATED AGENCIES APPROPRIATION, FY 1991",Passed,107,36,0,32,191,7,0,59,0,0,0,0,298,43,0,91
533,D,101,H J RES 687,27-Oct-1990,10:23 PM,On Passage,MAKING FURTHER CONTINUING APPROPRIATIONS FOR THE FISCAL YEAR 1991,Passed,97,45,0,33,186,4,0,67,0,0,0,0,283,49,0,100
534,D,101,S 3266,27-Oct-1990,11:57 PM,On Motion to Suspend the Rules and Pass,CRIME CONTROL ACT OF 1990,Passed,135,1,0,39,178,0,0,79,0,0,0,0,313,1,0,118
535,D,101,H R 4793,27-Oct-1990,11:59 PM,SUSPEND RULES AND AGREE TO SENATE AMENDMENT,SMALL BUSINESS REAUTHORIZATION AND AMENDMENTS ACT OF 1990,Passed,117,0,0,58,133,0,0,124,0,0,0,0,250,0,0,182
536,D,101,S 280,27-Oct-1990,11:59 PM,SUSPEND THE RULES AND CONCUR IN S. ADTS. TO H. ADT,NIOBRARA RIVER DESIGNATION,Failed,25,91,0,59,132,4,0,122,0,0,0,0,157,95,0,181
