Roll Call,Majority,Congress Num,Legislation Number,Date,Time,Question,Description,Result,Republican Yes,Republican No,Republican Present,Republican Not Voting,Democrat Yes,Democrat No,Democrat Present,Democrat Not Voting,Independent Yes,Independent No,Independent Present,Independent Not Voting,Total Yes,Total No,Total Present,Total Not Voting
1,D,110,QUORUM,15-Jan-2008,7:31 PM,Call of the House,None,Passed,0,0,181,18,0,0,212,20,0,0,0,0,0,0,393,38
2,D,110,H RES 918,16-Jan-2008,12:12 PM,On Ordering the Previous Question,"Providing for consideration of H.R. 2768, to establish improved mandatory standards to protect miners during emergencies, and for other purposes",Passed,0,190,0,9,222,1,0,8,0,0,0,0,222,191,0,17
3,D,110,H RES 912,16-Jan-2008,12:20 PM,On Motion to Suspend the Rules and Agree,Condemning the assassination of former Pakistani Prime Minister Benazir Bhutto,Passed,189,0,0,10,224,0,0,8,0,0,0,0,413,0,0,18
4,D,110,H RES 921,16-Jan-2008,12:28 PM,On Motion to Suspend the Rules and Agree,"Providing for the concurrence by the House in the Senate amendment to H.R. 4253, with an amendment",Passed,185,2,0,12,221,0,0,10,0,0,0,0,406,2,0,22
5,D,110,H R 2768,16-Jan-2008,2:55 PM,On Agreeing to the Amendment,None,Agreed to,8,183,0,9,226,0,0,9,0,0,0,0,234,183,0,18
6,D,110,H R 2768,16-Jan-2008,3:02 PM,On Agreeing to the Amendment,None,Agreed to,138,53,0,9,226,0,0,9,0,0,0,0,364,53,0,18
7,D,110,H R 2768,16-Jan-2008,3:08 PM,On Agreeing to the Amendment,None,Agreed to,189,0,0,11,227,0,0,8,0,0,0,0,416,0,0,19
8,D,110,H R 2768,16-Jan-2008,3:16 PM,On Agreeing to the Amendment,None,Failed,185,5,0,10,3,224,0,8,0,0,0,0,188,229,0,18
9,D,110,H R 2768,16-Jan-2008,3:48 PM,On Motion to Recommit with Instructions,S-MINER Act,Failed,189,1,0,9,8,216,0,7,0,0,0,0,197,217,0,16
10,D,110,H R 2768,16-Jan-2008,3:56 PM,On Passage,S-MINER Act,Passed,7,183,0,9,207,16,0,8,0,0,0,0,214,199,0,17
11,D,110,H R 4986,16-Jan-2008,4:51 PM,On Motion to Suspend the Rules and Pass,National Defense Authorization Act for Fiscal Year 2008,Passed,187,4,0,8,182,42,0,7,0,0,0,0,369,46,0,15
12,D,110,H R 3524,17-Jan-2008,1:28 PM,On Agreeing to the Amendment,None,Agreed to,165,20,0,15,223,0,0,12,0,0,0,0,388,20,0,27
13,D,110,H R 3524,17-Jan-2008,1:36 PM,On Agreeing to the Amendment,None,Failed,180,4,0,16,1,223,0,11,0,0,0,0,181,227,0,27
14,D,110,H R 3524,17-Jan-2008,1:43 PM,On Agreeing to the Amendment,None,Failed,185,0,0,15,1,221,0,13,0,0,0,0,186,221,0,28
15,D,110,H R 3524,17-Jan-2008,1:50 PM,On Agreeing to the Amendment,None,Failed,136,48,0,16,0,220,0,15,0,0,0,0,136,268,0,31
16,D,110,H R 3524,17-Jan-2008,1:56 PM,On Agreeing to the Amendment,None,Failed,165,20,0,15,4,220,0,11,0,0,0,0,169,240,0,26
17,D,110,H R 3524,17-Jan-2008,2:26 PM,On Motion to Recommit with Instructions,HOPE VI Improvement and Reauthorization Act,Passed,182,0,0,17,190,28,0,13,0,0,0,0,372,28,0,30
18,D,110,H R 3524,17-Jan-2008,2:33 PM,On Passage,HOPE VI Improvement and Reauthorization Act,Passed,53,130,0,16,218,0,0,13,0,0,0,0,271,130,0,29
19,D,110,H R 4211,22-Jan-2008,6:54 PM,On Motion to Suspend the Rules and Pass,Judge Richard B. Allsbrook Post Office,Passed,186,0,0,13,205,0,0,26,0,0,0,0,391,0,0,39
20,D,110,H RES 866,22-Jan-2008,7:06 PM,On Motion to Suspend the Rules and Agree,"Honoring the brave men and women of the United States Coast Guard whose tireless work, dedication, and commitment to protecting the United States have led to the Coast Guard seizing over 350,000 pounds of cocaine at sea during 2007, far surpassing all of our previous records",Passed,187,0,0,12,204,0,0,27,0,0,0,0,391,0,0,39
21,D,110,H R 3963,23-Jan-2008,12:35 PM,On Ordering the Previous Question,Children’s Health Insurance Program Extension and Improvement,Passed,0,194,0,5,217,1,0,13,0,0,0,0,217,195,0,18
22,D,110,H R 3963,23-Jan-2008,12:52 PM,"Passage, Objections of the President Not Withstanding",Children’s Health Insurance Program Extension and Improvement,Failed,42,151,0,6,218,1,0,13,0,0,0,0,260,152,0,19
23,D,110,S 2110,28-Jan-2008,5:28 PM,On Motion to Suspend the Rules and Pass,"To designate the facility of the United States Postal Service located at 427 North Street in Taft, California, as the “Larry S. Pierce Post Office”.",Passed,186,0,0,13,202,0,0,29,0,0,0,0,388,0,0,42
24,D,110,H R 4140,28-Jan-2008,5:37 PM,On Motion to Suspend the Rules and Pass,"To designate the Port Angeles Federal Building in Port Angeles, Washington, as the “Richard B. Anderson Federal Building”.",Passed,186,0,0,13,202,0,0,29,0,0,0,0,388,0,0,42
25,D,110,H R 5140,29-Jan-2008,3:11 PM,On Motion to Suspend the Rules and Pass,Recovery Rebates and Economic Stimulus for the American People Act of 2008,Passed,169,25,0,5,216,10,1,5,0,0,0,0,385,35,1,10
26,D,110,H RES 933,29-Jan-2008,3:20 PM,"On Motion to Suspend the Rules and Agree, as Amended",Commending the Louisiana State University Tigers football team for winning the 2007 Bowl Championship Series national championship game.,Passed,190,0,3,6,219,1,1,10,0,0,0,0,409,1,4,16
27,D,110,H R 1528,29-Jan-2008,6:29 PM,On Motion to Recommit with Instructions,New England National Scenic Trail Designation Act,Failed,172,0,0,27,11,205,0,15,0,0,0,0,183,205,0,42
28,D,110,H R 1528,29-Jan-2008,6:37 PM,On Passage,New England National Scenic Trail Designation Act,Passed,48,122,0,29,213,0,0,18,0,0,0,0,261,122,0,47
29,D,110,H RES 867,6-Feb-2008,6:54 PM,On Motion to Suspend the Rules and Agree,Commending the Houston Dynamo soccer team for winning the 2007 Major League Soccer Cup,Passed,170,0,0,28,203,0,0,28,0,0,0,0,373,0,0,56
30,D,110,H RES 942,6-Feb-2008,7:02 PM,On Motion to Suspend the Rules and Agree,Recognizing the significance of Black History Month,Passed,169,0,0,29,198,0,0,33,0,0,0,0,367,0,0,62
31,D,110,H RES 943,6-Feb-2008,7:10 PM,On Motion to Suspend the Rules and Agree,"Remembering the space shuttle Challenger disaster and honoring its crew members, who lost their lives on January 28, 1986",Passed,169,0,0,29,202,0,0,29,0,0,0,0,371,0,0,58
32,D,110,H RES 956,7-Feb-2008,11:57 AM,On Ordering the Previous Question,"Providing for consideration of the bill (H.R. 4137) to amend and extend the Higher Education Act of 1965, and for other purposes",Passed,0,189,0,9,204,7,0,20,0,0,0,0,204,196,0,29
33,D,110,H RES 956,7-Feb-2008,12:05 PM,On Agreeing to the Resolution,"Providing for consideration of the bill (H.R. 4137) to amend and extend the Higher Education Act of 1965, and for other purposes",Passed,0,188,0,10,214,2,0,15,0,0,0,0,214,190,0,25
34,D,110,H CON RES 283,7-Feb-2008,12:13 PM,"On Motion to Suspend the Rules and Agree, as Amended",Calling for a peaceful resolution to the current electoral crisis in Kenya.,Passed,188,1,0,9,217,0,0,14,0,0,0,0,405,1,0,23
35,D,110,H R 4848,7-Feb-2008,12:25 PM,"On Motion to Suspend the Rules and Pass, as Amended","To extend for one year parity in the application of certain limits to mental health benefits, and for other purposes.",Passed,167,23,0,8,217,0,0,14,0,0,0,0,384,23,0,22
36,D,110,H R 4137,7-Feb-2008,5:18 PM,On Agreeing to the Amendment,None,Agreed to,49,143,0,7,211,10,0,14,0,0,0,0,260,153,0,21
37,D,110,H R 4137,7-Feb-2008,5:26 PM,On Agreeing to the Amendment,None,Agreed to,25,167,0,7,197,24,0,14,0,0,0,0,222,191,0,21
38,D,110,H R 4137,7-Feb-2008,5:34 PM,On Agreeing to the Amendment,None,Failed,9,184,0,6,170,52,0,13,0,0,0,0,179,236,0,19
39,D,110,H R 4137,7-Feb-2008,6:07 PM,On Motion to Recommit with Instructions,"To amend and extend the Higher Education Act of 1965, and for other purposes",Failed,187,4,0,7,7,212,0,12,0,0,0,0,194,216,0,19
40,D,110,H R 4137,7-Feb-2008,6:17 PM,On Passage,"To amend and extend the Higher Education Act of 1965, and for other purposes",Passed,135,58,0,5,219,0,0,12,0,0,0,0,354,58,0,17
41,D,110,H RES 947,7-Feb-2008,6:27 PM,On Motion to Suspend the Rules and Agree,"Congratulating Lee Myung-Bak on his election to the Presidency of the Republic of Korea and wishing him well during his time of transition and his inauguration on February 25, 2008.",Passed,180,0,0,18,208,0,0,23,0,0,0,0,388,0,0,41
42,D,110,H R 5140,7-Feb-2008,7:44 PM,On Agreeing to the Senate Amendment,Recovery Rebates and Economic Stimulus for the American People Act of 2008,Passed,165,28,0,5,215,6,0,11,0,0,0,0,380,34,0,16
43,D,110,H RES 954,12-Feb-2008,6:55 PM,"On Motion to Suspend the Rules and Agree, as Amended","Honoring the life of senior Border Patrol agent Luis A. Aguilar, who lost his life in the line of duty near Yuma, Arizona, on January 19, 2008",Passed,161,0,0,37,196,0,0,34,0,0,0,0,357,0,0,71
44,D,110,H RES 909,12-Feb-2008,7:04 PM,"On Motion to Suspend the Rules and Agree, as Amended",Commemorating the courage of the Haitian soldiers that fought for American independence in the “Siege of Savannah” and for Haiti’s independence and renunciation of slavery,Passed,164,0,0,34,197,0,0,33,0,0,0,0,361,0,0,67
45,D,110,H CON RES 281,12-Feb-2008,7:13 PM,On Motion to Suspend the Rules and Agree,Celebrating the birth of Abraham Lincoln and recognizing the prominence the Declaration of Independence played in the development of Abraham Lincoln’s beliefs,Passed,163,0,0,35,194,0,0,36,0,0,0,0,357,0,0,71
46,D,110,ADJOURN,13-Feb-2008,10:56 AM,On Motion to Adjourn,None,Failed,3,167,0,28,0,199,0,31,0,0,0,0,3,366,0,59
47,D,110,ADJOURN,13-Feb-2008,11:23 AM,On Motion to Adjourn,None,Failed,6,170,0,22,1,194,0,35,0,0,0,0,7,364,0,57
48,D,110,H RES 976,13-Feb-2008,12:37 PM,On Ordering the Previous Question,"Providing for consideration of H.R. 5349, to extend the Protect America Act of 2007 for 21 days",Passed,1,190,0,7,209,5,0,16,0,0,0,0,210,195,0,23
49,D,110,H RES 976,13-Feb-2008,12:44 PM,Table Motion to Reconsider,"Providing for consideration of H.R. 5349, to extend the Protect America Act of 2007 for 21 days",Passed,0,189,0,9,206,5,0,19,0,0,0,0,206,194,0,28
50,D,110,H RES 976,13-Feb-2008,12:54 PM,On Agreeing to the Resolution,"Providing for consideration of H.R. 5349, to extend the Protect America Act of 2007 for 21 days",Passed,1,191,0,6,205,8,0,17,0,0,0,0,206,199,0,23
51,D,110,H RES 976,13-Feb-2008,1:03 PM,Table Motion to Reconsider,"Providing for consideration of H.R. 5349, to extend the Protect America Act of 2007 for 21 days",Passed,1,192,0,5,209,3,0,18,0,0,0,0,210,195,0,23
52,D,110,ADJOURN,13-Feb-2008,1:21 PM,On Motion to Adjourn,None,Failed,3,186,0,9,0,209,0,21,0,0,0,0,3,395,0,30
53,D,110,H R 5349,13-Feb-2008,4:02 PM,Table Appeal of the Ruling of the Chair,To extend the Protect America Act of 2007 for 21 days.,Passed,0,195,0,3,222,1,0,7,0,0,0,0,222,196,0,10
54,D,110,H R 5349,13-Feb-2008,4:11 PM,On Passage,To extend the Protect America Act of 2007 for 21 days.,Failed,0,195,0,3,191,34,0,6,0,0,0,0,191,229,0,9
55,D,110,H RES 960,13-Feb-2008,4:19 PM,On Motion to Suspend the Rules and Agree,Congratulating the National Football League champion New York Giants for winning Super Bowl XLII and completing one of the most remarkable postseason runs in professional sports history,Passed,194,0,0,4,218,1,2,9,0,0,0,0,412,1,2,13
56,D,110,H CON RES 293,13-Feb-2008,4:46 PM,On Agreeing to the Resolution,None,Passed,2,193,0,3,213,10,0,7,0,0,0,0,215,203,0,10
57,D,110,H RES 917,13-Feb-2008,4:55 PM,On Motion to Suspend the Rules and Agree,"Supporting the goals and ideals of National Engineers Week, and for other purposes",Passed,191,0,0,7,217,0,0,13,0,0,0,0,408,0,0,20
58,D,110,ADJOURN,14-Feb-2008,11:57 AM,On Motion to Adjourn,None,Failed,2,185,0,11,0,205,0,25,0,0,0,0,2,390,0,36
59,D,110,ADJOURN,14-Feb-2008,1:40 PM,On Motion to Adjourn,None,Failed,2,190,0,6,0,210,0,20,0,0,0,0,2,400,0,26
60,D,110,H RES 982,14-Feb-2008,2:23 PM,On Agreeing to the Resolution,"Providing for the adoption of H. Res. 979 and H. Res. 980, contempt of Congress resolutions.",Passed,3,31,1,163,220,1,0,10,0,0,0,0,223,32,1,173
61,D,110,H RES 966,14-Feb-2008,2:43 PM,On Motion to Suspend the Rules and Agree,"Honoring African-American inventors, past and present, for their leadership, courage, and significant contributions to our national competitiveness",Passed,174,0,0,24,213,0,0,17,0,0,0,0,387,0,0,41
62,D,110,H R 1834,14-Feb-2008,2:53 PM,"On Motion to Suspend the Rules and Pass, as Amended",National Ocean Exploration Program Act,Passed,139,49,0,10,213,0,0,17,0,0,0,0,352,49,0,27
63,D,110,S 2571,14-Feb-2008,2:59 PM,On Motion to Suspend the Rules and Pass,"To make technical corrections to the Federal Insecticide, Fungicide, and Rodenticide Act",Passed,190,0,0,8,210,0,0,20,0,0,0,0,400,0,0,28
64,D,110,H CON RES 289,14-Feb-2008,3:07 PM,On Motion to Suspend the Rules and Agree,Honoring and praising the National Association for the Advancement of Colored People on the occasion of its 99th anniversary,Passed,191,0,0,7,212,0,0,18,0,0,0,0,403,0,0,25
65,D,110,H R 4169,14-Feb-2008,3:43 PM,On Motion to Suspend the Rules and Pass,American Braille Flag Memorial Act,Passed,190,0,0,8,206,0,0,24,0,0,0,0,396,0,0,32
66,D,110,H RES 790,14-Feb-2008,3:50 PM,On Motion to Suspend the Rules and Agree,Commending the people of the State of Washington for showing their support for the needs of the State of Washington’s veterans and encouraging residents of the other States to pursue creative ways to show their own support for veterans,Passed,178,0,0,20,205,0,0,25,0,0,0,0,383,0,0,45
67,D,110,H RES 963,14-Feb-2008,3:56 PM,On Motion to Suspend the Rules and Agree,Supporting the goals and ideals of National Salute to Hospitalized Veterans Week,Passed,179,0,0,19,205,0,0,25,0,0,0,0,384,0,0,44
68,D,110,H RES 972,14-Feb-2008,4:03 PM,On Motion to Suspend the Rules and Agree,Supporting the goals and ideals of American Heart Month and National Wear Red Day,Passed,184,0,0,14,205,0,0,25,0,0,0,0,389,0,0,39
69,D,110,H RES 978,25-Feb-2008,6:55 PM,On Motion to Suspend the Rules and Agree,"Expressing support for the designation of the week of March 3-7, 2008, as “School Social Work Week” to promote awareness of the vital role of school social workers in schools, and in the community as a whole, in helping students prepare for their future as productive citizens",Passed,170,0,0,28,209,0,0,21,0,0,0,0,379,0,0,49
70,D,110,H RES 930,25-Feb-2008,7:06 PM,"On Motion to Suspend the Rules and Agree, as Amended",Supporting the goals and ideals of “Career and Technical Education Month”,Passed,170,0,0,28,210,0,0,20,0,0,0,0,380,0,0,48
71,D,110,H RES 944,25-Feb-2008,7:19 PM,"On Motion to Suspend the Rules and Agree, as Amended","Honoring the service and accomplishments of Lieutenant General Russel L. Honore, United States Army, for his 37 years of service on behalf of the United States",Passed,170,0,0,28,210,0,0,20,0,0,0,0,380,0,0,48
72,D,110,JOURNAL,26-Feb-2008,1:28 PM,On Approving the Journal,None,Passed,21,168,1,8,205,15,0,10,0,0,0,0,226,183,1,18
73,D,110,H RES 974,26-Feb-2008,1:35 PM,On Ordering the Previous Question,Providing for consideration of the bill (H.R. 3521) to improve the Operating Fund for public housing of the Department of Housing and Urban Development,Passed,0,191,0,7,212,7,0,11,0,0,0,0,212,198,0,18
74,D,110,H RES 974,26-Feb-2008,1:42 PM,On Agreeing to the Resolution,Providing for consideration of the bill (H.R. 3521) to improve the Operating Fund for public housing of the Department of Housing and Urban Development,Passed,0,190,0,8,218,0,0,12,0,0,0,0,218,190,0,20
75,D,110,H R 3521,26-Feb-2008,2:46 PM,On Agreeing to the Amendment,None,Agreed to,190,0,0,9,225,0,0,9,0,0,0,0,415,0,0,18
76,D,110,H R 3521,26-Feb-2008,2:54 PM,On Agreeing to the Amendment,None,Agreed to,114,77,0,8,223,0,0,11,0,0,0,0,337,77,0,19
77,D,110,H R 3521,26-Feb-2008,3:20 PM,On Motion to Table the Appeal of the Ruling of the Chair,Public Housing Asset Management Improvement Act,Passed,0,192,0,6,218,3,0,9,0,0,0,0,218,195,0,15
78,D,110,H RES 1001,27-Feb-2008,11:08 AM,Will the House Now Consider the Resolution,"Providing for the consideration of H.R. 5351, Renewable Energy and Energy Conservation Tax Act",Passed,1,185,0,12,223,1,0,6,0,0,0,0,224,186,0,18
79,D,110,JOURNAL,27-Feb-2008,12:39 PM,On Approving the Journal,None,Passed,12,170,1,15,205,15,0,10,0,0,0,0,217,185,1,25
80,D,110,H RES 1001,27-Feb-2008,12:45 PM,On Ordering the Previous Question,"Providing for the consideration of H.R. 5351, Renewable Energy and Energy Conservation Tax Act",Passed,0,182,0,16,214,7,0,9,0,0,0,0,214,189,0,25
81,D,110,H RES 1001,27-Feb-2008,12:52 PM,On Agreeing to the Resolution,"Providing for the consideration of H.R. 5351, Renewable Energy and Energy Conservation Tax Act",Passed,0,187,0,11,220,1,0,9,0,0,0,0,220,188,0,20
82,D,110,H R 5351,27-Feb-2008,3:27 PM,Table the Appeal of the Ruling of the Chair,Renewable Energy and Energy Conservation Tax Act of 2008,Passed,0,190,0,8,222,1,0,7,0,0,0,0,222,191,0,15
83,D,110,H R 5351,27-Feb-2008,4:04 PM,On Motion to Recommit with Instructions,Renewable Energy and Energy Conservation Tax Act of 2008,Failed,189,3,0,6,8,219,0,3,0,0,0,0,197,222,0,9
84,D,110,H R 5351,27-Feb-2008,4:30 PM,On Passage,Renewable Energy and Energy Conservation Tax Act of 2008,Passed,17,174,0,7,219,8,0,4,0,0,0,0,236,182,0,11
85,D,110,S 2272,28-Feb-2008,11:39 AM,On Motion to Suspend the Rules and Pass,John “Marty” Thiels Southpark Station,Passed,183,0,0,15,217,0,0,13,0,0,0,0,400,0,0,28
86,D,110,H R 3936,28-Feb-2008,11:47 AM,On Motion to Suspend the Rules and Pass,Sgt. Jason Harkins Post Office Building,Passed,181,0,0,17,219,0,0,11,0,0,0,0,400,0,0,28
87,D,110,H R 4454,28-Feb-2008,11:54 AM,On Motion to Suspend the Rules and Pass,Iraq and Afghanistan Fallen Military Heroes of Louisville Memorial Post Office Building,Passed,181,0,0,17,223,0,0,7,0,0,0,0,404,0,0,24
88,D,110,H R 1143,4-Mar-2008,6:58 PM,"On Motion to Suspend the Rules and Pass, as Amended","To authorize the Secretary of the Interior to lease certain lands in Virgin Islands National Park, and for other purposes",Passed,171,0,0,27,207,0,0,23,0,0,0,0,378,0,0,50
89,D,110,H R 1311,4-Mar-2008,7:07 PM,"On Motion to Suspend the Rules and Pass, as Amended","To direct the Secretary of the Interior to convey the Alta-Hualapai Site to the city of Las Vegas, Nevada, for the development of a cancer treatment facility",Passed,170,0,0,28,207,0,0,23,0,0,0,0,377,0,0,51
90,D,110,H R 816,4-Mar-2008,7:15 PM,"On Motion to Suspend the Rules and Pass, as Amended",To provide for the release of certain land from the Sunrise Mountain Instant Study Area in the State of Nevada and to grant a right-of-way across the released land for the construction and maintenance of a flood control project,Passed,169,0,0,29,206,0,0,24,0,0,0,0,375,0,0,53
91,D,110,H R 4191,5-Mar-2008,12:11 PM,On Motion to Suspend the Rules and Pass,"To redesignate Dayton Aviation Heritage National Historic Park in the State of Ohio as “Wright Brothers-Dunbar National Historical Park”, and for other purposes.",Passed,189,4,0,5,218,0,0,12,0,0,0,0,407,4,0,17
92,D,110,H CON RES 278,5-Mar-2008,12:18 PM,"On Motion to Suspend the Rules and Agree, as Amended",Supporting Taiwan’s fourth direct and democratic presidential elections in March 2008,Passed,190,1,1,6,219,0,0,11,0,0,0,0,409,1,1,17
93,D,110,H RES 951,5-Mar-2008,12:26 PM,"On Motion to Suspend the Rules and Agree, as Amended","Condemning the ongoing Palestinian rocket attacks on Israeli civilians, and for other purposes",Passed,190,1,0,7,214,0,4,12,0,0,0,0,404,1,4,19
94,D,110,H RES 1014,5-Mar-2008,2:40 PM,Will the House Now Consider the Resolution,"Providing for the consideration of H.R. 1014, Paul Wellstone Mental Health and Addiction Equity Act",Passed,4,184,1,9,211,8,0,11,0,0,0,0,215,192,1,20
95,D,110,H RES 1014,5-Mar-2008,4:06 PM,On Ordering the Previous Question,"Providing for the consideration of H.R. 1014, Paul Wellstone Mental Health and Addiction Equity Act",Passed,5,186,0,7,210,9,0,11,0,0,0,0,215,195,0,18
96,D,110,H RES 1014,5-Mar-2008,4:13 PM,On Agreeing to the Resolution,"Providing for the consideration of H.R. 1014, Paul Wellstone Mental Health and Addiction Equity Act",Passed,5,184,0,9,204,14,0,12,0,0,0,0,209,198,0,21
97,D,110,H R 4774,5-Mar-2008,4:20 PM,"On Motion to Suspend the Rules and Pass, as Amended",Cyndi Taylor Krier Post Office Building,Passed,189,0,0,9,215,0,0,15,0,0,0,0,404,0,0,24
98,D,110,H CON RES 286,5-Mar-2008,4:28 PM,On Motion to Suspend the Rules and Agree,Expressing the sense of Congress that Earl LLoyd should be recognized and honored for breaking the color barrier and becoming the first African-American to play in the National Basketball Association League 58 years ago,Passed,192,0,0,6,220,0,0,10,0,0,0,0,412,0,0,16
99,D,110,H R 1424,5-Mar-2008,7:22 PM,Table Appeal of the Ruling of the Chair,Paul Wellstone Mental Health and Addiction Equity Act,Passed,4,184,1,9,219,2,0,9,0,0,0,0,223,186,1,18
100,D,110,H R 1424,5-Mar-2008,7:56 PM,On Motion to Recommit with Instructions,Paul Wellstone Mental Health and Addiction Equity Act,Failed,181,12,0,5,15,209,0,6,0,0,0,0,196,221,0,11
101,D,110,H R 1424,5-Mar-2008,8:03 PM,On Passage,Paul Wellstone Mental Health and Addiction Equity Act,Passed,47,145,0,6,221,3,0,7,0,0,0,0,268,148,0,13
102,D,110,H R 5400,5-Mar-2008,8:11 PM,On Motion to Suspend the Rules and Pass,Sgt. Michael M. Kashkoush Post Office Building,Passed,192,0,0,6,210,0,0,20,0,0,0,0,402,0,0,26
103,D,110,H RES 1015,6-Mar-2008,11:06 AM,On Ordering the Previous Question,"Providing for consideration of H.R. 2857, to reauthorize and reform the national service laws",Passed,0,188,1,9,217,5,0,8,0,0,0,0,217,193,1,17
104,D,110,H RES 1015,6-Mar-2008,11:13 AM,On Agreeing to the Resolution,"Providing for consideration of H.R. 2857, to reauthorize and reform the national service laws",Passed,0,190,0,8,222,0,0,8,0,0,0,0,222,190,0,16
105,D,110,H R 2857,6-Mar-2008,1:59 PM,On Agreeing to the Amendment,None,Failed,150,39,0,10,3,221,0,10,0,0,0,0,153,260,0,20
106,D,110,H R 2857,6-Mar-2008,2:06 PM,On Agreeing to the Amendment,None,Agreed to,28,161,0,10,224,0,0,10,0,0,0,0,252,161,0,20
107,D,110,H R 2857,6-Mar-2008,2:40 PM,Table Appeal of the Ruling of the Chair,Generations Invigorating Volunteerism and Education “GIVE” Act,Passed,2,187,1,8,219,4,0,7,0,0,0,0,221,191,1,15
108,D,110,H RES 537,10-Mar-2008,6:59 PM,"On Motion to Suspend the Rules and Agree, as Amended",National 9-1-1 Education Month,Passed,176,0,0,22,205,0,0,25,0,0,0,0,381,0,0,47
109,D,110,H R 3196,10-Mar-2008,7:09 PM,On Motion to Suspend the Rules and Pass,E. Arthur Gray Post Office Building,Passed,175,0,0,23,207,0,0,23,0,0,0,0,382,0,0,46
110,D,110,H R 4166,10-Mar-2008,7:18 PM,On Motion to Suspend the Rules and Pass,Steve W. Allee Carrier Annex Post Office Building,Passed,176,0,0,22,206,0,0,24,0,0,0,0,382,0,0,46
111,D,110,ADJOURN,11-Mar-2008,12:57 PM,On Motion to Adjourn,None,Failed,19,162,0,17,1,202,0,27,0,0,0,0,20,364,0,44
112,D,110,ADJOURN,11-Mar-2008,1:54 PM,On Motion to Adjourn,None,Failed,6,179,0,13,0,208,0,22,0,0,0,0,6,387,0,35
113,D,110,ADJOURN,11-Mar-2008,3:17 PM,On Motion to Adjourn,None,Failed,3,183,0,12,2,205,0,23,0,0,0,0,5,388,0,35
114,D,110,ADJOURN,11-Mar-2008,4:23 PM,On Motion to Adjourn,None,Failed,4,183,0,11,0,213,0,17,0,0,0,0,4,396,0,28
115,D,110,H RES 924,11-Mar-2008,4:35 PM,"On Motion to Suspend the Rules and Agree, as Amended",Congratulating Iowa State University of Science and Technology for 150 years of leadership and service,Passed,189,0,0,9,216,0,0,14,0,0,0,0,405,0,0,23
116,D,110,MOTION,11-Mar-2008,5:18 PM,On Motion to table the appeal of the ruling of the Chair,None,Passed,1,188,1,8,217,4,0,10,0,0,0,0,218,192,1,18
117,D,110,H R 2082,11-Mar-2008,7:01 PM,"Passage, Objections of the President Not Withstanding",The Intelligence Authorization Act of 2008,Failed,5,185,0,8,220,3,0,9,0,0,0,0,225,188,0,17
118,D,110,H RES 948,11-Mar-2008,7:09 PM,"On Motion to Suspend the Rules and Agree, as Amended",Congratulating the University of Kansas football team for winning the 2008 FedEx Orange Bowl and having the most successful year in program history,Passed,183,0,6,9,213,0,6,12,0,0,0,0,396,0,12,21
119,D,110,H RES 493,11-Mar-2008,7:17 PM,"On Motion to Suspend the Rules and Agree, as Amended","Congratulating the women’s water polo team of the University of California, Los Angeles, for winning the 2007 NCAA Division I Women’s Water Polo National Championship, and congratulating UCLA on its 100th NCAA sports national title, making it the most accomplished athletic program in NCAA history",Passed,187,0,0,11,213,0,0,18,0,0,0,0,400,0,0,29
120,D,110,ADJOURN,11-Mar-2008,8:40 PM,On Motion to Adjourn,None,Failed,163,11,1,23,14,185,0,32,0,0,0,0,177,196,1,55
121,D,110,H RES 1031,11-Mar-2008,9:59 PM,On Ordering the Previous Question,"Providing for the adoption of the resolution (H. Res. 895) establishing within the House of Representatives an Office of Congressional Ethics, and for other purposes",Passed,4,188,0,6,203,18,0,11,0,0,0,0,207,206,0,17
122,D,110,H RES 1031,11-Mar-2008,10:27 PM,On Agreeing to the Resolution,"Providing for the adoption of the resolution (H. Res. 895) establishing within the House of Representatives an Office of Congressional Ethics, and for other purposes",Passed,33,159,0,6,196,23,4,9,0,0,0,0,229,182,4,15
123,D,110,ADJOURN,11-Mar-2008,10:43 PM,On Motion to Adjourn,None,Passed,19,170,0,9,197,16,0,18,0,0,0,0,216,186,0,27
124,D,110,ADJOURN,12-Mar-2008,10:40 AM,On Motion to Adjourn,None,Failed,2,177,0,19,3,198,0,30,0,0,0,0,5,375,0,49
125,D,110,H RES 1039,12-Mar-2008,11:22 AM,On Motion to Table the Resolution,Resolution Raising a Question of the Privileges of the House,Passed,0,192,0,6,215,1,0,15,0,0,0,0,215,193,0,21
126,D,110,ADJOURN,12-Mar-2008,11:50 AM,On Motion to Adjourn,None,Failed,14,176,0,8,0,208,0,23,0,0,0,0,14,384,0,31
127,D,110,ADJOURN,12-Mar-2008,1:13 PM,On Motion to Adjourn,None,Failed,2,176,0,20,1,206,0,24,0,0,0,0,3,382,0,44
128,D,110,H RES 1040,12-Mar-2008,1:42 PM,On Motion to Table the Resolution,None,Passed,0,193,0,5,219,0,0,12,0,0,0,0,219,193,0,17
129,D,110,H RES 1036,12-Mar-2008,2:48 PM,On Ordering the Previous Question,"Providing for the consideration of H. Con. Res. 312, Congressional Budget for the U.S. Government for Fiscal Year 2009",Passed,0,193,0,5,222,3,0,6,0,0,0,0,222,196,0,11
130,D,110,H RES 1036,12-Mar-2008,2:58 PM,On Agreeing to the Resolution,"Providing for the consideration of H. Con. Res. 312, Congressional Budget for the U.S. Government for Fiscal Year 2009",Passed,0,194,0,4,223,1,0,7,0,0,0,0,223,195,0,11
131,D,110,H R 5563,12-Mar-2008,3:07 PM,On Motion to Suspend the Rules and Pass,Generations Invigorating Volunteerism and Education Act,Failed,53,140,0,5,224,0,0,7,0,0,0,0,277,140,0,12
132,D,110,H CON RES 316,12-Mar-2008,5:15 PM,On Agreeing to the Resolution,Providing for an adjournment or recess of the two Houses,Passed,2,192,0,4,209,12,0,10,0,0,0,0,211,204,0,14
133,D,110,H RES 936,12-Mar-2008,5:23 PM,"On Motion to Suspend the Rules and Agree, as Amended","Honoring the 200th anniversary of the Gallatin Report on Roads and Canals, celebrating the national unity the Gallatin Report engendered, and recognizing the vast contributions that national planning efforts have provided to the United States.",Passed,190,0,0,8,221,0,0,10,0,0,0,0,411,0,0,18
134,D,110,S 2733,12-Mar-2008,5:30 PM,On Motion to Suspend the Rules and Pass,To temporarily extend the programs under the Higher Education Act of 1965,Passed,188,4,0,6,223,0,0,8,0,0,0,0,411,4,0,14
135,D,110,MOTION,13-Mar-2008,11:41 AM,On Motion to Table the Appeal of the Ruling of the Chair,None,Passed,1,189,0,8,221,3,0,7,0,0,0,0,222,192,0,15
136,D,110,JOURNAL,13-Mar-2008,11:49 AM,On Approving the Journal,None,Passed,15,168,1,14,207,15,0,9,0,0,0,0,222,183,1,23
137,D,110,H CON RES 312,13-Mar-2008,1:16 PM,On Agreeing to the Amendment,None,Failed,0,192,0,7,126,100,0,9,0,0,0,0,126,292,0,16
138,D,110,H CON RES 312,13-Mar-2008,2:53 PM,On Agreeing to the Amendment,None,Failed,0,191,0,8,98,131,0,6,0,0,0,0,98,322,0,14
139,D,110,QUORUM,13-Mar-2008,3:24 PM,Call of the House,None,Passed,0,0,173,25,0,0,211,21,0,0,0,0,0,0,384,46
140,D,110,H CON RES 312,13-Mar-2008,5:30 PM,On Agreeing to the Amendment,None,Failed,153,38,0,8,4,225,0,7,0,0,0,0,157,263,0,15
141,D,110,H CON RES 312,13-Mar-2008,5:50 PM,On Agreeing to the Resolution,"Revising the congressional Budget for the United States Government for fiscal year 2008, establishing the congressional budget for the United States Government for fiscal year 2009, and setting forth appropriate budgetary levels for fiscal years 2010 through 2013.",Passed,0,191,0,7,212,16,0,5,0,0,0,0,212,207,0,12
142,D,110,H RES 991,13-Mar-2008,5:59 PM,On Motion to Suspend the Rules and Agree,"Recognizing the exceptional sacrifice of the 69th Infantry Regiment, known as the Fighting 69th, in support of the Global War on Terror.",Passed,187,0,0,11,219,0,0,13,0,0,0,0,406,0,0,24
143,D,110,H RES 1041,14-Mar-2008,11:48 AM,On Ordering the Previous Question,"Providing for the consideration of the Senate amendment to the bill (H.R. 3773) to amend the Foreign Intelligence Surveillance Act of 1978 to establish a procedure for authorizing certain acquisitions of foreign intelligence, and for other purposes.",Passed,1,182,0,15,216,8,0,8,0,0,0,0,217,190,0,23
144,D,110,H RES 1041,14-Mar-2008,12:05 PM,On Agreeing to the Resolution,"Providing for the consideration of the Senate amendment to the bill (H.R. 3773) to amend the Foreign Intelligence Surveillance Act of 1978 to establish a procedure for authorizing certain acquisitions of foreign intelligence, and for other purposes.",Passed,0,185,0,13,221,3,0,8,0,0,0,0,221,188,0,21
145,D,110,H R 3773,14-Mar-2008,2:08 PM,Agree to the Senate Amendment with an Amendment,"To amend the Foreign Intelligence Surveillance Act of 1978 to establish a procedure for authorizing certain acquisitions of foreign intelligence, and for other purpoes",Passed,0,185,0,13,213,12,1,7,0,0,0,0,213,197,1,20
146,D,110,JOURNAL,14-Mar-2008,2:25 PM,On Approving the Journal,None,Passed,19,138,1,40,183,10,0,39,0,0,0,0,202,148,1,79
147,D,110,H R 3352,31-Mar-2008,6:56 PM,"On Motion to Suspend the Rules and Pass, as Amended","To reauthorize and amend the Hydrographic Services Improvement Act, and for other purposes",Passed,112,60,0,26,196,0,0,36,0,0,0,0,308,60,0,62
148,D,110,H R 2675,31-Mar-2008,7:06 PM,"On Motion to Suspend the Rules and Pass, as Amended","To provide for the conveyance of approximately 140 acres of land in the Ouachita National Forest in Oklahoma to the Indian Nations Council, Inc., of the Boy Scouts of America, and for other purposes",Passed,176,0,0,22,194,2,0,36,0,0,0,0,370,2,0,58
149,D,110,H CON RES 302,31-Mar-2008,7:15 PM,On Motion to Suspend the Rules and Agree,"Supporting the observance of Colorectal Cancer Awareness Month, and for other purposes",Passed,176,0,0,22,195,0,0,37,0,0,0,0,371,0,0,59
150,D,110,H CON RES 310,1-Apr-2008,4:11 PM,On Motion to Suspend the Rules and Agree,Expressing support for a national day of remembrance for Harriet Ross Tubman.,Passed,193,0,0,5,223,0,0,9,0,0,0,0,416,0,0,14
151,D,110,H RES 1005,1-Apr-2008,4:21 PM,"On Motion to Suspend the Rules and Agree, as Amended",Supporting the goals and ideals of Borderline Personality Awareness Month.,Passed,191,0,0,7,223,0,0,9,0,0,0,0,414,0,0,16
152,D,110,H RES 1021,1-Apr-2008,4:28 PM,"On Motion to Suspend the Rules and Agree, as Amended","Supporting the goals, ideals, and history of National Women’s History Month.",Passed,190,0,0,8,223,0,0,9,0,0,0,0,413,0,0,17
153,D,110,JOURNAL,2-Apr-2008,11:54 AM,On Approving the Journal,None,Passed,19,169,1,9,213,8,0,11,0,0,0,0,232,177,1,20
154,D,110,H RES 1065,2-Apr-2008,12:03 PM,On Ordering the Previous Question,"Providing for the consideration of H.R. 5501, Tom Lantos and Henry J. Hyde United States Global Leadership Against HIV/AIDS, Tuberculosis, and Malaria Reauthorization Act",Passed,0,190,0,8,215,9,0,8,0,0,0,0,215,199,0,16
155,D,110,H RES 1065,2-Apr-2008,12:11 PM,On Agreeing to the Resolution,"Providing for the consideration of H.R. 5501, Tom Lantos and Henry J. Hyde United States Global Leadership Against HIV/AIDS, Tuberculosis, and Malaria Reauthorization Act",Passed,1,191,0,6,220,1,0,11,0,0,0,0,221,192,0,17
156,D,110,H R 5501,2-Apr-2008,3:21 PM,On Agreeing to the Amendment,None,Agreed to,184,10,0,5,231,0,0,5,0,0,0,0,415,10,0,10
157,D,110,H R 5501,2-Apr-2008,3:55 PM,On Motion to Recommit with Instructions,"Tom Lantos and Henry J. Hyde United States Global Leadership Against HIV/AIDS, Tuberculosis, and Malaria Reauthorization Act",Failed,171,23,0,4,4,225,0,3,0,0,0,0,175,248,0,7
158,D,110,H R 5501,2-Apr-2008,4:03 PM,On Passage,"Tom Lantos and Henry J. Hyde United States Global Leadership Against HIV/AIDS, Tuberculosis, and Malaria Reauthorization Act",Passed,78,116,0,4,230,0,0,3,0,0,0,0,308,116,0,7
159,D,110,H R 4847,3-Apr-2008,12:46 PM,On Motion to Recommit with Instructions,United States Fire Administration Reauthorization Act,Failed,192,0,0,6,13,209,0,10,0,0,0,0,205,209,0,16
160,D,110,H R 4847,3-Apr-2008,12:56 PM,On Passage,United States Fire Administration Reauthorization Act,Passed,190,0,0,8,222,0,0,10,0,0,0,0,412,0,0,18
161,D,110,H J RES 70,8-Apr-2008,6:59 PM,"On Motion to Suspend the Rules and Agree, as Amended",Congratulating the Army Reserve on its centennial,Passed,182,0,0,16,211,0,0,21,0,0,0,0,393,0,0,37
162,D,110,H R 2464,8-Apr-2008,7:07 PM,"On Motion to Suspend the Rules and Pass, as Amended",The Wakefield Act,Passed,180,1,0,17,210,0,0,22,0,0,0,0,390,1,0,39
163,D,110,S 793,8-Apr-2008,7:17 PM,"On Motion to Suspend the Rules and Pass, as Amended",Reauthorization of the Traumatic Brain Injury Act,Passed,180,1,0,17,212,0,0,20,0,0,0,0,392,1,0,37
164,D,110,H RES 1084,9-Apr-2008,1:00 PM,On Ordering the Previous Question,"Providing for consideration of the bill H.R. 2016, to establish the National Landscape Conservation System, and for other purposes",Passed,0,187,0,11,220,3,0,9,0,0,0,0,220,190,0,20
165,D,110,H RES 1084,9-Apr-2008,1:07 PM,On Agreeing to the Resolution,"Providing for consideration of the bill H.R. 2016, to establish the National Landscape Conservation System, and for other purposes",Passed,1,187,0,10,219,1,0,12,0,0,0,0,220,188,0,22
166,D,110,H RES 1077,9-Apr-2008,1:15 PM,On Motion to Suspend the Rules and Agree,"Calling on the Government of the People’s Republic of China to end its crackdown in Tibet and to enter into a substantive dialogue with His Holiness the Dalai Lama to find a negotiated solution that respects the distinctive language, culture, religious identity, and fundamental freedom of all Tibetans",Passed,189,1,0,8,224,0,0,9,0,0,0,0,413,1,0,17
167,D,110,H R 2016,9-Apr-2008,4:51 PM,On Agreeing to the Amendment,None,Agreed to,187,0,0,12,227,0,0,9,0,0,0,0,414,0,0,21
168,D,110,H R 2016,9-Apr-2008,5:00 PM,On Agreeing to the Amendment,None,Failed,170,23,0,6,5,223,0,8,0,0,0,0,175,246,0,14
169,D,110,H R 2016,9-Apr-2008,5:07 PM,On Agreeing to the Amendment,None,Failed,169,23,0,7,3,222,0,11,0,0,0,0,172,245,0,18
170,D,110,H R 2016,9-Apr-2008,5:17 PM,On Agreeing to the Amendment,None,Agreed to,189,3,0,7,144,86,0,6,0,0,0,0,333,89,0,13
171,D,110,H R 2016,9-Apr-2008,5:24 PM,On Agreeing to the Amendment,None,Agreed to,192,0,0,7,224,5,0,7,0,0,0,0,416,5,0,14
172,D,110,H R 2016,9-Apr-2008,5:34 PM,On Agreeing to the Amendment,None,Agreed to,177,14,0,8,37,193,0,6,0,0,0,0,214,207,0,14
173,D,110,H R 2016,9-Apr-2008,6:01 PM,On Motion to Recommit with Instructions,National Landscape Conservation System Act,Failed,189,3,0,6,19,209,0,4,0,0,0,0,208,212,0,10
174,D,110,H R 2016,9-Apr-2008,6:10 PM,On Passage,National Landscape Conservation System Act,Passed,50,140,0,8,228,0,0,4,0,0,0,0,278,140,0,12
175,D,110,H R 2419,9-Apr-2008,6:47 PM,On Motion to Instruct Conferees,"Farm, Nutrition, and Bioenergy Act",Passed,190,0,0,8,210,11,0,11,0,0,0,0,400,11,0,19
176,D,110,H R 5489,9-Apr-2008,6:54 PM,On Motion to Suspend the Rules and Pass,Congresswoman Jo Anne S. Davis Post Office,Passed,184,0,0,14,213,0,0,19,0,0,0,0,397,0,0,33
177,D,110,H R 5472,9-Apr-2008,7:00 PM,On Motion to Suspend the Rules and Pass,Julia M. Carson Post Office Building,Passed,187,0,0,11,214,0,0,18,0,0,0,0,401,0,0,29
178,D,110,JOURNAL,10-Apr-2008,11:30 AM,On Approving the Journal,None,Passed,13,175,1,9,215,7,0,10,0,0,0,0,228,182,1,19
179,D,110,H RES 1083,10-Apr-2008,11:50 AM,On Agreeing to the Resolution,"Providing for consideration of H.R. 2537, Beach Protection Act of 2007.",Passed,1,189,0,8,223,3,0,7,0,0,0,0,224,192,0,15
180,D,110,H RES 1038,10-Apr-2008,11:57 AM,On Motion to Suspend the Rules and Agree,Recognizing the fifth anniversary of the Department of Homeland Security and honoring the Department’s employees for their extraordinary efforts and contributions to protect and secure our Nation.,Passed,185,1,0,12,221,2,0,10,0,0,0,0,406,3,0,22
181,D,110,H RES 1092,10-Apr-2008,1:47 PM,On Agreeing to the Resolution,Relating to the consideration of the bill H.R. 5274 to implement the United States-Colombia Trade Promotion Agreement.,Passed,6,185,0,7,218,10,1,5,0,0,0,0,224,195,1,12
182,D,110,H R 2537,10-Apr-2008,4:32 PM,On Agreeing to the Amendment,None,Agreed to,159,14,0,26,104,103,1,29,0,0,0,0,263,117,1,55
183,D,110,H RES 886,14-Apr-2008,6:58 PM,"On Motion to Suspend the Rules and Agree, as Amended","Expressing sympathy to the victims and families of the tragic acts of violence in Colorado Springs, Colorado and Arvada, Colorado",Passed,176,0,0,22,204,0,0,29,0,0,0,0,380,0,0,51
184,D,110,H RES 994,14-Apr-2008,7:06 PM,"On Motion to Suspend the Rules and Agree, as Amended",National Glanzmann’s Thrombasthenia Awareness Day,Passed,176,0,0,22,201,0,0,32,0,0,0,0,377,0,0,54
185,D,110,H R 3548,14-Apr-2008,7:13 PM,"On Motion to Suspend the Rules and Pass, as Amended",Plain Language in Government Communications Act,Passed,174,1,0,23,202,0,0,31,0,0,0,0,376,1,0,54
186,D,110,H RES 1102,15-Apr-2008,4:12 PM,On Ordering the Previous Question,Providing for consideration of the bill H.R. 5719,Passed,0,191,0,7,220,5,0,8,0,0,0,0,220,196,0,15
187,D,110,H RES 1102,15-Apr-2008,4:20 PM,On Agreeing to the Resolution,Providing for consideration of the bill H.R. 5719,Passed,0,192,0,6,222,3,0,8,0,0,0,0,222,195,0,14
188,D,110,H R 5036,15-Apr-2008,4:28 PM,"On Motion to Suspend the Rules and Pass, as Amended",Emergency Assistance for Secure Elections Act of 2008,Failed,16,176,0,6,223,2,0,8,0,0,0,0,239,178,0,14
189,D,110,H R 5719,15-Apr-2008,6:21 PM,On Motion to Recommit with Instructions,Taxpayer Assistance and Simplification Act,Failed,189,3,0,6,21,207,0,6,0,0,0,0,210,210,0,12
190,D,110,H R 5719,15-Apr-2008,6:33 PM,On Passage,Taxpayer Assistance and Simplification Act,Passed,14,177,0,7,224,2,0,7,0,0,0,0,238,179,0,14
191,D,110,H R 5517,15-Apr-2008,6:40 PM,On Motion to Suspend the Rules and Pass,Texas Military Veterans Post Office,Passed,190,0,0,8,223,0,0,10,0,0,0,0,413,0,0,18
192,D,110,H RES 1103,16-Apr-2008,12:18 PM,On Ordering the Previous Question,"Providing for consideration of H.R. 2634, Jubilee Act for Responsible Lending and Expanded Debt Collection Act",Passed,0,191,0,7,217,5,0,11,0,0,0,0,217,196,0,18
193,D,110,H RES 1103,16-Apr-2008,12:25 PM,On Agreeing to the Resolution,"Providing for consideration of H.R. 2634, Jubilee Act for Responsible Lending and Expanded Debt Collection Act",Passed,1,189,0,8,219,1,0,13,0,0,0,0,220,190,0,21
194,D,110,H RES 1107,16-Apr-2008,12:32 PM,On Ordering the Previous Question,"Providing for consideration of H.R. 5715, Ensuring Continued Access to Student Loans Act",Passed,0,193,0,5,218,5,0,10,0,0,0,0,218,198,0,15
195,D,110,H RES 1107,16-Apr-2008,12:40 PM,On Agreeing to the Resolution,"Providing for consideration of H.R. 5715, Ensuring Continued Access to Student Loans Act",Passed,1,191,0,6,222,1,0,10,0,0,0,0,223,192,0,16
196,D,110,H R 2634,16-Apr-2008,2:35 PM,On Agreeing to the Amendment,None,Agreed to,195,0,0,4,229,0,0,8,0,0,0,0,424,0,0,12
197,D,110,H R 2634,16-Apr-2008,2:44 PM,On Agreeing to the Amendment,None,Agreed to,196,0,0,3,186,41,2,8,0,0,0,0,382,41,2,11
198,D,110,H R 2634,16-Apr-2008,3:21 PM,On Motion to Recommit with Instructions,Jubilee Act for Responsible Lending and Expanded Debt Collection Act,Passed,194,1,0,3,97,129,1,6,0,0,0,0,291,130,1,9
199,D,110,H R 2634,16-Apr-2008,3:29 PM,On Passage,Jubilee Act for Responsible Lending and Expanded Debt Collection Act,Passed,69,126,0,3,216,6,0,12,0,0,0,0,285,132,0,15
200,D,110,H R 5715,16-Apr-2008,4:28 PM,On Motion that the Committee Rise,Ensuring Continued Access to Student Loans Act,Passed,181,0,0,18,214,1,0,22,0,0,0,0,395,1,0,40
201,D,110,H R 2537,16-Apr-2008,5:03 PM,Sustaining the Ruling of the Chair,Beach Protection Act,Passed,1,190,0,8,215,3,0,19,0,0,0,0,216,193,0,27
202,D,110,H RES 1097,16-Apr-2008,5:21 PM,"On Motion to Suspend the Rules and Agree, as Amended",National Child Abuse Prevention Month,Passed,191,0,0,7,219,0,0,14,0,0,0,0,410,0,0,21
203,D,110,H R 5715,17-Apr-2008,1:45 PM,On Agreeing to the Amendment,None,Agreed to,189,0,0,10,224,0,0,13,0,0,0,0,413,0,0,23
204,D,110,H R 5715,17-Apr-2008,2:09 PM,On Passage,Ensuring Continued Access to Student Loans Act,Passed,161,27,0,10,222,0,0,11,0,0,0,0,383,27,0,21
205,D,110,H RES 981,22-Apr-2008,7:03 PM,"On Motion to Suspend the Rules and Agree, As Amended",Recognizing World Glaucoma Day,Passed,179,0,0,19,208,0,0,25,0,0,0,0,387,0,0,44
206,D,110,H R 5151,22-Apr-2008,7:10 PM,"On Motion to Suspend the Rules and Pass, as Amended",Wild Monongahela Act: A National Legacy for West Virginia’s Special Places,Passed,161,17,0,20,207,0,0,26,0,0,0,0,368,17,0,46
207,D,110,H R 831,22-Apr-2008,7:17 PM,"On Motion to Suspend the Rules and Pass, as Amended",Coffman Cove Administrative Site Conveyance Act of 2008,Passed,176,0,0,22,206,0,0,27,0,0,0,0,382,0,0,49
208,D,110,ADJOURN,23-Apr-2008,3:24 PM,On Motion to Adjourn,None,Failed,50,130,0,18,7,215,0,11,0,0,0,0,57,345,0,29
209,D,110,H R 5613,23-Apr-2008,3:52 PM,"On Motion to Suspend the Rules and Pass, as Amended",Protecting the Medicaid Safety Net Act of 2008,Passed,128,62,0,8,221,0,0,12,0,0,0,0,349,62,0,20
210,D,110,H CON RES 322,23-Apr-2008,4:01 PM,On Motion to Suspend the Rules and Agree,Recognizing the 60th Anniversary of the founding of the modern State of Israel.,Passed,192,0,0,6,225,0,0,9,0,0,0,0,417,0,0,15
211,D,110,H RES 1125,23-Apr-2008,4:12 PM,On Ordering the Previous Question,"Providing for the consideration of H.R. 5819, to amend the Small Business Act to improve the Small Business Innovation Research (SBIR) program and the Small Business Technology Transfer (STTR) program",Passed,0,192,0,6,222,2,0,9,0,0,0,0,222,194,0,15
212,D,110,H RES 1125,23-Apr-2008,4:20 PM,On Agreeing to the Resolution,"Providing for the consideration of H.R. 5819, to amend the Small Business Act to improve the Small Business Innovation Research (SBIR) program and the Small Business Technology Transfer (STTR) program",Passed,0,190,0,8,221,0,0,12,0,0,0,0,221,190,0,20
213,D,110,H R 5819,23-Apr-2008,7:17 PM,On Agreeing to the Amendment,None,Agreed to,132,48,0,19,223,0,0,14,0,0,0,0,355,48,0,33
214,D,110,H R 5819,23-Apr-2008,7:26 PM,On Agreeing to the Amendment,None,Agreed to,183,0,0,16,222,0,0,15,0,0,0,0,405,0,0,31
215,D,110,H R 5819,23-Apr-2008,7:33 PM,On Agreeing to the Amendment,None,Agreed to,184,0,0,15,222,0,3,12,0,0,0,0,406,0,3,27
216,D,110,H R 5819,23-Apr-2008,8:08 PM,On Motion to Recommit with Instructions,SBIR/STTR Reauthorization Act,Failed,186,0,0,12,9,215,0,9,0,0,0,0,195,215,0,21
217,D,110,H R 5819,23-Apr-2008,8:15 PM,On Passage,SBIR/STTR Reauthorization Act,Passed,149,38,0,11,219,5,0,9,0,0,0,0,368,43,0,20
218,D,110,H RES 1126,23-Apr-2008,8:23 PM,On Ordering the Previous Question,"Providing for the consideration of H. R. 2830, Coast Guard Authorization Act",Passed,1,185,0,12,219,2,0,12,0,0,0,0,220,187,0,24
219,D,110,H RES 1126,23-Apr-2008,8:30 PM,On Agreeing to the Resolution,"Providing for the consideration of H. R. 2830, Coast Guard Authorization Act",Passed,5,181,0,12,218,2,0,13,0,0,0,0,223,183,0,25
220,D,110,H R 2830,24-Apr-2008,2:21 PM,On Agreeing to the Amendment,None,Agreed to,182,1,0,16,226,0,0,11,0,0,0,0,408,1,0,27
221,D,110,H R 2830,24-Apr-2008,2:30 PM,On Agreeing to the Amendment,None,Agreed to,184,0,0,15,224,0,0,13,0,0,0,0,408,0,0,28
222,D,110,H R 2830,24-Apr-2008,3:04 PM,On Motion to Recommit with Instructions,Coast Guard Authorization for 2008,Failed,173,10,0,15,22,198,0,13,0,0,0,0,195,208,0,28
223,D,110,H R 2830,24-Apr-2008,3:13 PM,On Passage,Coast Guard Authorization for 2008,Passed,175,7,0,16,220,0,0,13,0,0,0,0,395,7,0,29
224,D,110,H RES 1079,29-Apr-2008,6:58 PM,On Motion to Suspend the Rules and Agree,Supporting the goals and ideals of Financial Literacy Month 2008,Passed,186,2,0,10,216,0,0,17,0,0,0,0,402,2,0,27
225,D,110,H R 4332,29-Apr-2008,7:09 PM,On Motion to Suspend the Rules and Pass,Financial Consumer Hotline Act of 2007,Passed,186,1,0,11,222,0,0,11,0,0,0,0,408,1,0,22
226,D,110,S 2739,29-Apr-2008,7:18 PM,On Motion to Suspend the Rules and Pass,Consolidated Natural Resources Act of 2008,Passed,70,117,0,11,221,0,0,12,0,0,0,0,291,117,0,23
227,D,110,H RES 1157,30-Apr-2008,4:27 PM,On Ordering the Previous Question,"Providing for the consideration of H.R. 5522, the “Combustable Dust Explosion and Fire Prevention Act”",Passed,0,193,0,5,226,1,0,6,0,0,0,0,226,194,0,11
228,D,110,H RES 1157,30-Apr-2008,4:35 PM,On Agreeing to the Resolution,"Providing for the consideration of H.R. 5522, the “Combustable Dust Explosion and Fire Prevention Act”",Passed,0,192,0,6,222,1,0,10,0,0,0,0,222,193,0,16
229,D,110,H R 1195,30-Apr-2008,4:44 PM,On Motion to Suspend the Rules and Agree to the Senate Amendment,SAFETEA-LU Technical Corrections Act,Passed,138,51,6,3,220,0,5,8,0,0,0,0,358,51,11,11
230,D,110,H R 5522,30-Apr-2008,6:06 PM,On Agreeing to the Amendment,None,Agreed to,187,0,0,12,225,0,0,12,0,0,0,0,412,0,0,24
231,D,110,H R 5522,30-Apr-2008,6:15 PM,On Agreeing to the Amendment,None,Failed,175,11,1,12,3,226,0,8,0,0,0,0,178,237,1,20
232,D,110,H R 5522,30-Apr-2008,6:48 PM,On Motion to Recommit with Instructions,Combustible Dust Explosion and Fire Prevention Act,Failed,184,3,0,11,3,222,0,8,0,0,0,0,187,225,0,19
233,D,110,H R 5522,30-Apr-2008,6:56 PM,On Passage,Combustible Dust Explosion and Fire Prevention Act,Passed,22,165,0,11,225,0,0,8,0,0,0,0,247,165,0,19
234,D,110,H R 493,1-May-2008,12:40 PM,On Motion to Agree to the Senate Amendment,Genetic Information Nondiscrimination Act of 2008,Passed,188,1,0,9,226,0,0,7,0,0,0,0,414,1,0,16
235,D,110,H RES 1167,1-May-2008,12:48 PM,On Ordering the Previous Question,Providing for consideration of motions to suspend the rules,Passed,0,189,0,9,226,1,0,6,0,0,0,0,226,190,0,15
236,D,110,H RES 1167,1-May-2008,12:57 PM,On Agreeing to the Resolution,Providing for consideration of motions to suspend the rules,Passed,2,188,0,8,226,1,0,6,0,0,0,0,228,189,0,14
237,D,110,H CON RES 308,1-May-2008,1:04 PM,On Motion to Suspend the Rules and Agree,Authorizing the use of the Capitol Grounds for the National Peace Officers’ Memorial Service.,Passed,188,0,0,10,224,0,0,9,0,0,0,0,412,0,0,19
238,D,110,H R 2419,1-May-2008,2:10 PM,On Motion to Instruct Conferees,"Farm, Nutrition, and Bioenergy Act",Failed,104,86,0,8,53,173,0,7,0,0,0,0,157,259,0,15
239,D,110,H R 5715,1-May-2008,2:17 PM,Suspend Rules and Agree to Senate Amendments,Ensuring Continued Access to Student Loans Act,Passed,167,21,0,10,221,0,0,12,0,0,0,0,388,21,0,22
240,D,110,H RES 952,5-May-2008,7:05 PM,On Motion to Suspend the Rules and Agree,To establish a National Teacher’s Day,Passed,167,0,0,31,201,0,0,32,0,0,0,0,368,0,0,63
241,D,110,H RES 952,5-May-2008,7:12 PM,Table motion to reconsider,To establish a National Teacher’s Day,Passed,0,168,0,30,202,0,0,31,0,0,0,0,202,168,0,61
242,D,110,H RES 1011,5-May-2008,7:21 PM,"On Motion to Suspend the Rules and Agree, as Amended","Calling on the United States Government and the international community to promptly develop, fund, and implement a comprehensive regional strategy to protect civilians, facilitate humanitarian operations, contain and reduce violence, and contribute to conditions for sustainable peace and good governance in Chad",Passed,169,0,0,29,202,0,0,31,0,0,0,0,371,0,0,60
243,D,110,H RES 1011,5-May-2008,7:28 PM,Table Motion to Reconsider,"Calling on the United States Government and the international community to promptly develop, fund, and implement a comprehensive regional strategy to protect civilians, facilitate humanitarian operations, contain and reduce violence, and contribute to conditions for sustainable peace and good governance in Chad",Passed,0,168,0,30,199,0,0,34,0,0,0,0,199,168,0,64
244,D,110,ADJOURN,5-May-2008,7:45 PM,On Motion to Adjourn,None,Passed,6,164,0,28,193,4,0,36,0,0,0,0,199,168,0,64
245,D,110,ADJOURN,6-May-2008,1:04 PM,On Motion to Adjourn,None,Failed,151,37,0,10,1,218,0,14,0,0,0,0,152,255,0,24
246,D,110,JOURNAL,6-May-2008,1:15 PM,On Approving the Journal,None,Passed,15,170,1,12,205,12,0,16,0,0,0,0,220,182,1,28
247,D,110,H R 2419,6-May-2008,1:37 PM,On Motion to Instruct Conferees,"Farm, Nutrition, and Bioenergy Act",Failed,141,49,0,8,31,192,0,11,0,0,0,0,172,241,0,19
248,D,110,H R 2419,6-May-2008,1:44 PM,Table Motion to Reconsider,"Farm, Nutrition, and Bioenergy Act",Passed,2,176,0,20,201,0,0,33,0,0,0,0,203,176,0,53
249,D,110,H R 3658,6-May-2008,3:48 PM,On Motion to Suspend the Rules and Pass,To amend the Foreign Service Act of 1980 to permit rest and recuperation travel to United States territories for members of the Foreign Service,Passed,191,0,0,7,225,0,0,9,0,0,0,0,416,0,0,16
250,D,110,H R 3658,6-May-2008,3:56 PM,Table Motion to Reconsider,To amend the Foreign Service Act of 1980 to permit rest and recuperation travel to United States territories for members of the Foreign Service,Passed,0,190,0,8,226,0,0,8,0,0,0,0,226,190,0,16
251,D,110,H CON RES 317,6-May-2008,4:03 PM,"On Motion to Suspend the Rules and Agree, as Amended",Condemning the Burmese regime’s undemocratic constitution and scheduled referendum,Passed,189,1,0,8,224,0,0,10,0,0,0,0,413,1,0,18
252,D,110,H CON RES 317,6-May-2008,4:11 PM,Table Motion to Reconsider,Condemning the Burmese regime’s undemocratic constitution and scheduled referendum,Passed,0,190,0,8,225,0,0,9,0,0,0,0,225,190,0,17
253,D,110,H RES 1109,6-May-2008,4:19 PM,"On Motion to Suspend the Rules and Agree, as Amended",Honoring the memory of Dith Pran by remembering his life’s work and continuing to acknowledge and remember the victims of genocides that have taken place around the globe,Passed,189,1,0,8,224,0,0,10,0,0,0,0,413,1,0,18
254,D,110,H RES 1109,6-May-2008,4:27 PM,Table Motion to Reconsider,Honoring the memory of Dith Pran by remembering his life’s work and continuing to acknowledge and remember the victims of genocides that have taken place around the globe,Passed,2,186,0,10,223,0,0,11,0,0,0,0,225,186,0,21
255,D,110,ADJOURN,6-May-2008,4:45 PM,On Motion to Adjourn,None,Failed,143,48,0,7,2,223,0,9,0,0,0,0,145,271,0,16
256,D,110,S 2929,6-May-2008,4:52 PM,"On Motion to Suspend the Rules and Pass, as Amended",To temporarily extend the programs under the Higher Education Act of 1965,Passed,187,0,0,11,221,0,0,13,0,0,0,0,408,0,0,24
257,D,110,S 2929,6-May-2008,5:01 PM,Table Motion to Reconsider,To temporarily extend the programs under the Higher Education Act of 1965,Passed,0,189,0,9,223,0,0,11,0,0,0,0,223,189,0,20
258,D,110,H R 2419,6-May-2008,5:09 PM,On Motion to Instruct Conferees,"Farm, Nutrition, and Bioenergy Act",Failed,39,150,0,9,101,124,0,9,0,0,0,0,140,274,0,18
259,D,110,H R 2419,6-May-2008,5:16 PM,Table Motion to Reconsider,"Farm, Nutrition, and Bioenergy Act",Passed,0,191,0,7,221,1,0,12,0,0,0,0,221,192,0,19
260,D,110,ADJOURN,6-May-2008,5:33 PM,On Motion to Adjourn,None,Failed,147,41,0,10,2,210,0,22,0,0,0,0,149,251,0,32
261,D,110,ADJOURN,6-May-2008,6:23 PM,On Motion to Adjourn,None,Failed,134,44,0,20,4,204,0,26,0,0,0,0,138,248,0,46
262,D,110,ADJOURN,6-May-2008,7:00 PM,On Motion to Adjourn,None,Failed,147,33,0,18,2,203,0,29,0,0,0,0,149,236,0,47
263,D,110,H RES 1168,6-May-2008,7:12 PM,"On Motion to Suspend the Rules and Agree, as Amended","Congratulating charter schools and their students, parents, teachers, and administrators across the United States for their ongoing contributions to education, and for other purposes",Passed,181,0,0,17,210,2,1,21,0,0,0,0,391,2,1,38
264,D,110,H RES 1168,6-May-2008,7:19 PM,Table Motion to Reconsider,"Congratulating charter schools and their students, parents, teachers, and administrators across the United States for their ongoing contributions to education, and for other purposes",Passed,0,182,0,16,215,0,0,19,0,0,0,0,215,182,0,35
265,D,110,H RES 1155,6-May-2008,7:26 PM,"On Motion to Suspend the Rules and Agree, as Amended",Honoring the recipients of the El Dorado Promise scholarship,Passed,179,1,0,18,211,0,0,23,0,0,0,0,390,1,0,41
266,D,110,H RES 1155,6-May-2008,7:34 PM,Table Motion to Reconsider,Honoring the recipients of the El Dorado Promise scholarship,Passed,0,180,0,18,216,0,0,18,0,0,0,0,216,180,0,36
267,D,110,ADJOURN,7-May-2008,11:04 AM,On Motion to Adjourn,None,Failed,130,54,0,14,2,215,0,17,0,0,0,0,132,269,0,31
268,D,110,JOURNAL,7-May-2008,11:32 AM,On Approving the Journal,None,Passed,14,173,1,11,215,11,0,8,0,0,0,0,229,184,1,19
269,D,110,H RES 1166,7-May-2008,11:44 AM,On Motion to Suspend the Rules and Agree,Expressing the sense of the House of Representatives regarding provocative and dangerous statements and actions taken by the Government of the Russian Federation that undermine the territorial integrity of the Republic of Georgia,Passed,173,15,0,11,217,8,2,7,0,0,0,0,390,23,2,18
270,D,110,H RES 1166,7-May-2008,11:54 AM,Table Motion to Reconsider,Expressing the sense of the House of Representatives regarding provocative and dangerous statements and actions taken by the Government of the Russian Federation that undermine the territorial integrity of the Republic of Georgia,Passed,0,185,0,14,218,6,0,10,0,0,0,0,218,191,0,24
271,D,110,ADJOURN,7-May-2008,12:11 PM,On Motion to Adjourn,None,Failed,138,44,0,17,2,202,0,30,0,0,0,0,140,246,0,47
272,D,110,ADJOURN,7-May-2008,1:18 PM,On Motion to Adjourn,None,Failed,141,46,0,12,3,204,0,27,0,0,0,0,144,250,0,39
273,D,110,ADJOURN,7-May-2008,2:10 PM,On Motion to Adjourn,None,Failed,138,47,0,14,0,225,0,9,0,0,0,0,138,272,0,23
274,D,110,H RES 1113,7-May-2008,2:19 PM,On Motion to Suspend the Rules and Agree,Celebrating the role of mothers in the United States and supporting the goals and ideals of Mother’s Day,Passed,189,0,0,10,223,0,0,11,0,0,0,0,412,0,0,21
275,D,110,H RES 1113,7-May-2008,2:27 PM,Table Motion to Reconsider,Celebrating the role of mothers in the United States and supporting the goals and ideals of Mother’s Day,Passed,13,178,0,8,224,0,0,10,0,0,0,0,237,178,0,18
276,D,110,ADJOURN,7-May-2008,2:46 PM,On Motion to Adjourn,None,Failed,143,50,0,6,3,226,0,5,0,0,0,0,146,276,0,11
277,D,110,H R 5937,7-May-2008,2:56 PM,On Motion to Suspend the Rules and Pass,To facilitate the preservation of certain affordable housing dwelling units,Passed,119,73,0,7,226,0,0,8,0,0,0,0,345,73,0,15
278,D,110,H R 5937,7-May-2008,3:04 PM,Table Motion to Reconsider,To facilitate the preservation of certain affordable housing dwelling units,Passed,1,188,0,10,224,2,0,8,0,0,0,0,225,190,0,18
279,D,110,ADJOURN,7-May-2008,3:23 PM,On Motion to Adjourn,None,Failed,132,52,0,15,5,208,0,21,0,0,0,0,137,260,0,36
280,D,110,ADJOURN,7-May-2008,4:51 PM,On Motion to Adjourn,None,Failed,137,52,0,10,1,211,0,22,0,0,0,0,138,263,0,32
281,D,110,H RES 1175,7-May-2008,5:23 PM,On Ordering the Previous Question,Providing for consideration of the Senate amendments to H.R. 3221.,Passed,1,195,0,3,225,3,0,6,0,0,0,0,226,198,0,9
282,D,110,H RES 1175,7-May-2008,5:30 PM,Table Motion to Reconsider,Providing for consideration of the Senate amendments to H.R. 3221.,Passed,1,192,0,6,224,0,0,10,0,0,0,0,225,192,0,16
283,D,110,H RES 1175,7-May-2008,5:39 PM,On Agreeing to the Resolution,Providing for consideration of the Senate amendments to H.R. 3221.,Passed,1,196,0,2,223,2,1,8,0,0,0,0,224,198,1,10
284,D,110,H RES 1175,7-May-2008,5:47 PM,Table Motion to Reconsider,Providing for consideration of the Senate amendments to H.R. 3221.,Passed,0,196,0,3,227,0,0,7,0,0,0,0,227,196,0,10
285,D,110,ADJOURN,7-May-2008,6:17 PM,On Motion to Adjourn,None,Failed,108,87,0,4,3,224,0,7,0,0,0,0,111,311,0,11
286,D,110,ADJOURN,7-May-2008,6:51 PM,On Motion to Adjourn,None,Failed,140,49,0,10,3,223,0,8,0,0,0,0,143,272,0,18
287,D,110,H RES 1174,7-May-2008,7:01 PM,On Ordering the Previous Question,"Providing for consideration of the bill, H.R. 5818, to authorize the Secretary of Housing and Urban Development to make loans to States to acquire foreclosed housing and to make grants to States for related costs",Passed,1,186,0,12,219,1,0,14,0,0,0,0,220,187,0,26
288,D,110,H RES 1174,7-May-2008,7:12 PM,Table Motion to Reconsider,"Providing for consideration of the bill, H.R. 5818, to authorize the Secretary of Housing and Urban Development to make loans to States to acquire foreclosed housing and to make grants to States for related costs",Passed,4,186,0,9,222,0,0,12,0,0,0,0,226,186,0,21
289,D,110,H RES 1174,7-May-2008,7:19 PM,On Agreeing to the Resolution,"Providing for consideration of the bill, H.R. 5818, to authorize the Secretary of Housing and Urban Development to make loans to States to acquire foreclosed housing and to make grants to States for related costs",Passed,1,190,0,8,222,2,0,10,0,0,0,0,223,192,0,18
290,D,110,H RES 1174,7-May-2008,7:26 PM,Table Motion to Reconsider,"Providing for consideration of the bill, H.R. 5818, to authorize the Secretary of Housing and Urban Development to make loans to States to acquire foreclosed housing and to make grants to States for related costs",Passed,1,183,0,15,211,0,0,23,0,0,0,0,212,183,0,38
291,D,110,ADJOURN,7-May-2008,7:44 PM,On Motion to Adjourn,None,Failed,136,50,0,13,4,214,0,16,0,0,0,0,140,264,0,29
292,D,110,H R 5818,7-May-2008,9:32 PM,On Motion That The Committee Rise,Neighborhood Stabilization Act of 2008,Failed,182,8,0,10,2,223,0,13,0,0,0,0,184,231,0,23
293,D,110,H R 5818,7-May-2008,9:40 PM,On Agreeing to the Amendment,None,Agreed to,31,157,0,12,225,0,0,13,0,0,0,0,256,157,0,25
294,D,110,H R 5818,7-May-2008,9:50 PM,On Agreeing to the Amendment,None,Agreed to,194,0,0,6,231,0,0,7,0,0,0,0,425,0,0,13
295,D,110,H R 5818,8-May-2008,10:45 AM,On Agreeing to the Amendment,None,Failed,188,7,0,5,2,212,0,24,0,0,0,0,190,219,0,29
296,D,110,MOTION,8-May-2008,11:21 AM,Sustaining the Ruling of the Chair,None,Passed,5,182,6,7,230,0,0,8,0,0,0,0,235,182,6,15
297,D,110,H R 5818,8-May-2008,11:30 AM,On Agreeing to the Amendment,None,Agreed to,194,3,0,3,197,30,0,11,0,0,0,0,391,33,0,14
298,D,110,H R 5818,8-May-2008,12:06 PM,On Motion to Recommit with Instructions,Neighborhood Stabilization Act of 2008,Failed,196,1,0,2,14,215,0,5,0,0,0,0,210,216,0,7
299,D,110,H R 5818,8-May-2008,12:16 PM,On Passage,Neighborhood Stabilization Act of 2008,Passed,11,187,0,1,228,1,0,5,0,0,0,0,239,188,0,6
300,D,110,H R 4279,8-May-2008,12:22 PM,"On Motion to Suspend the Rules and Pass, as Amended",Prioritizing Resources and Organization for Intellectual Property Act of 2008,Passed,186,7,0,6,224,4,0,6,0,0,0,0,410,11,0,12
301,D,110,H R 3221,8-May-2008,4:19 PM,On Agreeing to the Senate Amendment with Amendment No. 1,Foreclosure Prevention Act of 2008,Passed,39,154,0,6,227,0,0,7,0,0,0,0,266,154,0,13
302,D,110,H R 3221,8-May-2008,4:27 PM,On Agreeing to the Senate Amendment with Amendment No. 2,Foreclosure Prevention Act of 2008,Passed,95,94,0,10,227,0,0,7,0,0,0,0,322,94,0,17
303,D,110,H R 3221,8-May-2008,4:33 PM,On Agreeing to the Senate Amendment with Amendment No. 3,Foreclosure Prevention Act of 2008,Passed,31,159,0,9,225,1,0,8,0,0,0,0,256,160,0,17
304,D,110,H R 2419,8-May-2008,4:39 PM,On Flake Motion to Instruct Conferees,"Farm, Nutrition, and Bioenergy Act",Failed,104,79,0,16,24,195,0,15,0,0,0,0,128,274,0,31
305,D,110,H R 2419,8-May-2008,4:46 PM,On Cantor Motion to Instruct Conferees,"Farm, Nutrition, and Bioenergy Act",Failed,161,18,0,20,8,204,0,22,0,0,0,0,169,222,0,42
306,D,110,H RES 1181,13-May-2008,7:01 PM,On Motion to Suspend the Rules and Agree,Expressing condolences and sympathy to the people of Burma for the grave loss of life and vast destruction caused by Cyclone Nargis,Passed,186,1,0,12,224,0,0,10,0,0,0,0,410,1,0,22
307,D,110,H R 6022,13-May-2008,7:13 PM,On Motion to Suspend the Rules and Pass,Strategic Petroleum Reserve Fill Suspension and Consumer Protection Act,Passed,162,25,0,12,223,0,0,11,0,0,0,0,385,25,0,23
308,D,110,H R 4008,13-May-2008,7:23 PM,On Motion to Suspend the Rules and Pass,Credit and Debit Card Receipt Clarification Act of 2007,Passed,185,0,0,14,222,0,0,12,0,0,0,0,407,0,0,26
309,D,110,H RES 1189,14-May-2008,11:51 AM,Will the House Now Consider the Resolution,"Providing for consideration of the conference report to accompany H.R. 2419, the Farm, Nutrition, and Bioenergy Act",Passed,2,186,0,11,226,3,0,5,0,0,0,0,228,189,0,16
310,D,110,H RES 1189,14-May-2008,1:35 PM,On Ordering the Previous Question,"Providing for consideration of the conference report to accompany H.R. 2419, the Farm, Nutrition, and Bioenergy Act",Passed,5,185,0,9,227,3,0,4,0,0,0,0,232,188,0,13
311,D,110,H RES 1189,14-May-2008,1:45 PM,On Agreeing to the Resolution,"Providing for consideration of the conference report to accompany H.R. 2419, the Farm, Nutrition, and Bioenergy Act",Passed,0,189,0,10,228,4,0,2,0,0,0,0,228,193,0,12
312,D,110,H RES 1134,14-May-2008,1:53 PM,On Motion to Suspend the Rules and Agree,Supporting the goals and ideals of Mental Health Month,Passed,189,0,0,10,232,0,0,2,0,0,0,0,421,0,0,12
313,D,110,H RES 1176,14-May-2008,2:01 PM,On Motion to Suspend the Rules and Agree,Supporting the goals and ideals of National Train Day,Passed,187,0,0,12,228,0,0,6,0,0,0,0,415,0,0,18
314,D,110,H R 2419,14-May-2008,4:01 PM,Recommit Conference Report with Instructions,"Farm, Nutrition, and Bioenergy Act",Failed,184,6,0,9,9,224,0,2,0,0,0,0,193,230,0,11
315,D,110,H R 2419,14-May-2008,4:07 PM,On Agreeing to the Conference Report,"Farm, Nutrition, and Bioenergy Act",Passed,100,91,0,8,218,15,0,2,0,0,0,0,318,106,0,10
316,D,110,H RES 1133,14-May-2008,4:18 PM,"On Motion to Suspend the Rules and Agree, as Amended",Congratulating Winona State University on winning the 2008 Division II men’s basketball championships,Passed,187,0,0,12,226,0,0,8,0,0,0,0,413,0,0,20
317,D,110,H RES 1190,14-May-2008,5:11 PM,On Ordering the Previous Question,"Providing for the adoption of the concurrent resolution, S. Con. Res. 70, the Congressional Budget Act",Passed,7,179,0,13,218,8,0,8,0,0,0,0,225,187,0,21
318,D,110,H RES 1190,14-May-2008,5:19 PM,On Agreeing to the Resolution,"Providing for the adoption of the concurrent resolution, S. Con. Res. 70, the Congressional Budget Act",Passed,0,189,0,10,214,14,0,7,0,0,0,0,214,203,0,17
319,D,110,H RES 1173,14-May-2008,5:28 PM,On Motion to Suspend the Rules and Agree,Recognizing AmeriCorps Week,Passed,119,69,0,11,225,0,0,9,0,0,0,0,344,69,0,20
320,D,110,H R 4040,14-May-2008,7:07 PM,On Motion to Instruct Conferees,Consumer Product Saftey Commission Reform Act,Passed,183,0,0,16,222,0,0,12,0,0,0,0,405,0,0,28
321,D,110,S CON RES 70,14-May-2008,7:16 PM,On Motion to Instruct Conferees,The Congressional Budget Resolution,Failed,171,17,0,11,14,212,0,8,0,0,0,0,185,229,0,19
322,D,110,H RES 789,14-May-2008,7:24 PM,"On Motion to Suspend the Rules and Agree, as Amended","Honoring public child welfare agencies, nonprofit organizations and private entities providing services for foster children",Passed,188,0,0,11,226,0,0,8,0,0,0,0,414,0,0,19
323,D,110,H RES 1197,15-May-2008,11:57 AM,On Ordering the Previous Question,"Providing for consideration of the Senate amendment to H.R. 2642, Military Construction and Veterans Affairs and Related Agencies Appropriations Act",Passed,0,191,0,8,224,4,0,6,0,0,0,0,224,195,0,14
324,D,110,H RES 1197,15-May-2008,12:05 PM,On Agreeing to the Resolution,"Providing for consideration of the Senate amendment to H.R. 2642, Military Construction and Veterans Affairs and Related Agencies Appropriations Act",Passed,0,192,0,7,221,8,0,5,0,0,0,0,221,200,0,12
325,D,110,H R 5614,15-May-2008,12:13 PM,"On Motion to Suspend the Rules and Pass, as Amended",Original Saint-Gaudens Double Eagle Ultra-High Relief Palladium Bullion Coin Act,Passed,189,0,0,10,226,0,0,8,0,0,0,0,415,0,0,18
326,D,110,H R 406,15-May-2008,12:20 PM,"On Motion to Suspend the Rules and Pass, as Amended",Alice Paul Women’s Suffrage Congressional Gold Medal Act,Passed,187,1,0,11,225,0,0,9,0,0,0,0,412,1,0,20
327,D,110,H R 5872,15-May-2008,12:29 PM,"On Motion to Suspend the Rules and Pass, as Amended",Boy Scouts of America Centennial Commemorative Coin Act,Passed,187,0,0,12,216,8,0,10,0,0,0,0,403,8,0,22
328,D,110,H R 2642,15-May-2008,3:30 PM,On Agreeing to the Senate Amendment With Amendment No. 1,Military Construction and Veterans Affairs and Related Agencies Appropriations Act,Failed,56,2,132,9,85,147,0,3,0,0,0,0,141,149,132,12
329,D,110,H R 2642,15-May-2008,3:37 PM,On Agreeing to the Senate Amendment With Amendment No. 2,Military Construction and Veterans Affairs and Related Agencies Appropriations Act,Passed,8,183,0,8,219,13,0,3,0,0,0,0,227,196,0,11
330,D,110,H R 2642,15-May-2008,3:45 PM,On Agreeing to the Senate Amendment With Amendment No. 3,Military Construction and Veterans Affairs and Related Agencies Appropriations Act,Passed,32,159,0,8,224,7,0,4,0,0,0,0,256,166,0,12
331,D,110,H R 6081,20-May-2008,1:11 PM,"On Motion to Suspend the Rules and Pass, as Amended",Heroes Earnings Assistance and Relief Tax Act,Passed,184,0,0,15,219,0,0,15,0,0,0,0,403,0,0,30
332,D,110,H R 6074,20-May-2008,1:28 PM,On Motion to Suspend the Rules and Pass,Gas Price Relief for Consumers Act,Passed,103,82,0,14,221,2,0,12,0,0,0,0,324,84,0,26
333,D,110,H RES 1144,20-May-2008,1:37 PM,"On Motion to Suspend the Rules and Agree, as Amended","Expressing support for designation of a “Frank Sinatra Day” on May 13, 2008, in honor of the dedication of the Frank Sinatra commemorative stamp",Passed,180,3,0,16,222,0,0,13,0,0,0,0,402,3,0,29
334,D,110,H CON RES 355,20-May-2008,5:09 PM,On Agreeing to the Resolution,Providing for an adjournment or recess of the two Houses,Passed,19,167,0,13,220,8,0,7,0,0,0,0,239,175,0,20
335,D,110,H R 1464,20-May-2008,5:17 PM,"On Motion to Suspend the Rules and Pass, as Amended",Great Cats and Rare Canids Act of 2007,Passed,67,118,0,14,227,1,0,7,0,0,0,0,294,119,0,21
336,D,110,H R 2649,20-May-2008,5:29 PM,"On Motion to Suspend the Rules and Pass, as Amended",Lake Hodges Surface Water Improvement and Reclamation Act of 2008,Passed,146,39,0,14,228,0,0,7,0,0,0,0,374,39,0,21
337,D,110,H R 2744,20-May-2008,5:37 PM,"On Motion to Suspend the Rules and Pass, as Amended",Airline Flight Crew Technical Corrections Act,Passed,176,9,0,14,226,0,0,9,0,0,0,0,402,9,0,23
338,D,110,H RES 1212,21-May-2008,1:22 PM,On Ordering the Previous Question,"Providing for consideration of H.R. 6049, Energy Production and Conservation and Individual Income Tax Relief",Passed,1,188,0,10,222,2,0,11,0,0,0,0,223,190,0,21
339,D,110,H RES 1212,21-May-2008,1:31 PM,On Agreeing to the Resolution,"Providing for consideration of H.R. 6049, Energy Production and Conservation and Individual Income Tax Relief",Passed,0,193,0,6,223,1,0,11,0,0,0,0,223,194,0,17
340,D,110,H RES 1213,21-May-2008,1:39 PM,On Ordering the Previous Question,"Providing for consideration of H.R. 5658, National Defense Authorization, 2009",Passed,9,185,0,5,226,1,0,8,0,0,0,0,235,186,0,13
341,D,110,H RES 1214,21-May-2008,1:46 PM,On Ordering the Previous Question,"Providing for consideration of the conference report to accompany S. Con. Res. 70, the Congressional Budget Act",Passed,8,183,0,8,221,3,0,11,0,0,0,0,229,186,0,19
342,D,110,H RES 1214,21-May-2008,1:54 PM,On Agreeing to the Resolution,"Providing for consideration of the conference report to accompany S. Con. Res. 70, the Congressional Budget Act",Passed,0,192,0,7,220,7,0,9,0,0,0,0,220,199,0,16
343,D,110,H R 6049,21-May-2008,4:00 PM,On Motion to Recommit with Instructions,Renewable Energy and Job Creation Act,Failed,194,0,0,5,7,220,0,8,0,0,0,0,201,220,0,13
344,D,110,H R 6049,21-May-2008,4:08 PM,On Passage,Renewable Energy and Job Creation Act,Passed,35,159,0,5,228,1,0,7,0,0,0,0,263,160,0,12
345,D,110,H R 1771,21-May-2008,4:16 PM,"On Motion to Suspend the Rules and Pass, as Amended",Crane Conservation Act of 2008,Passed,76,118,0,5,228,0,0,7,0,0,0,0,304,118,0,12
346,D,110,H R 2419,21-May-2008,6:09 PM,"Passage, Objections of the President Not Withstanding","Farm, Nutrition, and Bioenergy Act",Passed,100,94,0,5,216,14,0,6,0,0,0,0,316,108,0,11
347,D,110,H R 3819,21-May-2008,6:16 PM,"On Motion to Suspend the Rules and Pass, as Amended",Veterans Emergency Care Fairness Act of 2008,Passed,187,0,0,12,225,0,0,10,0,0,0,0,412,0,0,22
348,D,110,H R 5826,21-May-2008,6:23 PM,On Motion to Suspend the Rules and Pass,Veterans’ Compensation Cost-of-Living Adjustment Act of 2008,Passed,195,0,0,4,222,0,0,13,0,0,0,0,417,0,0,17
349,D,110,H R 5856,21-May-2008,7:09 PM,On Motion to Suspend the Rules and Pass,Department of Veterans Affairs Medical Facility Authorization and Lease Act,Passed,191,0,0,8,225,0,0,10,0,0,0,0,416,0,0,18
350,D,110,H RES 1218,22-May-2008,12:09 PM,On Ordering the Previous Question,"Providing for consideration of H.R. 5658, Department of Defense Authorization, 2009",Passed,2,191,0,6,226,1,0,8,0,0,0,0,228,192,0,14
351,D,110,H RES 1218,22-May-2008,12:18 PM,On Agreeing to the Resolution,"Providing for consideration of H.R. 5658, Department of Defense Authorization, 2009",Passed,0,193,0,6,223,4,0,8,0,0,0,0,223,197,0,14
352,D,110,H RES 1221,22-May-2008,12:42 PM,On Motion to Table,None,Passed,0,188,5,6,220,0,5,10,0,0,0,0,220,188,10,16
353,D,110,H R 6124,22-May-2008,1:33 PM,On Motion to Suspend the Rules and Pass,"To provide for the continuation of agricultural and other programs of the Department of Agriculture through the fiscal year 2012, and for other purposes",Passed,90,98,0,11,216,12,0,8,0,0,0,0,306,110,0,19
354,D,110,H RES 1194,22-May-2008,1:42 PM,On Motion to Suspend the Rules and Agree,"Reaffirming the support of the House of Representatives for the legitimate, democratically-elected Government of Lebanon under Prime Minister Fouad Siniora",Passed,187,1,0,11,214,9,2,10,0,0,0,0,401,10,2,21
355,D,110,H R 5658,22-May-2008,5:51 PM,On Agreeing to the Amendment,None,Failed,128,60,0,12,0,227,0,12,0,0,0,0,128,287,0,24
356,D,110,H R 5658,22-May-2008,5:55 PM,On Agreeing to the Amendment,None,Failed,174,14,0,12,12,215,0,12,0,0,0,0,186,229,0,24
357,D,110,H R 5658,22-May-2008,5:59 PM,On Agreeing to the Amendment,None,Failed,5,181,0,14,117,111,0,11,0,0,0,0,122,292,0,25
358,D,110,H R 5658,22-May-2008,6:04 PM,On Agreeing to the Amendment,None,Failed,144,44,0,12,1,227,0,11,0,0,0,0,145,271,0,23
359,D,110,H R 5658,22-May-2008,6:10 PM,On Agreeing to the Amendment,None,Agreed to,13,176,0,11,221,7,0,11,0,0,0,0,234,183,0,22
360,D,110,H R 5658,22-May-2008,6:14 PM,On Agreeing to the Amendment,None,Agreed to,20,167,0,13,225,1,0,13,0,0,0,0,245,168,0,26
361,D,110,H R 5658,22-May-2008,9:08 PM,On Agreeing to the Amendment,None,Agreed to,17,167,0,16,223,1,0,15,0,0,0,0,240,168,0,31
362,D,110,H R 5658,22-May-2008,9:15 PM,On Agreeing to the Amendment,None,Agreed to,15,169,0,16,203,23,0,13,0,0,0,0,218,192,0,29
363,D,110,H R 5658,22-May-2008,9:20 PM,On Agreeing to the Amendment,None,Agreed to,3,181,0,16,217,8,0,14,0,0,0,0,220,189,0,30
364,D,110,H R 5658,22-May-2008,9:52 PM,On Motion to Recommit with Instructions,Duncan Hunter National Defense Authorization Act for Fiscal Year 2009,Failed,184,1,0,14,2,222,0,11,0,0,0,0,186,223,0,25
365,D,110,H R 5658,22-May-2008,9:59 PM,On Passage,Duncan Hunter National Defense Authorization Act for Fiscal Year 2009,Passed,181,3,0,15,203,20,0,12,0,0,0,0,384,23,0,27
366,D,110,H RES 986,22-May-2008,10:06 PM,"On Motion to Suspend the Rules and Agree, as Amended","Recognizing the courage and sacrifice of those members of the United States Armed Forces who were held as prisoners of war during the Vietnam conflict and calling for a full accounting of the 1,729 members of the Armed Forces who remain unaccounted for from the Vietnam conflict",Passed,183,0,0,16,211,0,0,24,0,0,0,0,394,0,0,40
367,D,110,H CON RES 138,3-Jun-2008,6:57 PM,"On Motion to Suspend the Rules and Agree, as Amended",Supporting National Men’s Health Week,Passed,175,0,0,24,187,0,0,47,0,0,0,0,362,0,0,71
368,D,110,H RES 923,3-Jun-2008,7:04 PM,On Motion to Suspend the Rules and Agree,Recognizing the State of Minnesota’s 150th anniversary,Passed,175,0,0,24,188,0,0,46,0,0,0,0,363,0,0,70
369,D,110,H RES 1114,3-Jun-2008,7:11 PM,On Motion to Suspend the Rules and Agree,Supporting the goals and ideals of the Arbor Day Foundation and National Arbor Day,Passed,175,0,0,24,189,0,0,45,0,0,0,0,364,0,0,69
370,D,110,H RES 1234,4-Jun-2008,4:14 PM,On Ordering the Previous Question,"Providing for consideration of H.R. 3021, the 21st Century Green High-Performing Public School Facilities Act“",Passed,0,193,0,6,221,3,0,10,0,0,0,0,221,196,0,16
371,D,110,H RES 1234,4-Jun-2008,4:22 PM,On Agreeing to the Resolution,"Providing for consideration of H.R. 3021, the 21st Century Green High-Performing Public School Facilities Act“",Passed,1,192,0,6,222,1,0,11,0,0,0,0,223,193,0,17
372,D,110,H R 1343,4-Jun-2008,4:34 PM,"On Motion to Suspend the Rules and Pass, as Amended",Health Centers Renewal Act of 2007,Passed,169,24,0,6,224,0,0,10,0,0,0,0,393,24,0,16
373,D,110,H R 5669,4-Jun-2008,4:44 PM,On Motion to Suspend the Rules and Pass,"Poison Center Support, Enhancement, and Awareness Act of 2008",Passed,182,10,0,7,223,0,0,11,0,0,0,0,405,10,0,18
374,D,110,H R 3021,4-Jun-2008,7:41 PM,On Agreeing to the Amendment,None,Agreed to,41,150,0,9,219,1,0,18,0,0,0,0,260,151,0,27
375,D,110,H R 3021,4-Jun-2008,7:49 PM,On Agreeing to the Amendment,None,Agreed to,191,2,0,7,206,15,0,17,0,0,0,0,397,17,0,24
376,D,110,H R 3021,4-Jun-2008,7:57 PM,On Agreeing to the Amendment,None,Agreed to,187,5,0,8,222,0,0,16,0,0,0,0,409,5,0,24
377,D,110,H R 3021,4-Jun-2008,8:04 PM,On Agreeing to the Amendment,None,Agreed to,40,153,0,7,226,0,0,12,0,0,0,0,266,153,0,19
378,D,110,H R 3021,4-Jun-2008,8:37 PM,On Motion to Recommit with Instructions,21st Century Green High-Performing Public School Facilities Act,Failed,187,5,0,7,0,225,0,9,0,0,0,0,187,230,0,16
379,D,110,H R 3021,4-Jun-2008,8:46 PM,On Passage,21st Century Green High-Performing Public School Facilities Act,Passed,27,164,0,8,223,0,0,11,0,0,0,0,250,164,0,19
380,D,110,H RES 1233,5-Jun-2008,12:37 PM,On Ordering the Previous Question,"Providing for consideration of H.R. 5540, the Chesapeake Bay Gateways and Watertrails Network Continuing Authorization Act",Passed,0,192,0,7,221,2,0,11,0,0,0,0,221,194,0,18
381,D,110,H RES 1233,5-Jun-2008,12:46 PM,On Agreeing to the Resolution,"Providing for consideration of H.R. 5540, the Chesapeake Bay Gateways and Watertrails Network Continuing Authorization Act",Passed,0,195,0,4,225,0,0,9,0,0,0,0,225,195,0,13
382,D,110,S CON RES 70,5-Jun-2008,1:03 PM,On Agreeing to the Conference Report,The Congressional Budget Resolution,Passed,0,196,0,3,214,14,0,7,0,0,0,0,214,210,0,10
383,D,110,H R 5940,5-Jun-2008,1:10 PM,"On Motion to Suspend the Rules and Pass, as Amended",National Nanotechnology Initiative Amendments Act of 2008,Passed,184,6,0,9,223,0,0,11,0,0,0,0,407,6,0,20
384,D,110,H R 5540,5-Jun-2008,2:54 PM,On Agreeing to the Amendment,None,Failed,172,14,0,13,6,218,0,10,0,0,0,0,178,232,0,23
385,D,110,H R 5540,5-Jun-2008,3:22 PM,On Motion to Recommit with Instructions,Chesapeake Bay Gateways and Watertrails Network Continuing Authorization Act,Failed,179,3,0,17,2,220,0,12,0,0,0,0,181,223,0,29
386,D,110,H R 5540,5-Jun-2008,3:29 PM,On Passage,Chesapeake Bay Gateways and Watertrails Network Continuing Authorization Act,Passed,96,86,0,17,225,0,0,10,0,0,0,0,321,86,0,27
387,D,110,H R 3058,5-Jun-2008,3:44 PM,"On Motion to Suspend the Rules and Pass, as Amended",Public Land Communities Transition Act of 2007,Failed,16,174,0,9,202,19,2,12,0,0,0,0,218,193,2,21
388,D,110,H RES 1225,9-Jun-2008,6:56 PM,On Motion to Suspend the Rules and Agree,Expressing support for designation of June 2008 as “National Safety Month”,Passed,177,0,0,22,202,0,0,32,0,0,0,0,379,0,0,54
389,D,110,H RES 1243,9-Jun-2008,7:03 PM,On Motion to Suspend the Rules and Agree,"Recognizing the immeasurable contributions of fathers in the healthy development of children, supporting responsible fatherhood, and encouraging greater involvement of fathers in the lives of their children, especially on Father’s Day",Passed,174,0,0,25,199,0,0,35,0,0,0,0,373,0,0,60
390,D,110,H RES 127,9-Jun-2008,7:11 PM,On Motion to Suspend the Rules and Agree,Recognizing and celebrating the 50th anniversary of the entry of Alaska into the Union as the 49th State,Passed,174,0,0,25,201,0,0,33,0,0,0,0,375,0,0,58
391,D,110,H RES 1253,10-Jun-2008,1:10 PM,On Ordering the Previous Question,"Providing for the consideration of H.R. 6003, the Passenger Rail Investment and Improvement Act of 2008",Passed,5,183,0,11,222,2,0,10,0,0,0,0,227,185,0,21
392,D,110,H RES 1253,10-Jun-2008,1:22 PM,On Agreeing to the Resolution,"Providing for the consideration of H.R. 6003, the Passenger Rail Investment and Improvement Act of 2008",Passed,5,186,0,8,222,1,0,11,0,0,0,0,227,187,0,19
393,D,110,H R 6028,10-Jun-2008,1:31 PM,"On Motion to Suspend the Rules and Pass, as Amended",Merida Initiative to Combat Illicit Narcotics and Reduce Organized Crime Authorization Act,Passed,108,84,0,7,203,22,0,9,0,0,0,0,311,106,0,16
394,D,110,H RES 1063,10-Jun-2008,5:24 PM,On Motion to Suspend the Rules and Agree,"Marking the 225th anniversary of the Treaty of Paris of 1783, which ended the Revolutionary War",Passed,188,0,0,11,226,0,0,8,0,0,0,0,414,0,0,19
395,D,110,H CON RES 318,10-Jun-2008,5:31 PM,"On Motion to Suspend the Rules and Agree, as Amended",Supporting the goals and ideals of the International Year of Sanitation,Passed,190,0,1,8,221,0,0,13,0,0,0,0,411,0,1,21
396,D,110,H CON RES 336,10-Jun-2008,5:39 PM,On Motion to Suspend the Rules and Agree,Honoring the sacrifices and contributions made by disabled American veterans,Passed,192,0,0,7,225,0,0,9,0,0,0,0,417,0,0,16
397,D,110,H R 6003,11-Jun-2008,1:57 PM,On Agreeing to the Amendment,None,Failed,147,47,0,6,3,228,0,7,0,0,0,0,150,275,0,13
398,D,110,H R 6003,11-Jun-2008,2:15 PM,On Agreeing to the Amendment,None,Agreed to,67,126,0,6,228,1,0,5,0,0,0,0,295,127,0,11
399,D,110,H R 6003,11-Jun-2008,2:53 PM,On Motion to Recommit with Instructions,Passenger Rail Investment and Improvement Act,Failed,187,8,0,4,7,222,0,5,0,0,0,0,194,230,0,9
400,D,110,H R 6003,11-Jun-2008,2:59 PM,On Passage,Passenger Rail Investment and Improvement Act,Passed,87,104,0,8,224,0,0,10,0,0,0,0,311,104,0,18
401,D,110,H RES 1258,11-Jun-2008,3:08 PM,On Motion to Refer,The Kucinich Privilege Resolution,Passed,24,166,0,9,227,0,0,7,0,0,0,0,251,166,0,16
402,D,110,H RES 1235,11-Jun-2008,3:15 PM,On Motion to Suspend the Rules and Agree,"Expressing support for the designation of National D-Day Remembrance Day, and recognizing the spirit, courage, and sacrifice of men and women who fought and won World War II",Passed,191,0,0,8,215,0,0,19,0,0,0,0,406,0,0,27
403,D,110,H R 5749,11-Jun-2008,4:56 PM,"On Motion to Suspend the Rules and Pass, as Amended",Emergency Extended Unemployment Compensation Act of 2008,Failed,49,144,0,6,230,0,0,5,0,0,0,0,279,144,0,11
404,D,110,H RES 977,11-Jun-2008,5:03 PM,On Motion to Suspend the Rules and Agree,Expressing the sense of the House of Representatives that rebate checks would better stimulate the economy if spent on American-made products and services from American-owned companies,Passed,178,6,6,9,226,0,0,8,0,0,0,0,404,6,6,17
405,D,110,H RES 1257,12-Jun-2008,11:50 AM,On Ordering the Previous Question,"Providing for consideration of H.R. 6063, the National Aeronautics and Space Administration Authorization Act",Passed,9,180,0,10,217,3,0,14,0,0,0,0,226,183,0,24
406,D,110,H RES 1257,12-Jun-2008,11:59 AM,On Agreeing to the Resolution,"Providing for consideration of H.R. 6063, the National Aeronautics and Space Administration Authorization Act",Passed,0,187,0,12,221,1,0,12,0,0,0,0,221,188,0,24
407,D,110,H RES 1265,12-Jun-2008,12:05 PM,On Ordering the Previous Question,"Providing for consideration of H.R. 5749, the Emergency Extended Unemployment Compensation Act",Passed,7,184,0,8,218,2,0,14,0,0,0,0,225,186,0,22
408,D,110,H RES 1265,12-Jun-2008,12:14 PM,On Agreeing to the Resolution,"Providing for consideration of H.R. 5749, the Emergency Extended Unemployment Compensation Act",Passed,3,190,0,6,224,2,0,8,0,0,0,0,227,192,0,14
409,D,110,H R 1553,12-Jun-2008,12:24 PM,"On Motion to Suspend the Rules and Pass, as Amended",Conquer Childhood Cancer Act,Passed,191,0,0,8,225,0,0,9,0,0,0,0,416,0,0,17
410,D,110,H R 5749,12-Jun-2008,12:45 PM,Motion to table the appeal,Emergency Extended Unemployment Compensation Act of 2008,Passed,1,184,0,14,216,1,0,17,0,0,0,0,217,185,0,31
411,D,110,H R 5749,12-Jun-2008,2:32 PM,On Motion to Recommit with Instructions,Emergency Extended Unemployment Compensation Act of 2008,Failed,167,19,0,13,3,224,0,8,0,0,0,0,170,243,0,21
412,D,110,H R 5749,12-Jun-2008,2:39 PM,On Passage,Emergency Extended Unemployment Compensation Act of 2008,Passed,49,137,0,13,225,0,0,10,0,0,0,0,274,137,0,23
413,D,110,S 2146,12-Jun-2008,2:50 PM,"On Motion to Suspend the Rules and Pass, as Amended","Authorizing the Administrator of the Environmental Protection Agency to accept, as part of a settlement, diesel emission reduction Supplemental Environmental Projects, and for other purposes.",Passed,184,0,0,15,222,0,0,12,0,0,0,0,406,0,0,27
414,D,110,H R 2964,17-Jun-2008,6:58 PM,"On Motion to Suspend the Rules and Pass, as Amended",Captive Primate Safety Act,Passed,82,96,0,21,220,0,0,14,0,0,0,0,302,96,0,35
415,D,110,H R 3702,17-Jun-2008,7:05 PM,"On Motion to Suspend the Rules and Pass, as Amended",Montana Cemetery Act,Passed,177,0,0,22,219,0,0,15,0,0,0,0,396,0,0,37
416,D,110,H RES 1275,17-Jun-2008,7:13 PM,On Motion to Suspend the Rules and Agree,"Honoring the life of Timothy John Russert, Jr., public servant, political analyst, and author",Passed,176,0,0,23,219,0,0,15,0,0,0,0,395,0,0,38
417,D,110,H R 6124,18-Jun-2008,3:57 PM,"Passage, Objections of the President Not Withstanding","To provide for the continuation of agricultural and other programs of the Department of Agriculture through the fiscal year 2012, and for other purposes",Passed,99,96,0,4,218,13,0,4,0,0,0,0,317,109,0,8
418,D,110,H R 6063,18-Jun-2008,4:16 PM,On Agreeing to the Amendment,None,Agreed to,197,0,0,3,232,1,0,5,0,0,0,0,429,1,0,8
419,D,110,H R 6063,18-Jun-2008,4:25 PM,On Agreeing to the Amendment,None,Agreed to,191,3,0,6,232,0,0,6,0,0,0,0,423,3,0,12
420,D,110,H R 6063,18-Jun-2008,5:00 PM,On Motion to Recommit with Instructions,National Aeronautics and Space Administration Authorization Act of 2008,Failed,191,2,0,6,5,223,0,6,0,0,0,0,196,225,0,12
421,D,110,H R 6063,18-Jun-2008,5:11 PM,On Passage,National Aeronautics and Space Administration Authorization Act of 2008,Passed,181,15,0,3,228,0,0,6,0,0,0,0,409,15,0,9
422,D,110,H RES 1002,18-Jun-2008,5:20 PM,"On Motion to Suspend the Rules and Agree, as Amended",Expressing support for designation of April 2008 as “Public Radio Recognition Month”,Passed,191,0,0,8,223,0,0,11,0,0,0,0,414,0,0,19
423,D,110,H RES 1277,19-Jun-2008,11:42 AM,On Ordering the Previous Question,"Providing for consideration of H.R. 5781, to provide that 8 of the 12 weeks of parental leave made available to a Federal employee shall be paid leave",Passed,0,195,0,4,222,2,0,10,0,0,0,0,222,197,0,14
424,D,110,H RES 1277,19-Jun-2008,11:51 AM,On Agreeing to the Resolution,"Providing for consideration of H.R. 5781, to provide that 8 of the 12 weeks of parental leave made available to a Federal employee shall be paid leave",Passed,2,193,0,4,228,1,0,5,0,0,0,0,230,194,0,9
425,D,110,H R 5710,19-Jun-2008,11:59 AM,On Motion to Suspend the Rules and Pass,Eastern New Mexico Rural Water System Authorization Act,Passed,71,124,0,4,230,0,0,4,0,0,0,0,301,124,0,8
426,D,110,H R 5781,19-Jun-2008,1:42 PM,On Agreeing to the Amendment,None,Agreed to,193,0,0,6,229,0,0,5,0,0,0,0,422,0,0,11
427,D,110,H R 5781,19-Jun-2008,2:31 PM,On Motion to Recommit with Instructions,Federal Employees Paid Parental Leave Act,Failed,194,1,0,4,12,219,0,4,0,0,0,0,206,220,0,8
428,D,110,H R 5781,19-Jun-2008,2:39 PM,On Passage,Federal Employees Paid Parental Leave Act,Passed,50,145,0,4,228,1,0,6,0,0,0,0,278,146,0,10
429,D,110,H RES 1284,19-Jun-2008,6:44 PM,On Agreeing to the Resolution,"Providing for consideration of the Senate Adts. to the House Amendments to the Senate Adt. to the bill (H.R. 2642) making appropriations for military construction, the Department of Veterans Affairs, and related agencies for the fiscal year ending Sept. 30, 2008",Passed,150,43,0,6,192,40,0,3,0,0,0,0,342,83,0,9
430,D,110,H RES 1230,19-Jun-2008,6:52 PM,"On Motion to Suspend the Rules and Agree, as Amended",Condemning the postelection violence in Zimbabwe and calling for a peaceful resolution to the current political crisis,Passed,184,1,0,14,228,0,0,7,0,0,0,0,412,1,0,21
431,D,110,H R 2642,19-Jun-2008,8:04 PM,Agree to Senate Amendment to House Amendment No. 1,Military Construction and Veterans Affairs and Related Agencies Appropriations Act,Passed,188,4,0,7,80,151,0,5,0,0,0,0,268,155,0,12
432,D,110,H R 2642,19-Jun-2008,8:13 PM,Agree to Senate Adt to House Adt No. 2 with Amendment,Military Construction and Veterans Affairs and Related Agencies Appropriations Act,Passed,186,9,0,4,230,3,0,3,0,0,0,0,416,12,0,7
433,D,110,H RES 1029,19-Jun-2008,8:21 PM,"On Motion to Suspend the Rules and Agree, as Amended","Congratulating and recognizing Mr. Juan Antonio “Chi-Chi” Rodriguez for his continued success on and off the golf course, for his generosity and devotion to charity, and for his exemplary dedication to the intellectual and moral growth of thousands of low-income and disadvantaged youth in our country",Passed,193,0,0,6,222,0,0,13,0,0,0,0,415,0,0,19
434,D,110,JOURNAL,20-Jun-2008,10:29 AM,On Approving the Journal,None,Passed,18,157,0,24,212,11,0,12,0,0,0,0,230,168,0,36
435,D,110,H RES 1276,20-Jun-2008,10:37 AM,On Ordering the Previous Question,"Providing for consideration of H.R. 5876, the Stop Child Abuse in Residential Programs for Teens Act of 2008",Passed,1,177,0,21,219,2,0,14,0,0,0,0,220,179,0,35
436,D,110,H RES 1276,20-Jun-2008,10:45 AM,On Agreeing to the Resolution,"Providing for consideration of H.R. 5876, the Stop Child Abuse in Residential Programs for Teens Act of 2008",Passed,0,183,0,16,223,2,0,10,0,0,0,0,223,185,0,26
437,D,110,H R 6304,20-Jun-2008,12:48 PM,On Passage,FISA Amendments Act of 2008,Passed,188,1,0,10,105,128,0,3,0,0,0,0,293,129,0,13
438,D,110,H RES 1242,23-Jun-2008,6:56 PM,On Motion to Suspend the Rules and Agree,"Honoring the life, musical accomplishments, and contributions of Louis Jordan on the 100th anniversary of his birth",Passed,164,0,0,35,184,0,0,51,0,0,0,0,348,0,0,86
439,D,110,H CON RES 372,23-Jun-2008,7:04 PM,On Motion to Suspend the Rules and Agree,Supporting the goals and ideals of Black Music Month,Passed,167,0,0,32,186,0,0,49,0,0,0,0,353,0,0,81
440,D,110,H RES 1051,23-Jun-2008,7:13 PM,"On Motion to Suspend the Rules and Agree, As Amended","Congratulating James Madison University in Harrisonburg, Virginia, for 100 years of service and leadership to the United States",Passed,163,0,0,36,191,0,0,44,0,0,0,0,354,0,0,80
441,D,110,ADJOURN,24-Jun-2008,10:58 AM,On Motion to Adjourn,None,Failed,82,99,0,18,5,200,0,30,0,0,0,0,87,299,0,48
442,D,110,ADJOURN,24-Jun-2008,11:16 AM,On Motion to Adjourn,None,Failed,72,112,0,15,3,197,0,35,0,0,0,0,75,309,0,50
443,D,110,H R 6331,24-Jun-2008,12:36 PM,"On Motion to Suspend the Rules and Pass, as Amended",Medicare Improvements for Patients and Providers Act,Passed,129,59,0,11,226,0,0,9,0,0,0,0,355,59,0,20
444,D,110,H R 5876,24-Jun-2008,5:20 PM,On Agreeing to the Amendment,None,Agreed to,193,0,0,7,229,0,0,10,0,0,0,0,422,0,0,17
445,D,110,H CON RES 379,24-Jun-2008,5:51 PM,On Agreeing to the Resolution,None,Passed,3,191,0,5,222,6,0,7,0,0,0,0,225,197,0,12
446,D,110,JOURNAL,24-Jun-2008,5:58 PM,On Approving the Journal,None,Passed,25,168,2,4,214,13,0,8,0,0,0,0,239,181,2,12
447,D,110,H R 6327,24-Jun-2008,6:07 PM,"On Motion to Suspend the Rules and Pass, as Amended",Federal Aviation Administration Extension Act of 2008,Passed,196,0,0,3,226,0,0,9,0,0,0,0,422,0,0,12
448,D,110,H R 6346,24-Jun-2008,6:16 PM,"On Motion to Suspend the Rules and Pass, as Amended",Federal Price Gouging Prevention Act,Failed,51,145,0,3,225,1,0,10,0,0,0,0,276,146,0,13
449,D,110,H RES 1298,25-Jun-2008,12:43 PM,On Ordering the Previous Question,"Providing for consideration of H.R. 2176, to provide for and approve the settlement of certain land claims of the Bay Mills Indian Community",Passed,3,191,0,5,223,3,0,9,0,0,0,0,226,194,0,14
450,D,110,H RES 1298,25-Jun-2008,12:51 PM,On Agreeing to the Resolution,"Providing for consideration of H.R. 2176, to provide for and approve the settlement of certain land claims of the Bay Mills Indian Community",Passed,4,184,0,11,203,20,0,12,0,0,0,0,207,204,0,23
451,D,110,H RES 1297,25-Jun-2008,12:58 PM,On Ordering the Previous Question,"Providing for consideration of H.R. 6275, the Alternative Minimum Tax Relief Act",Passed,1,192,0,6,224,2,0,9,0,0,0,0,225,194,0,15
452,D,110,H RES 1297,25-Jun-2008,1:04 PM,On Agreeing to the Resolution,"Providing for consideration of H.R. 6275, the Alternative Minimum Tax Relief Act",Passed,0,192,0,7,224,1,0,10,0,0,0,0,224,193,0,17
453,D,110,H RES 1299,25-Jun-2008,1:12 PM,On Ordering the Previous Question,"Providing for consideration of H.R. 3195, the ADA Amendments Act of 2008",Passed,1,191,0,7,220,3,0,12,0,0,0,0,221,194,0,19
454,D,110,H R 6275,25-Jun-2008,2:02 PM,On Motion to Recommit with Instructions,Alternative Minimum Tax Relief Act of 2008,Failed,194,1,0,4,5,221,0,9,0,0,0,0,199,222,0,13
455,D,110,H R 6275,25-Jun-2008,2:09 PM,On Passage,Alternative Minimum Tax Relief Act of 2008,Passed,10,183,0,6,223,6,0,6,0,0,0,0,233,189,0,12
456,D,110,H R 3546,25-Jun-2008,2:17 PM,"On Motion to Suspend the Rules and Pass, as Amended",Edward Byrne Memorial Justice Assistance Grant Program Authorization,Passed,182,11,0,6,224,0,0,11,0,0,0,0,406,11,0,17
457,D,110,H R 2176,25-Jun-2008,4:05 PM,Table Appeal of the Ruling of the Chair,To provide for and approve the settlement of certain land claims of the Bay Mills Indian Community,Passed,1,189,0,9,225,0,0,10,0,0,0,0,226,189,0,19
458,D,110,H R 2176,25-Jun-2008,4:14 PM,On Passage,To provide for and approve the settlement of certain land claims of the Bay Mills Indian Community,Failed,25,167,0,7,96,131,0,8,0,0,0,0,121,298,0,15
459,D,110,H R 6358,25-Jun-2008,6:03 PM,On Motion to Suspend the Rules and Pass,Stop Child Abuse in Residential Programs for Teens Act of 2008,Passed,89,103,0,7,229,0,0,6,0,0,0,0,318,103,0,13
460,D,110,H R 3195,25-Jun-2008,6:11 PM,On Passage,ADA Amendments Act of 2008,Passed,174,17,0,8,228,0,0,7,0,0,0,0,402,17,0,15
461,D,110,H R 4040,25-Jun-2008,6:18 PM,On Motion to Instruct Conferees,Consumer Product Safety Commission Reform Act,Passed,189,0,0,10,226,0,0,9,0,0,0,0,415,0,0,19
462,D,110,H RES 1304,26-Jun-2008,11:52 AM,On Ordering the Previous Question,"Providing for consideration of H.R. 6052, to promote increased public transportation use, to promote increased use of alternative fuels in providing public transportation, and for other purposes",Passed,2,194,0,3,226,4,0,5,0,0,0,0,228,198,0,8
463,D,110,H RES 1304,26-Jun-2008,12:02 PM,On Agreeing to the Resolution,"Providing for consideration of H.R. 6052, to promote increased public transportation use, to promote increased use of alternative fuels in providing public transportation, and for other purposes",Passed,1,195,0,3,229,1,0,5,0,0,0,0,230,196,0,8
464,D,110,H RES 1291,26-Jun-2008,12:08 PM,On Motion to Suspend the Rules and Agree,Expressing gratitude for the contributions of the American GI Forum on its 60th anniversary,Passed,195,0,0,4,226,0,0,9,0,0,0,0,421,0,0,13
465,D,110,H R 6052,26-Jun-2008,4:45 PM,On Agreeing to the Amendment,None,Agreed to,191,0,0,9,230,0,0,9,0,0,0,0,421,0,0,18
466,D,110,H R 6052,26-Jun-2008,5:21 PM,On Motion to Recommit with Instructions,Saving Energy Through Public Transportation Act,Failed,185,4,0,10,14,217,0,4,0,0,0,0,199,221,0,14
467,D,110,H R 6052,26-Jun-2008,5:28 PM,On Passage,Saving Energy Through Public Transportation Act,Passed,91,98,0,10,231,0,0,4,0,0,0,0,322,98,0,14
468,D,110,H R 6377,26-Jun-2008,5:36 PM,On Motion to Suspend the Rules and Pass,Energy Markets Emergency Act of 2008,Passed,170,19,0,10,232,0,0,3,0,0,0,0,402,19,0,13
469,D,110,H R 6251,26-Jun-2008,5:44 PM,"On Motion to Suspend the Rules and Pass, as Amended",Responsible Federal Oil and Gas Lease Act,Failed,11,176,0,12,212,19,0,4,0,0,0,0,223,195,0,16
470,D,110,H RES 1098,26-Jun-2008,5:51 PM,On Motion to Suspend the Rules and Agree,Supporting the goals and ideals of the Year of the American Veteran,Passed,182,0,0,17,227,0,0,8,0,0,0,0,409,0,0,25
471,D,110,H R 3981,8-Jul-2008,6:56 PM,"On Motion to Suspend the Rules and Pass, as Amended",Preserve America and Save America’s Treasures Act,Passed,145,23,0,31,215,0,0,20,0,0,0,0,360,23,0,51
472,D,110,H R 1423,8-Jul-2008,7:08 PM,"On Motion to Suspend the Rules and Pass, as Amended",Dorothy Buell Memorial Visitor Center Lease Act,Passed,156,11,0,32,220,0,0,15,0,0,0,0,376,11,0,47
473,D,110,H R 4199,8-Jul-2008,7:16 PM,"On Motion to Suspend the Rules and Pass, as Amended","To amend the Dayton Aviation Heritage Preservation Act of 1992 to add sites to the Dayton Aviation Heritage National Historical Park, and for other purposes",Passed,149,18,0,32,219,0,0,16,0,0,0,0,368,18,0,48
474,D,110,H RES 1318,9-Jul-2008,3:55 PM,On Ordering the Previous Question,"Providing for consideration of H.R. 5811, The Electronic Message Preservation Act",Passed,3,189,0,7,225,4,0,6,0,0,0,0,228,193,0,13
475,D,110,H RES 1318,9-Jul-2008,4:06 PM,On Agreeing to the Resolution,"Providing for consideration of H.R. 5811, The Electronic Message Preservation Act",Passed,0,192,0,7,229,1,0,5,0,0,0,0,229,193,0,12
476,D,110,H R 5811,9-Jul-2008,5:39 PM,On Motion to Recommit with Instructions,Electronic Message Preservation Act,Passed,192,0,0,7,227,1,2,5,0,0,0,0,419,1,2,12
477,D,110,H R 5811,9-Jul-2008,5:51 PM,On Passage,Electronic Message Preservation Act,Passed,56,137,0,6,230,0,0,5,0,0,0,0,286,137,0,11
478,D,110,H R 3329,9-Jul-2008,5:59 PM,"On Motion to Suspend the Rules and Pass, as Amended",Homes for Heroes Act,Passed,181,9,0,9,231,0,0,4,0,0,0,0,412,9,0,13
479,D,110,H R 6184,9-Jul-2008,6:06 PM,On Motion to Suspend the Rules and Pass,America’s Beautiful National Parks Quarter Dollar Coin Act,Passed,190,0,0,9,229,0,0,6,0,0,0,0,419,0,0,15
480,D,110,H RES 1317,10-Jul-2008,1:04 PM,On Ordering the Previous Question,Providing for consideration of the bill (H.R. 1286) to amend the National Trails System Act to designate the Washington-Rochambeau Revolutionary Route National Historic Trail,Passed,4,184,0,11,222,1,0,12,0,0,0,0,226,185,0,23
481,D,110,H RES 1317,10-Jul-2008,1:11 PM,On Agreeing to the Resolution,Providing for consideration of the bill (H.R. 1286) to amend the National Trails System Act to designate the Washington-Rochambeau Revolutionary Route National Historic Trail,Passed,0,182,0,17,224,0,0,11,0,0,0,0,224,182,0,28
482,D,110,H R 1286,10-Jul-2008,2:49 PM,On Agreeing to the Amendment,None,Agreed to,192,0,0,8,232,0,0,7,0,0,0,0,424,0,0,15
483,D,110,H R 1286,10-Jul-2008,3:28 PM,On Motion to Recommit with Instructions,Washington-Rochambeau Revolutionary Route National Historic Trail Designation Act,Failed,185,5,0,9,17,206,0,12,0,0,0,0,202,211,0,21
484,D,110,H R 1286,10-Jul-2008,3:37 PM,On Passage,Washington-Rochambeau Revolutionary Route National Historic Trail Designation Act,Passed,122,69,0,8,223,0,0,12,0,0,0,0,345,69,0,20
485,D,110,H R 3121,10-Jul-2008,3:45 PM,On Motion to Instruct Conferees,"To restore the financial solvency of the national flood insurance program and to provide for such program to make available multiperil coverage for damage resulting from windstorms and floods, and for other purposes",Passed,177,12,0,10,208,14,0,13,0,0,0,0,385,26,0,23
486,D,110,H RES 1067,14-Jul-2008,6:59 PM,On Motion to Suspend the Rules and Agree,Recognizing the 50th anniversary of the crossing of the North Pole by the USS Nautilus (SSN 571),Passed,175,0,0,24,200,0,0,35,0,0,0,0,375,0,0,59
487,D,110,H RES 1080,14-Jul-2008,7:06 PM,"On Motion to Suspend the Rules and Agree, as Amended","Honoring the extraordinary service and exceptional sacrifice of the 101st Airborne Division (Air Assault), known as the Screaming Eagles",Passed,176,0,0,23,202,0,0,33,0,0,0,0,378,0,0,56
488,D,110,H CON RES 297,14-Jul-2008,7:14 PM,"On Motion to Suspend the Rules and Agree, as Amended",Recognizing the 60th anniversary of the integration of the United States Armed Forces,Passed,174,0,0,25,204,0,0,31,0,0,0,0,378,0,0,56
489,D,110,H RES 1259,15-Jul-2008,4:27 PM,"On Motion to Suspend the Rules and Agree, as Amended",Congratulating the Hamilton College Continentals on winning the NCAA Division III women’s lacrosse championship,Passed,192,0,0,7,231,0,0,4,0,0,0,0,423,0,0,11
490,D,110,H RES 1323,15-Jul-2008,4:41 PM,On Motion to Suspend the Rules and Agree,Commending the Arizona State University softball team for their victory in the 2008 Women’s College World Series,Passed,194,0,0,5,231,0,0,4,0,0,0,0,425,0,0,9
491,D,110,H R 6331,15-Jul-2008,4:48 PM,"Passage, Objections of the President Not Withstanding",Medicare Improvements for Patients and Providers Act,Passed,153,41,0,5,230,0,0,6,0,0,0,0,383,41,0,11
492,D,110,H RES 1345,15-Jul-2008,6:39 PM,On Motion to Refer,The Kucinich Resolution,Passed,9,180,0,10,229,0,0,6,0,0,0,0,238,180,0,16
493,D,110,H R 5803,15-Jul-2008,6:48 PM,On Motion to Suspend the Rules and Pass,To direct the Election Assistance Commission to establish a program to make grants to participating States and units of local goverment to carry out a program to make backup paper ballots in the case of the failure of a voting system or voting equipment,Failed,20,170,0,9,228,0,0,7,0,0,0,0,248,170,0,16
494,D,110,H RES 1090,15-Jul-2008,6:55 PM,"On Motion to Suspend the Rules and Agree, as Amended",Honoring the esteemed former President Nelson Rolihlahla Mandela on the occasion of his 90th birthday,Passed,188,0,0,11,223,0,0,12,0,0,0,0,411,0,0,23
495,D,110,H RES 1343,16-Jul-2008,12:42 PM,On Ordering the Previous Question,"Providing for consideration of the bill (H.R. 5959) to authorize appropriations for fiscal year 2009 for intelligence and intelligence-related activities of the United States Government, the Community Management Account, and Central Intelligence Agency Retirement and Disability System",Passed,0,191,0,8,226,1,0,8,0,0,0,0,226,192,0,16
496,D,110,H RES 1343,16-Jul-2008,12:51 PM,On Agreeing to the Resolution,"Providing for consideration of the bill (H.R. 5959) to authorize appropriations for fiscal year 2009 for intelligence and intelligence-related activities of the United States Government, the Community Management Account, and Central Intelligence Agency Retirement and Disability System",Passed,2,191,0,6,224,2,0,9,0,0,0,0,226,193,0,15
497,D,110,H RES 1339,16-Jul-2008,1:02 PM,On Ordering the Previous Question,Providing for consideration of the bill (H.R. 415) to amend the Wild and Scenic Rivers Act to designate segments of the Taunton River in the Commonwealth of Massachusetts as a component of the National Wild and Scenic Rivers System,Passed,0,194,0,5,223,4,0,8,0,0,0,0,223,198,0,13
498,D,110,H RES 1339,16-Jul-2008,1:10 PM,On Agreeing to the Resolution,Providing for consideration of the bill (H.R. 415) to amend the Wild and Scenic Rivers Act to designate segments of the Taunton River in the Commonwealth of Massachusetts as a component of the National Wild and Scenic Rivers System,Passed,0,192,0,7,224,3,0,8,0,0,0,0,224,195,0,15
499,D,110,H R 5959,16-Jul-2008,3:38 PM,On Agreeing to the Amendment,None,Agreed to,196,1,0,3,218,9,7,5,0,0,0,0,414,10,7,8
500,D,110,H R 5959,16-Jul-2008,3:46 PM,On Agreeing to the Amendment,None,Agreed to,194,2,0,4,55,178,0,6,0,0,0,0,249,180,0,10
501,D,110,H R 5959,16-Jul-2008,3:54 PM,On Agreeing to the Amendment,None,Agreed to,196,1,0,3,230,1,0,8,0,0,0,0,426,2,0,11
502,D,110,H R 5959,16-Jul-2008,4:56 PM,On Motion to Recommit with Instructions,Intelligence Authorization Act of Fiscal Year 2009,Failed,192,3,0,4,8,222,0,5,0,0,0,0,200,225,0,9
503,D,110,H R 415,16-Jul-2008,7:00 PM,On Agreeing to the Amendment,None,Failed,188,3,0,9,1,232,0,6,0,0,0,0,189,235,0,15
504,D,110,H R 415,16-Jul-2008,7:08 PM,On Agreeing to the Amendment,None,Agreed to,191,0,0,9,234,0,0,5,0,0,0,0,425,0,0,14
505,D,110,H R 415,16-Jul-2008,7:15 PM,On Agreeing to the Amendment,None,Agreed to,188,0,0,12,233,0,0,6,0,0,0,0,421,0,0,18
506,D,110,H R 415,16-Jul-2008,7:47 PM,On Motion to Recommit with Instructions,To amend the Wild and Scenic Rivers Act to designate segments of the Taunton River in the Commonwealth of Massachusetts as a component of the National Wild and Scenic Rivers System,Failed,184,3,0,12,4,224,0,7,0,0,0,0,188,227,0,19
507,D,110,H R 415,16-Jul-2008,7:54 PM,On Passage,To amend the Wild and Scenic Rivers Act to designate segments of the Taunton River in the Commonwealth of Massachusetts as a component of the National Wild and Scenic Rivers System,Passed,11,175,0,13,231,0,0,5,0,0,0,0,242,175,0,18
508,D,110,H CON RES 295,16-Jul-2008,8:00 PM,On Motion to Suspend the Rules and Agree,Expressing the deepest appreciation of Congress to the families of members of the United States Armed Forces,Passed,190,0,0,9,225,0,0,10,0,0,0,0,415,0,0,19
509,D,110,H RES 1350,17-Jul-2008,1:11 PM,On Ordering the Previous Question,Providing for consideration of motions to suspend the rules,Passed,2,186,0,11,226,2,0,7,0,0,0,0,228,188,0,18
510,D,110,H RES 1350,17-Jul-2008,1:20 PM,On Agreeing to the Resolution,Providing for consideration of motions to suspend the rules,Passed,0,190,0,9,222,4,0,9,0,0,0,0,222,194,0,18
511,D,110,H R 6515,17-Jul-2008,3:16 PM,On Motion to Suspend the Rules and Pass,Drill Responsibly in Leased Lands Act of 2008,Failed,26,162,0,11,218,11,0,7,0,0,0,0,244,173,0,18
512,D,110,H R 6493,22-Jul-2008,6:59 PM,"On Motion to Suspend the Rules and Pass, as Amended",Aviation Safety Enhancement Act of 2008,Passed,178,0,0,21,214,0,0,21,0,0,0,0,392,0,0,42
513,D,110,H RES 1311,22-Jul-2008,7:07 PM,On Motion to Suspend the Rules and Agree,Expressing support for the designation of National GEAR UP Day,Passed,171,1,0,27,214,0,0,21,0,0,0,0,385,1,0,48
514,D,110,H RES 1202,22-Jul-2008,7:19 PM,On Motion to Suspend the Rules and Agree,Supporting the goals and ideals of a National Guard Youth Challenge Day,Passed,174,0,0,25,214,0,0,21,0,0,0,0,388,0,0,46
515,D,110,ADJOURN,23-Jul-2008,1:22 PM,On Motion to Adjourn,None,Failed,19,174,0,6,1,226,0,8,0,0,0,0,20,400,0,14
516,D,110,H RES 1363,23-Jul-2008,1:38 PM,On Ordering the Previous Question,"Providing for consideration of the Senate amendment to the House amendments to the Senate amendment to H.R. 3221, to provide needed housing reform and for other purposes",Passed,4,181,0,14,222,2,0,11,0,0,0,0,226,183,0,25
517,D,110,H RES 1363,23-Jul-2008,1:47 PM,On Agreeing to the Resolution,"Providing for consideration of the Senate amendment to the House amendments to the Senate amendment to H.R. 3221, to provide needed housing reform and for other purposes",Passed,0,195,0,4,223,6,0,6,0,0,0,0,223,201,0,10
518,D,110,H R 6532,23-Jul-2008,1:54 PM,On Motion to Suspend the Rules and Pass,To amend the Internal Revenue Code of 1986 to restore the Highway Trust Fund balance,Passed,159,37,0,3,228,0,0,7,0,0,0,0,387,37,0,10
519,D,110,H R 3221,23-Jul-2008,5:01 PM,Concur in Senate Amendment with House Amendment,Foreclosure Prevention Act of 2008,Passed,45,149,0,5,227,3,0,6,0,0,0,0,272,152,0,11
520,D,110,H R 6545,23-Jul-2008,5:08 PM,On Motion to Suspend the Rules and Pass,National Energy Security Intelligence Act of 2008,Passed,190,0,2,7,224,0,0,11,0,0,0,0,414,0,2,18
521,D,110,H R 6545,23-Jul-2008,5:16 PM,Table Motion to Reconsider,National Energy Security Intelligence Act of 2008,Passed,15,179,0,5,227,0,0,8,0,0,0,0,242,179,0,13
522,D,110,H RES 1344,23-Jul-2008,6:12 PM,On Ordering the Previous Question,"Providing for consideration of H.R. 3999, to improve the safety of Federal-aid highway bridges, to strengthen bridge inspection standards and processes, to increase investment in the reconstruction of structurally deficient bridges on the National Highway System, and for other purposes",Passed,4,188,0,7,224,4,0,7,0,0,0,0,228,192,0,14
523,D,110,H RES 1344,23-Jul-2008,6:20 PM,On Agreeing to the Resolution,"Providing for consideration of H.R. 3999, to improve the safety of Federal-aid highway bridges, to strengthen bridge inspection standards and processes, to increase investment in the reconstruction of structurally deficient bridges on the National Highway System, and for other purposes",Passed,2,192,0,5,226,1,0,8,0,0,0,0,228,193,0,13
524,D,110,H RES 1367,24-Jul-2008,12:41 PM,On Ordering the Previous Question,Providing for consideration of motions to suspend the rules,Passed,7,183,0,9,225,1,0,9,0,0,0,0,232,184,0,18
525,D,110,H RES 1367,24-Jul-2008,12:48 PM,On Agreeing to the Resolution,Providing for consideration of motions to suspend the rules,Passed,0,188,0,11,226,2,0,7,0,0,0,0,226,190,0,18
526,D,110,H RES 1362,24-Jul-2008,12:55 PM,On Ordering the Previous Question,"Providing for consideration of the Senate amendment to the bill (H.R. 5501) to authorize appropriations for fiscal years 2009 through 2013 to provide assistance to foreign countries to combat HIV/AIDS, tuberculosis, and malaria, and for other purposes",Passed,8,182,0,9,223,3,0,9,0,0,0,0,231,185,0,18
527,D,110,H R 6578,24-Jul-2008,2:44 PM,"On Motion to Suspend the Rules and Pass, as Amended",Consumer Energy Supply Act of 2008,Failed,37,157,0,5,231,0,0,5,0,0,0,0,268,157,0,10
528,D,110,H R 3999,24-Jul-2008,3:03 PM,On Agreeing to the Amendment,None,Agreed to,192,0,0,8,224,1,6,8,0,0,0,0,416,1,6,16
529,D,110,H R 3999,24-Jul-2008,3:42 PM,On Motion to Recommit with Instructions,National Highway Bridge Reconstruction and Inspection Act,Failed,151,37,5,6,0,231,0,4,0,0,0,0,151,268,5,10
530,D,110,H R 3999,24-Jul-2008,3:53 PM,On Passage,National Highway Bridge Reconstruction and Inspection Act,Passed,137,55,0,7,230,0,0,5,0,0,0,0,367,55,0,12
531,D,110,H R 5501,24-Jul-2008,6:42 PM,Concur in the Senate Amendment,"Tom Lantos and Henry J. Hyde United States Global Leadership Against HIV/AIDS, Tuberculosis, and Malaria Reauthorization Act",Passed,75,114,0,10,228,1,0,7,0,0,0,0,303,115,0,17
532,D,110,H RES 1368,24-Jul-2008,6:50 PM,On Agreeing to the Resolution,"Relating to the House procedures contained in section 803 of the Medicare Presciption Drug, Improvement, and Modernization Act of 2003",Passed,15,174,0,10,216,10,0,9,0,0,0,0,231,184,0,19
533,D,110,H RES 1296,24-Jul-2008,6:58 PM,"On Motion to Suspend the Rules and Agree, as Amended",National Child Awareness Month,Passed,182,0,0,17,222,0,0,13,0,0,0,0,404,0,0,30
534,D,110,H R 2490,29-Jul-2008,7:03 PM,"On Motion to Suspend the Rules and Pass, as Amended",To require the Secretary of Homeland Security to conduct a pilot program for the mobile biometric identification in the maritime environment of aliens unlawfully attempting to enter the United States,Passed,178,1,0,20,216,2,1,16,0,0,0,0,394,3,1,36
535,D,110,H R 6113,29-Jul-2008,7:11 PM,"On Motion to Suspend the Rules and Pass, as Amended",Paperwork Assistance Act,Passed,175,0,0,24,219,0,0,16,0,0,0,0,394,0,0,40
536,D,110,H R 2192,29-Jul-2008,7:20 PM,"On Motion to Suspend the Rules and Pass, as Amended","To amend title 38, United States Code, to establish an Ombudsman within the Department of Veterans Affairs",Passed,178,0,0,21,220,0,0,15,0,0,0,0,398,0,0,36
537,D,110,H CON RES 398,30-Jul-2008,1:04 PM,On Agreeing to the Resolution,Adjournment Resolution,Passed,0,195,0,4,213,17,0,6,0,0,0,0,213,212,0,10
538,D,110,H R 5892,30-Jul-2008,1:14 PM,"On Motion to Suspend the Rules and Pass, as Amended",Veterans Disability Benefits Claims Modernization Act,Passed,196,0,0,3,233,0,0,3,0,0,0,0,429,0,0,6
539,D,110,H RES 1370,30-Jul-2008,1:23 PM,"On Motion to Suspend the Rules and Agree, as Amended","Calling on the Government of the People’s Republic of China to immediately end abuses of the human rights of its citizens, to cease repression of Tibetan and Uighur citizens, and to end its support for the Government of Sudan and Burma to ensure that the 2008 Beijing Olympic Games take place in an atmosphere of freedom",Passed,190,1,0,8,229,0,1,6,0,0,0,0,419,1,1,14
540,D,110,H R 6604,30-Jul-2008,2:55 PM,"On Motion to Suspend the Rules and Pass, as Amended",Commodity Markets Transparency and Accountability Act,Failed,61,135,0,3,215,16,0,5,0,0,0,0,276,151,0,8
541,D,110,H R 6445,30-Jul-2008,3:08 PM,"On Motion to Suspend the Rules and Pass, as Amended","To amend title 38, United States Code, to prohibit the Secretary of Veterans Affairs from collecting certain copayments from veterans who are catastrophically disabled",Passed,193,0,0,6,228,0,0,7,0,0,0,0,421,0,0,13
542,D,110,H R 1108,30-Jul-2008,6:36 PM,"On Motion to Suspend the Rules and Pass, as Amended",Family Smoking Prevention and Tobacco Control Act,Passed,96,99,0,4,230,3,0,2,0,0,0,0,326,102,0,6
543,D,110,H R 4040,30-Jul-2008,6:45 PM,On Motion to Suspend the Rules and Agree to the Conference Report,Consumer Product Safety Commission Reform Act,Passed,193,1,0,5,231,0,0,4,0,0,0,0,424,1,0,9
544,D,110,H R 4137,31-Jul-2008,2:52 PM,On Agreeing to the Conference Report,"To amend and extend the Higher Education Act of 1965, and for other purposes",Passed,146,49,0,4,234,0,0,1,0,0,0,0,380,49,0,5
545,D,110,JOURNAL,31-Jul-2008,3:02 PM,On Approving the Journal,None,Passed,0,194,0,5,223,9,0,3,0,0,0,0,223,203,0,8
546,D,110,H RES 1396,31-Jul-2008,3:34 PM,On Motion to Table,None,Passed,25,138,29,7,229,0,5,2,0,0,0,0,254,138,34,9
547,D,110,H RES 1388,31-Jul-2008,3:45 PM,On Ordering the Previous Question,"Providing for consideration of H.R. 1338, the Paycheck Fairness Act",Passed,5,187,0,7,227,4,0,4,0,0,0,0,232,191,0,11
548,D,110,H RES 1388,31-Jul-2008,3:53 PM,On Agreeing to the Resolution,"Providing for consideration of H.R. 1338, the Paycheck Fairness Act",Passed,0,193,0,6,229,1,0,5,0,0,0,0,229,194,0,11
549,D,110,H RES 1384,31-Jul-2008,4:02 PM,On Ordering the Previous Question,"Providing for consideration of H. R. 6599, Military Consruction and Veterans’ Affairs Appropriations, FY 2009",Passed,11,181,0,7,232,0,0,3,0,0,0,0,243,181,0,10
550,D,110,H RES 1384,31-Jul-2008,4:09 PM,On Agreeing to the Resolution,"Providing for consideration of H. R. 6599, Military Consruction and Veterans’ Affairs Appropriations, FY 2009",Passed,4,186,0,9,226,0,0,9,0,0,0,0,230,186,0,18
551,D,110,H R 1338,31-Jul-2008,6:35 PM,On Agreeing to the Amendment,None,Failed,188,2,0,10,0,238,0,1,0,0,0,0,188,240,0,11
552,D,110,H R 1338,31-Jul-2008,6:39 PM,On Agreeing to the Amendment,None,Agreed to,191,0,0,9,235,1,0,3,0,0,0,0,426,1,0,12
553,D,110,H R 1338,31-Jul-2008,6:44 PM,On Agreeing to the Amendment,None,Agreed to,190,0,0,10,207,29,0,3,0,0,0,0,397,29,0,13
554,D,110,H R 1338,31-Jul-2008,6:49 PM,On Agreeing to the Amendment,None,Agreed to,191,0,0,9,219,16,1,3,0,0,0,0,410,16,1,12
555,D,110,H R 1338,31-Jul-2008,7:22 PM,On Motion to Recommit with Instructions,Paycheck Fairness Act,Failed,188,4,0,7,1,232,0,2,0,0,0,0,189,236,0,9
556,D,110,H R 1338,31-Jul-2008,7:33 PM,On Passage,Paycheck Fairness Act,Passed,14,178,0,7,233,0,0,2,0,0,0,0,247,178,0,9
557,D,110,H R 6633,31-Jul-2008,7:44 PM,On Motion to Suspend the Rules and Pass,Employee Verification Amendment Act of 2008,Passed,183,1,0,15,224,1,4,6,0,0,0,0,407,2,4,21
558,D,110,H R 6599,1-Aug-2008,9:47 AM,On Agreeing to the Amendment,None,Failed,174,13,0,13,11,214,0,14,0,0,0,0,185,227,0,27
559,D,110,H R 6599,1-Aug-2008,9:58 AM,On Agreeing to the Amendment,None,Agreed to,186,2,0,12,143,84,0,12,0,0,0,0,329,86,0,24
560,D,110,H R 6599,1-Aug-2008,10:05 AM,On Agreeing to the Amendment,None,Failed,61,126,0,13,2,224,1,12,0,0,0,0,63,350,1,25
561,D,110,H R 6599,1-Aug-2008,10:12 AM,On Agreeing to the Amendment,None,Failed,143,44,0,13,0,231,0,8,0,0,0,0,143,275,0,21
562,D,110,H R 6599,1-Aug-2008,10:45 AM,On Motion to Table Appeal of the Ruling of the Chair,"Military Construction and Veterans Affairs Appropriation, FY 2009",Passed,10,179,0,10,220,5,0,10,0,0,0,0,230,184,0,20
563,D,110,H R 6599,1-Aug-2008,10:51 AM,On Passage,"Military Construction and Veterans Affairs Appropriation, FY 2009",Passed,180,4,0,15,229,0,0,6,0,0,0,0,409,4,0,21
564,D,110,H RES 1008,1-Aug-2008,10:58 AM,"On Motion to Suspend the Rules and Agree, as Amended",Condemning the persecution of Baha is in Iran,Passed,181,3,0,15,227,0,0,8,0,0,0,0,408,3,0,23
565,D,110,H RES 1316,1-Aug-2008,11:06 AM,On Motion to Suspend the Rules and Agree,"Honoring the service of the Navy and Coast Guard veterans who served on the LST amphibious landing craft during WWII, the Korean War, the Vietnam war, Operation Desert Storm, and global operations through 2002",Passed,186,0,0,13,229,0,0,6,0,0,0,0,415,0,0,19
566,D,110,ADJOURN,1-Aug-2008,11:23 AM,On Motion to Adjourn,None,Passed,2,182,0,15,211,15,0,9,0,0,0,0,213,197,0,24
567,D,110,S 2403,8-Sep-2008,6:57 PM,"On Motion to Suspend the Rules and Pass, as Amended","Spottswood W. Robinson III and Robert R. Merhige, Jr. Federal Courthouse",Passed,180,0,0,19,196,0,0,38,0,0,0,0,376,0,0,57
568,D,110,S 2837,8-Sep-2008,7:12 PM,On Motion to Suspend the Rules and Pass,Theodore Roosevelt United States Courthouse,Passed,179,1,0,19,196,0,0,38,0,0,0,0,375,1,0,57
569,D,110,S 2135,8-Sep-2008,7:20 PM,"On Motion to Suspend the Rules and Pass, as Amended",Child Soldiers Accountability Act of 2007,Passed,177,0,0,22,194,0,0,40,0,0,0,0,371,0,0,62
570,D,110,H CON RES 344,9-Sep-2008,3:06 PM,"On Motion to Suspend the Rules and Agree, as Amended",Recognizing that we are facing a global food crisis,Passed,190,1,1,7,214,0,3,17,0,0,0,0,404,1,4,24
571,D,110,H RES 937,9-Sep-2008,3:17 PM,"On Motion to Suspend the Rules and Agree, as Amended",Expressing the sense of the House of Representatives that the emergency communications services provided by the American Red Cross are vital resources for military service members and their families,Passed,193,0,0,6,218,0,0,16,0,0,0,0,411,0,0,22
572,D,110,H RES 1069,9-Sep-2008,3:26 PM,"On Motion to Suspend the Rules and Agree, as Amended","Condemning the use of television programming by Hamas to indoctrinate hatred, violence, and anti-Semitism toward Israel in young Palestinian children",Passed,192,1,0,6,217,0,0,17,0,0,0,0,409,1,0,23
573,D,110,H RES 1307,9-Sep-2008,6:38 PM,"On Motion to Suspend the Rules and Agree, as Amended",Commemorating the Kingdom of Bhutan’s participation in the 2008 Smithsonian Folklife Festival and commending the people and the Government of the Kingdom of Bhutan for their commitment to holding elections and broadening political participation,Passed,179,15,0,5,216,0,0,18,0,0,0,0,395,15,0,23
574,D,110,H R 6168,9-Sep-2008,6:45 PM,On Motion to Suspend the Rules and Pass,Lance Corporal Drew W. Weaver Post Office Building,Passed,192,0,0,7,211,0,0,23,0,0,0,0,403,0,0,30
575,D,110,H R 6630,9-Sep-2008,6:54 PM,"On Motion to Suspend the Rules and Pass, as Amended",To prohibit the Secretary of Transportation from granting authority to a motor carrier domiciled in Mexico to operate beyond United States municipalities and commercial zones on the United States-Mexico border unless expressly authorized by Congress,Passed,180,15,0,4,215,3,0,16,0,0,0,0,395,18,0,20
576,D,110,H RES 1419,10-Sep-2008,1:25 PM,On Ordering the Previous Question,"Providing for consideration of H.R. 3667, Missisquoi and Trout Rivers Wild and Scenic River Study Act of 2008",Passed,5,185,0,9,219,4,0,11,0,0,0,0,224,189,0,20
577,D,110,H RES 1419,10-Sep-2008,1:35 PM,On Agreeing to the Resolution,"Providing for consideration of H.R. 3667, Missisquoi and Trout Rivers Wild and Scenic River Study Act of 2008",Passed,1,189,0,9,222,1,0,11,0,0,0,0,223,190,0,20
578,D,110,H R 1527,10-Sep-2008,1:43 PM,"On Motion to Suspend the Rules and Pass, as Amended",Rural Veterans Access to Care Act,Passed,191,0,0,8,226,0,0,8,0,0,0,0,417,0,0,16
579,D,110,S 2617,10-Sep-2008,1:52 PM,On Motion to Suspend the Rules and Pass,Veterans’ Compensation Cost-of-Living Adjustment Act of 2008,Passed,193,0,0,6,225,0,0,9,0,0,0,0,418,0,0,15
580,D,110,H R 3667,10-Sep-2008,3:52 PM,On Motion that the Committee Rise,Missisquoi and Trout Rivers Wild and Scenic River Study Act of 2008,Passed,1,188,0,11,220,5,0,13,0,0,0,0,221,193,0,24
581,D,110,H R 3667,10-Sep-2008,5:53 PM,On Agreeing to the Amendment,None,Agreed to,193,0,0,7,225,0,0,13,0,0,0,0,418,0,0,20
582,D,110,H R 3667,10-Sep-2008,6:25 PM,Table Appeal of the Ruling of the Chair,Missisquoi and Trout Rivers Wild and Scenic River Study Act of 2008,Passed,8,185,0,6,220,2,0,12,0,0,0,0,228,187,0,18
583,D,110,H R 3667,10-Sep-2008,6:49 PM,On Passage,Missisquoi and Trout Rivers Wild and Scenic River Study Act of 2008,Passed,77,118,0,4,222,0,0,12,0,0,0,0,299,118,0,16
584,D,110,H R 4081,10-Sep-2008,7:41 PM,"On Motion to Suspend the Rules and Pass, as Amended",Prevent All Cigarette Trafficking Act of 2007,Passed,176,10,0,13,203,2,0,29,0,0,0,0,379,12,0,42
585,D,110,JOURNAL,11-Sep-2008,4:00 PM,On Approving the Journal,None,Passed,0,183,1,15,215,7,0,12,0,0,0,0,215,190,1,27
586,D,110,H RES 1420,11-Sep-2008,4:08 PM,On Motion to Suspend the Rules and Agree,"Expressing the sense of the House of Representatives regarding the terrorist attacks launched against the United States on September 11, 2001",Passed,180,0,0,19,222,0,0,12,0,0,0,0,402,0,0,31
587,D,110,H R 6532,11-Sep-2008,4:18 PM,On Motion to Suspend the Rules and Agree to the Senate Amendment,To amend the Internal Revenue Code of 1986 to restore the Highway Trust Fund balance,Passed,152,29,0,18,224,0,0,10,0,0,0,0,376,29,0,28
588,D,110,ADJOURN,11-Sep-2008,4:34 PM,On Motion to Adjourn,None,Passed,0,177,0,22,208,13,0,13,0,0,0,0,208,190,0,35
589,D,110,H RES 1200,15-Sep-2008,6:57 PM,"On Motion to Suspend the Rules and Agree, as Amended",Honoring the dedication and outstanding work of military support groups across the country for their steadfast support of the members of our Armed Forces and their families,Passed,170,0,0,29,204,0,0,30,0,0,0,0,374,0,0,59
590,D,110,H CON RES 390,15-Sep-2008,7:08 PM,"On Motion to Suspend the Rules and Agree, as Amended",Honoring the 28th Infantry Division for serving and protecting the United States,Passed,169,0,0,30,205,0,0,29,0,0,0,0,374,0,0,59
591,D,110,H R 6889,15-Sep-2008,7:16 PM,On Motion to Suspend the Rules and Pass,"To extend the authority of the Secretary of Education to purchase guaranteed student loans for an additional year, and for other purposes",Passed,165,4,0,30,203,0,0,31,0,0,0,0,368,4,0,61
592,D,110,ADJOURN,16-Sep-2008,12:22 PM,On Motion to Adjourn,None,Failed,11,170,0,18,0,223,0,11,0,0,0,0,11,393,0,29
593,D,110,H RES 1433,16-Sep-2008,1:11 PM,Will the House Now Consider the Resolution,"Rule for H.R. 6899, the Energy Bill",Passed,2,179,0,18,228,1,0,5,0,0,0,0,230,180,0,23
594,D,110,ADJOURN,16-Sep-2008,1:31 PM,On Motion to Adjourn,None,Failed,8,165,0,26,1,221,0,12,0,0,0,0,9,386,0,38
595,D,110,H RES 1433,16-Sep-2008,4:26 PM,On Ordering the Previous Question,"Providing for consideration of H.R. 6899, Comprehensive American Energy Security and Consumer Protection Act",Passed,8,183,0,8,230,2,0,2,0,0,0,0,238,185,0,10
596,D,110,H RES 1433,16-Sep-2008,4:38 PM,On Agreeing to the Resolution,"Providing for consideration of H.R. 6899, Comprehensive American Energy Security and Consumer Protection Act",Passed,0,190,0,9,229,4,0,1,0,0,0,0,229,194,0,10
597,D,110,H RES 1434,16-Sep-2008,4:47 PM,On Ordering the Previous Question,"Providing for consideration of H.R. 6842, the National Capital Security and Safety Act",Passed,10,181,0,8,231,2,0,1,0,0,0,0,241,183,0,9
598,D,110,H R 6899,16-Sep-2008,9:56 PM,On Motion to Recommit with Instructions,Comprehensive American Energy Security and Consumer Protection Act,Failed,178,10,0,11,13,216,0,6,0,0,0,0,191,226,0,17
599,D,110,H R 6899,16-Sep-2008,10:04 PM,On Passage,Comprehensive American Energy Security and Consumer Protection Act,Passed,15,176,0,8,221,13,0,1,0,0,0,0,236,189,0,9
600,D,110,H R 6842,17-Sep-2008,10:58 AM,On Agreeing to the Amendment,None,Agreed to,178,9,0,13,82,151,1,4,0,0,0,0,260,160,1,17
601,D,110,H R 6842,17-Sep-2008,11:16 AM,On Passage,National Capital Security and Safety Act,Passed,181,7,0,11,85,145,1,3,0,0,0,0,266,152,1,14
602,D,110,H RES 1335,17-Sep-2008,5:54 PM,On Motion to Suspend the Rules and Agree,Celebrating the 120-year partnership between the Government and State veterans homes,Passed,188,0,0,11,223,0,0,11,0,0,0,0,411,0,0,22
603,D,110,S 2339,17-Sep-2008,6:02 PM,On Motion to Suspend the Rules and Agree,"To designate the Department of Veterans Affairs clinic in Alpena, Michigan, as the “Lieutenant Colonel Clement C. Van Wagoner Department of Veterans Affairs Clinic”",Passed,188,0,0,11,224,0,0,10,0,0,0,0,412,0,0,21
604,D,110,H R 1594,17-Sep-2008,6:10 PM,On Motion to Suspend the Rules and Pass,Michael A. Marzano Department of Veterans Affairs Outpatient Clinic,Passed,187,0,0,12,223,0,0,11,0,0,0,0,410,0,0,23
605,D,110,H RES 1449,18-Sep-2008,12:14 PM,On Ordering the Previous Question,"Providing for consideration of H.R. 6604, to amend the Commodity Exchange Act to bring greater transparency and accountability to commodity markets, and for other purposes",Passed,3,184,0,12,221,3,0,10,0,0,0,0,224,187,0,22
606,D,110,H RES 1449,18-Sep-2008,12:23 PM,On Agreeing to the Resolution,"Providing for consideration of H.R. 6604, to amend the Commodity Exchange Act to bring greater transparency and accountability to commodity markets, and for other purposes",Passed,0,186,0,13,218,4,0,12,0,0,0,0,218,190,0,25
607,D,110,H R 6604,18-Sep-2008,2:00 PM,On Motion to Recommit with Instructions,Commodity Markets Transparency and Accountability Act,Failed,189,0,0,10,7,221,0,6,0,0,0,0,196,221,0,16
608,D,110,H R 6604,18-Sep-2008,2:11 PM,On Passage,Commodity Markets Transparency and Accountability Act,Passed,69,119,0,11,214,14,0,6,0,0,0,0,283,133,0,17
609,D,110,H RES 1460,18-Sep-2008,2:36 PM,On Motion to Table,None,Passed,5,176,6,12,221,0,5,8,0,0,0,0,226,176,11,20
610,D,110,H RES 1441,18-Sep-2008,2:47 PM,On Ordering the Previous Question,"Providing for consideration of H.R. 3036, to amend the Elementary and Secondary Education Act of 1965 regarding environmental education, and for other purposes",Passed,3,185,0,11,224,3,0,7,0,0,0,0,227,188,0,18
611,D,110,H RES 1441,18-Sep-2008,2:54 PM,On Agreeing to the Resolution,"Providing for consideration of H.R. 3036, to amend the Elementary and Secondary Education Act of 1965 regarding environmental education, and for other purposes",Passed,2,181,0,16,219,1,0,14,0,0,0,0,221,182,0,30
612,D,110,H R 3036,18-Sep-2008,4:47 PM,On Agreeing to the Amendment,None,Agreed to,158,22,0,20,225,1,0,12,0,0,0,0,383,23,0,32
613,D,110,H R 3036,18-Sep-2008,5:17 PM,On Motion to Recommit with Instructions,No Child Left Inside Act of 2008,Failed,172,8,0,19,0,222,0,12,0,0,0,0,172,230,0,31
614,D,110,H R 3036,18-Sep-2008,5:25 PM,On Passage,No Child Left Inside Act of 2008,Passed,68,108,0,23,225,1,0,8,0,0,0,0,293,109,0,31
615,D,110,H R 6460,18-Sep-2008,5:33 PM,"On Motion to Suspend the Rules and Pass, as Amended",Great Lakes Legacy Reauthorization Act of 2008,Passed,151,20,0,28,220,0,0,14,0,0,0,0,371,20,0,42
616,D,110,H R 6685,22-Sep-2008,6:56 PM,On Motion to Suspend the Rules and Pass,To authorize the Secretary of the Interior to provide an annual grant to facilitate an iron working training program for Native Americans,Passed,94,72,0,33,208,0,0,26,0,0,0,0,302,72,0,59
617,D,110,H R 1907,22-Sep-2008,7:03 PM,"On Motion to Suspend the Rules and Pass, as Amended",Coastal and Estuarine Land Conservation Program Act,Passed,105,59,0,35,208,0,0,26,0,0,0,0,313,59,0,61
618,D,110,H R 6853,22-Sep-2008,7:12 PM,"On Motion to Suspend the Rules and Pass, as Amended",Nationwide Mortgage Fraud Coordinator Act of 2008,Passed,142,23,0,34,208,0,0,26,0,0,0,0,350,23,0,60
619,D,110,H RES 1476,23-Sep-2008,11:53 AM,On Ordering the Previous Question,"Providing for consideration of H.R. 5244, Credit Cardholders’ Bill of Rights Act of 2008",Passed,3,189,0,7,218,3,0,13,0,0,0,0,221,192,0,20
620,D,110,H RES 1476,23-Sep-2008,12:01 PM,On Agreeing to the Resolution,"Providing for consideration of H.R. 5244, Credit Cardholders’ Bill of Rights Act of 2008",Passed,0,192,0,7,220,2,0,12,0,0,0,0,220,194,0,19
621,D,110,S J RES 45,23-Sep-2008,12:09 PM,On Motion to Suspend the Rules and Pass,Expressing the consent and approval of Congress to an interstate compact regarding water resources in the Great Lakes--St. Lawrence River Basin,Passed,185,6,0,8,205,19,0,10,0,0,0,0,390,25,0,18
622,D,110,H R 5244,23-Sep-2008,1:47 PM,On Motion to Recommit with Instructions,Credit Cardholders’ Bill of Rights Act of 2008,Failed,189,0,0,10,9,219,0,6,0,0,0,0,198,219,0,16
623,D,110,H R 5244,23-Sep-2008,1:58 PM,On Passage,Credit Cardholders’ Bill of Rights Act of 2008,Passed,84,111,0,4,228,1,0,5,0,0,0,0,312,112,0,9
624,D,110,H R 6897,23-Sep-2008,2:05 PM,"On Motion to Suspend the Rules and Pass, as Amended",Filipino Veterans Equity Act 2008,Passed,172,22,0,5,220,1,0,13,0,0,0,0,392,23,0,18
625,D,110,H R 6983,23-Sep-2008,6:49 PM,"On Motion to Suspend the Rules and Pass, as Amended",Paul Wellstone and Pete Domenici Mental Health Parity and Addiction Equity Act of 2008,Passed,143,47,0,9,233,0,0,1,0,0,0,0,376,47,0,10
626,D,110,H R 5352,23-Sep-2008,6:58 PM,"On Motion to Suspend the Rules and Pass, as Amended",Elder Abuse Victims Act of 2008,Passed,161,28,0,10,226,0,0,8,0,0,0,0,387,28,0,18
627,D,110,H R 642,23-Sep-2008,7:06 PM,"On Motion to Suspend the Rules and Pass, as Amended",Honorable Stephanie Tubbs Jones College Fire Prevention Act,Passed,138,51,0,10,227,0,0,7,0,0,0,0,365,51,0,17
628,D,110,H RES 1488,24-Sep-2008,12:13 PM,Will the House Now Consider the Resolution,"Providing for consideration of the Senate amendment to H.R. 2638, making appropriations for the Department of Homeland Security FY 2008",Passed,22,167,0,10,220,1,0,13,0,0,0,0,242,168,0,23
629,D,110,H RES 1488,24-Sep-2008,1:44 PM,On Ordering the Previous Question,"Providing for consideration of the Senate amendment to H.R. 2638, making appropriations for the Department of Homeland Security FY 2008",Passed,4,193,0,2,227,5,0,2,0,0,0,0,231,198,0,4
630,D,110,H RES 1488,24-Sep-2008,1:53 PM,On Agreeing to the Resolution,"Providing for consideration of the Senate amendment to H.R. 2638, making appropriations for the Department of Homeland Security FY 2008",Passed,0,197,0,2,228,5,0,1,0,0,0,0,228,202,0,3
631,D,110,S 3001,24-Sep-2008,2:02 PM,"On Motion to Suspend the Rules and Pass, as Amended",National Defense Authorization Act for Fiscal Year 2009,Passed,192,5,0,2,200,34,0,0,0,0,0,0,392,39,0,2
632,D,110,H R 2638,24-Sep-2008,3:47 PM,On Motion to Concur in Senate Amendment with Amendment,"Making appropriations for the Department of Homeland Security for fiscal year ending September 30, 2008",Passed,146,51,1,1,224,7,0,3,0,0,0,0,370,58,1,4
633,D,110,H R 5265,24-Sep-2008,3:55 PM,"On Motion to Suspend the Rules and Pass, as Amended","Paul D. Wellstone Muscular Dystrophy Community Assistance, Research, and Education Amendments of 2008",Passed,193,2,0,4,225,0,0,9,0,0,0,0,418,2,0,13
634,D,110,H R 7005,24-Sep-2008,6:57 PM,On Motion to Suspend the Rules and Pass,Alternative Minimum Tax Relief Act of 2008,Passed,193,0,0,6,200,30,0,4,0,0,0,0,393,30,0,10
635,D,110,H R 7006,24-Sep-2008,7:06 PM,On Motion to Suspend the Rules and Pass,Disaster Tax Relief Act of 2008,Passed,193,0,0,6,226,4,0,4,0,0,0,0,419,4,0,10
636,D,110,S 2606,24-Sep-2008,7:13 PM,On Motion to Suspend the Rules and Pass,United States Fire Administration Reauthorization Act of 2008,Passed,189,2,0,8,229,0,0,5,0,0,0,0,418,2,0,13
637,D,110,H RES 1490,25-Sep-2008,1:36 PM,On Ordering the Previous Question,Same Day Rule,Passed,4,191,0,4,223,7,0,4,0,0,0,0,227,198,0,8
638,D,110,H RES 1490,25-Sep-2008,1:43 PM,On Agreeing to the Resolution,Same Day Rule,Passed,0,193,0,6,222,5,0,7,0,0,0,0,222,198,0,13
639,D,110,H R 758,25-Sep-2008,1:53 PM,"On Motion to Suspend the Rules and Pass, as Amended",Breast Cancer Patient Protection Act of 2008,Passed,190,2,0,7,231,0,0,3,0,0,0,0,421,2,0,10
640,D,110,H RES 1501,25-Sep-2008,3:39 PM,On Ordering the Previous Question,Proceedings on Roll Call 640 were vacated by unanimous consent.,Passed,0,194,0,5,223,6,0,5,0,0,0,0,223,200,0,10
641,D,110,H CON RES 255,25-Sep-2008,4:04 PM,"On Motion to Suspend the Rules and Agree, as Amended",Expressing the sense of Congress regarding the United States commitment to preservation of religious and cultural sites and condemning instances where sites are desecrated,Passed,189,1,0,9,225,0,0,9,0,0,0,0,414,1,0,18
642,D,110,H R 1014,25-Sep-2008,5:42 PM,"On Motion to Suspend the Rules and Pass, as Amended","Heart Disease Education, Analysis Research, and Treatment for Women Act or the “HEART for Women Act”",Passed,189,4,0,6,229,0,0,5,0,0,0,0,418,4,0,11
643,D,110,H R 6950,25-Sep-2008,5:50 PM,On Motion to Suspend the Rules and Pass,Stephanie Tubbs Jones Gift or Life Medal Act of 2008,Passed,190,1,0,8,230,0,0,4,0,0,0,0,420,1,0,12
644,D,110,H RES 1421,25-Sep-2008,6:01 PM,"On Motion to Suspend the Rules and Agree, as Amended","Commemorating the 25th anniversary of the tragic October 1983 terrorist bombing of the United States Marine Corps Barracks in Beirut, Lebanon",Passed,189,0,0,10,225,0,0,9,0,0,0,0,414,0,0,19
645,D,110,H RES 1502,26-Sep-2008,9:51 AM,On Ordering the Previous Question,"Providing for consideration of H.R. 7060, to amend the Internal Revenue Code of 1986 to provide incentives for energy production and conservation, to extend certain expiring provisions, to provide individual income tax relief, and for other purposes",Passed,0,181,0,18,206,5,0,23,0,0,0,0,206,186,0,41
646,D,110,H RES 1502,26-Sep-2008,10:01 AM,On Agreeing to the Resolution,"Providing for consideration of H.R. 7060, to amend the Internal Revenue Code of 1986 to provide incentives for energy production and conservation, to extend certain expiring provisions, to provide individual income tax relief, and for other purposes",Passed,0,184,0,15,215,4,0,15,0,0,0,0,215,188,0,30
647,D,110,H R 6045,26-Sep-2008,10:12 AM,On Motion to Suspend the Rules and Pass,Bulletproof Vest Partnership Grant Act,Passed,183,2,0,14,221,0,0,13,0,0,0,0,404,2,0,27
648,D,110,H R 7060,26-Sep-2008,11:45 AM,Table Appeal of the Ruling of the Chair,Renewable Energy and Job Creation Tax Act of 2008,Passed,0,192,0,7,220,6,0,8,0,0,0,0,220,198,0,15
649,D,110,H R 7060,26-Sep-2008,11:54 AM,On Passage,Renewable Energy and Job Creation Tax Act of 2008,Passed,30,165,0,4,227,1,0,6,0,0,0,0,257,166,0,10
650,D,110,S 1382,26-Sep-2008,12:02 PM,On Motion to Suspend the Rules and Pass,To amend the Public Health Service Act to provide for the establishment of an Amyotrophic Lateral Sclerosis Registry,Passed,189,2,0,8,226,0,0,8,0,0,0,0,415,2,0,16
651,D,110,H RES 1500,26-Sep-2008,1:13 PM,On Ordering the Previous Question,Providing for consideration of motions to suspend the rules,Passed,4,189,0,6,221,3,0,10,0,0,0,0,225,192,0,16
652,D,110,H RES 1500,26-Sep-2008,1:25 PM,On Agreeing to the Resolution,Providing for consideration of motions to suspend the rules,Passed,0,193,0,6,222,3,0,9,0,0,0,0,222,196,0,15
653,D,110,S 2932,26-Sep-2008,1:32 PM,On Motion to Suspend the Rules and Pass,"Poison Center Support, Enhancement, and Awareness Act of 2008",Passed,184,6,0,9,219,0,0,15,0,0,0,0,403,6,0,24
654,D,110,H RES 1503,26-Sep-2008,3:01 PM,On Ordering the Previous Question,Rule waiving a requirement of clause 6(a) of rule XIII with respect to consideration of certain resolutions reported from the Committee on Rules,Passed,2,190,0,7,220,8,0,6,0,0,0,0,222,198,0,13
655,D,110,H RES 1503,26-Sep-2008,3:11 PM,On Agreeing to the Resolution,Rule waiving a requirement of clause 6(a) of rule XIII with respect to consideration of certain resolutions reported from the Committee on Rules,Passed,0,192,0,7,216,11,0,7,0,0,0,0,216,203,0,14
656,D,110,H R 4120,26-Sep-2008,3:28 PM,Suspend the Rules and Concur in the Senate Amendment,Effective Child Pornography Prosecution Act,Passed,192,0,0,7,226,0,0,8,0,0,0,0,418,0,0,15
657,D,110,H RES 1507,26-Sep-2008,5:08 PM,On Ordering the Previous Question,"Providing for consideration of H.R. 7110, making supplemental appropriations for job creation and preservation, infrastructure investment, and economic and energy assistance for the fiscal year ending September 30, 2009, and for other purposes",Passed,0,193,0,6,218,11,0,5,0,0,0,0,218,204,0,11
658,D,110,H RES 1507,26-Sep-2008,5:21 PM,On Agreeing to the Resolution,"Providing for consideration of H.R. 7110, making supplemental appropriations for job creation and preservation, infrastructure investment, and economic and energy assistance for the fiscal year ending September 30, 2009, and for other purposes",Passed,0,192,0,7,213,16,0,5,0,0,0,0,213,208,0,12
659,D,110,S 1046,26-Sep-2008,5:29 PM,On Motion to Suspend the Rules and Pass,Senior Professional Performance Act,Passed,192,0,0,7,227,0,0,7,0,0,0,0,419,0,0,14
660,D,110,H R 7110,26-Sep-2008,6:41 PM,On Passage,"Making supplemental appropriations for job creation and preservation, infrastructure investment, and economic and energy assistance for the fiscal year ending September 30, 2009",Passed,41,150,0,8,223,8,0,4,0,0,0,0,264,158,0,12
661,D,110,H R 928,27-Sep-2008,4:37 PM,Suspend the Rules and concur in the Senate Amendment,Inspector General Reform Act,Passed,189,0,0,10,225,0,0,9,0,0,0,0,414,0,0,19
662,D,110,H R 7081,27-Sep-2008,4:44 PM,On Motion to Suspend the Rules and Pass,United States-India Nuclear Cooperation Approval and Nonproliferation Enhancement Act,Passed,178,10,0,11,120,107,1,6,0,0,0,0,298,117,1,17
663,D,110,H R 6707,27-Sep-2008,4:55 PM,"On Motion to Suspend the Rules and Pass, as Amended",Taking Responsible Action for Community Safety Act,Failed,37,153,0,9,206,22,0,6,0,0,0,0,243,175,0,15
664,D,110,S 3325,28-Sep-2008,5:03 PM,On Motion to Suspend the Rules and Pass,None,Passed,176,19,0,4,205,22,0,7,0,0,0,0,381,41,0,11
665,D,110,H R 6460,28-Sep-2008,5:12 PM,Suspend the Rules and Concur in the Senate Amendment,Great Lakes Legacy Reauthorization Act of 2008,Passed,185,9,0,5,226,0,0,8,0,0,0,0,411,9,0,13
666,D,110,H RES 1514,28-Sep-2008,8:43 PM,On Ordering the Previous Question,Waiving a requirement of clause 6(a) of rule XIII with respect to consideration of certain resolutions reported from the Committee on Rules,Passed,0,193,0,6,211,8,0,15,0,0,0,0,211,201,0,21
667,D,110,H RES 1514,28-Sep-2008,8:51 PM,On Agreeing to the Resolution,Waiving a requirement of clause 6(a) of rule XIII with respect to consideration of certain resolutions reported from the Committee on Rules,Passed,0,192,0,7,216,8,0,10,0,0,0,0,216,200,0,17
668,D,110,S 2840,28-Sep-2008,9:03 PM,On Motion to Suspend the Rules and Pass,Military Personnel Citizenship Processing Act,Passed,192,0,0,7,224,0,0,10,0,0,0,0,416,0,0,17
669,D,110,S 906,29-Sep-2008,8:30 AM,On Motion to Suspend the Rules and Pass,"To prohibit the sale, distribution,transfer, and export of elemental mercury, and for other purposes",Passed,170,5,6,18,223,0,0,11,0,0,0,0,393,5,6,29
670,D,110,H RES 1517,29-Sep-2008,8:36 AM,On Ordering the Previous Question,"Rule providing for consideration of the Senate amendment to the House amendment to the Senate amendment to H.R. 3997, the Emergency Economic Stabilization Act of 2008.",Passed,3,188,0,8,214,8,0,12,0,0,0,0,217,196,0,20
671,D,110,H RES 1517,29-Sep-2008,8:45 AM,On Agreeing to the Resolution,"Rule providing for consideration of the Senate amendment to the House amendment to the Senate amendment to H.R. 3997, the Emergency Economic Stabilization Act of 2008.",Passed,11,181,0,7,209,17,0,8,0,0,0,0,220,198,0,15
672,D,110,H CON RES 440,29-Sep-2008,9:05 AM,On Agreeing to the Resolution,Provding for an adjournment or recess of the two Houses,Passed,0,194,0,5,213,17,0,5,0,0,0,0,213,211,0,10
673,D,110,ADJOURN,29-Sep-2008,9:26 AM,On Motion to Adjourn,None,Failed,7,173,0,19,1,221,0,12,0,0,0,0,8,394,0,31
674,D,110,H R 3997,29-Sep-2008,2:07 PM,On Concurring in Senate Amendment With An Amendment,"To amend the Internal Revenue Code of 1986 to provide earnings assistance and tax relief to members of the uniformed services, volunteer firefighters, and Peace Corps volunteers, and for other purposes",Failed,65,133,0,1,140,95,0,0,0,0,0,0,205,228,0,1
675,D,110,H R 7175,29-Sep-2008,2:17 PM,On Motion to Suspend the Rules and Pass,Small Business Financing Improvements Act of 2008,Passed,168,6,0,25,206,0,0,28,0,0,0,0,374,6,0,53
676,D,110,S 3641,2-Oct-2008,5:27 PM,On Motion to Suspend the Rules and Pass,To authorize funding for the National Crime Victim Law Institute to provide support for victims of crime under Crime Victims Legal Assistance Programs as a part of the Victims of Crime Act of 1984.,Passed,188,2,0,9,222,0,0,12,0,0,0,0,410,2,0,21
677,D,110,S 3641,2-Oct-2008,5:36 PM,Table Motion to Reconsider,To authorize funding for the National Crime Victim Law Institute to provide support for victims of crime under Crime Victims Legal Assistance Programs as a part of the Victims of Crime Act of 1984.,Passed,75,115,0,9,220,0,0,14,0,0,0,0,295,115,0,23
678,D,110,H R 7221,2-Oct-2008,5:44 PM,"On Motion to Suspend the Rules and Pass, as Amended",Homeless Emergency Assistance and Rapid Transition to Housing Act,Passed,131,61,0,7,224,0,0,10,0,0,0,0,355,61,0,17
679,D,110,H RES 1525,3-Oct-2008,10:25 AM,On Ordering the Previous Question,"Providing for consideration of the Senate amendments to H.R. 1424, Emergency Economic Stabilization Act of 2008.",Passed,19,176,0,4,216,14,0,4,0,0,0,0,235,190,0,8
680,D,110,H RES 1525,3-Oct-2008,10:34 AM,On Agreeing to the Resolution,"Providing for consideration of the Senate amendments to H.R. 1424, Emergency Economic Stabilization Act of 2008.",Passed,20,176,0,3,203,29,0,2,0,0,0,0,223,205,0,5
681,D,110,H R 1424,3-Oct-2008,1:22 PM,On Motion to Concur in Senate Amendments,Emergency Economic Stabilization Act of 2008,Passed,91,108,0,0,172,63,0,0,0,0,0,0,263,171,0,0
682,D,110,S 3197,3-Oct-2008,1:29 PM,On Motion to Suspend the Rules and Pass,National Guard and Reservists Debt Relief Act,Passed,184,0,0,15,227,0,0,7,0,0,0,0,411,0,0,22
683,D,110,H R 6867,3-Oct-2008,2:41 PM,"On Motion to Suspend the Rules and Pass, as Amended",Unemployment Compensation Extension Act of 2008,Passed,142,28,0,29,226,0,0,9,0,0,0,0,368,28,0,38
684,D,110,H RES 1533,10-Dec-2008,3:47 PM,On Ordering the Previous Question,Waiving a requirement of clause 6(a) of Rule XIII with respect to consideration of certain resolutions reported from the Committee on Rules,Passed,6,170,0,22,218,4,0,13,0,0,0,0,224,174,0,35
685,D,110,H RES 1533,10-Dec-2008,3:57 PM,On Agreeing to the Resolution,Waiving a requirement of clause 6(a) of Rule XIII with respect to consideration of certain resolutions reported from the Committee on Rules,Passed,10,164,0,24,216,5,0,14,0,0,0,0,226,169,0,38
686,D,110,JOURNAL,10-Dec-2008,4:11 PM,On Approving the Journal,None,Passed,8,163,1,26,207,7,0,21,0,0,0,0,215,170,1,47
687,D,110,H RES 1534,10-Dec-2008,5:53 PM,On Ordering the Previous Question,"Providing for consideration of H.R. 7321, to authorize financial assistance to eligible automobile manufacturers, and for other purposes",Passed,5,176,1,16,220,4,0,11,0,0,0,0,225,180,1,27
688,D,110,H RES 1534,10-Dec-2008,6:12 PM,On Agreeing to the Resolution,"Providing for consideration of H.R. 7321, to authorize financial assistance to eligible automobile manufacturers, and for other purposes",Passed,10,170,1,17,215,9,0,11,0,0,0,0,225,179,1,28
689,D,110,H R 7321,10-Dec-2008,8:27 PM,On Agreeing to the Amendment,None,Agreed to,180,0,1,17,223,0,0,12,0,0,0,0,403,0,1,29
690,D,110,H R 7321,10-Dec-2008,8:46 PM,On Passage,Auto Industry Financing and Restructuring Act,Passed,32,150,1,15,205,20,0,11,0,0,0,0,237,170,1,26
