Roll Call,Majority,Congress Num,Legislation Number,Date,Time,Question,Description,Result,Republican Yes,Republican No,Republican Present,Republican Not Voting,Democrat Yes,Democrat No,Democrat Present,Democrat Not Voting,Independent Yes,Independent No,Independent Present,Independent Not Voting,Total Yes,Total No,Total Present,Total Not Voting
1,R,112,QUORUM,5-Jan-2011,12:34 PM,Call of the House,None,Passed,0,0,242,0,0,0,192,0,0,0,0,0,0,0,434,0
2
3,R,112,H RES 5,5-Jan-2011,3:11 PM,On Motion to Table,Adopting rules for the One Hundred Twelfth Congress,Passed,223,0,0,16,0,188,0,4,0,0,0,0,223,188,0,20
4,R,112,H RES 5,5-Jan-2011,4:57 PM,On Ordering the Previous Question,Adopting rules for the One Hundred Twelfth Congress,Passed,236,0,0,3,0,188,0,4,0,0,0,0,236,188,0,7
5,R,112,H RES 5,5-Jan-2011,5:17 PM,On Motion to Commit,Adopting rules for the One Hundred Twelfth Congress,Failed,0,238,0,1,191,0,0,1,0,0,0,0,191,238,0,2
6,R,112,H RES 5,5-Jan-2011,5:34 PM,On Agreeing to the Resolution,Adopting rules for the One Hundred Twelfth Congress,Passed,238,0,0,1,0,191,0,1,0,0,0,0,238,191,0,2
7,R,112,QUORUM,6-Jan-2011,10:54 AM,Call of the House,None,Passed,0,0,225,14,0,0,179,14,0,0,0,0,0,0,404,28
8,R,112,H RES 22,6-Jan-2011,1:39 PM,On Motion to Suspend the Rules and Agree,"Reducing the amount authorized for salaries and expenses of Member, committee, and leadership offices in 2011 and 2012.",Passed,231,0,0,8,177,13,0,3,0,0,0,0,408,13,0,11
9,R,112,H RES 26,7-Jan-2011,10:56 AM,On Ordering the Previous Question,"Providing for consideration of H.R. 2, to repeal the job-killing health care law and health care-related provisions in the Health Care and Education Reconciliation Act of 2010; and providing for consideration of H.Res. 9, instructing certain committees to report legislation replacing the job-killing health care law",Passed,234,0,0,7,2,182,0,9,0,0,0,0,236,182,0,16
10,R,112,H RES 26,7-Jan-2011,11:04 AM,On Agreeing to the Resolution,"Providing for consideration of H.R. 2, to repeal the job-killing health care law and health care-related provisions in the Health Care and Education Reconciliation Act of 2010; and providing for consideration of H.Res. 9, instructing certain committees to report legislation replacing the job-killing health care law",Passed,232,0,2,7,4,181,0,8,0,0,0,0,236,181,2,15
11,R,112,H RES 27,7-Jan-2011,11:32 AM,On Agreeing to the Resolution,Relating to the status of certain actions taken by Members-elect,Passed,230,0,2,9,27,159,1,6,0,0,0,0,257,159,3,15
12,R,112,H R 292,18-Jan-2011,6:52 PM,"On Motion to Suspend the Rules and Pass, as Amended",Stop the OverPrinting (STOP) Act,Passed,234,0,0,7,165,0,0,28,0,0,0,0,399,0,0,35
13,R,112,H R 2,19-Jan-2011,5:46 PM,On Motion to Recommit with Instructions,Repealing the Job-Killing Health Care Law Act,Failed,0,240,0,1,185,5,0,3,0,0,0,0,185,245,0,4
14,R,112,H R 2,19-Jan-2011,5:53 PM,On Passage,Repealing the Job-Killing Health Care Law Act,Passed,242,0,0,0,3,189,0,1,0,0,0,0,245,189,0,1
15,R,112,H RES 9,20-Jan-2011,11:00 AM,On Agreeing to the Amendment,None,Agreed to,240,0,0,1,188,1,0,4,0,0,0,0,428,1,0,5
16,R,112,H RES 9,20-Jan-2011,11:08 AM,On Agreeing to the Resolution,Instructing certain committees to report legislation replacing the job-killing health care law,Passed,239,0,0,2,14,175,0,4,0,0,0,0,253,175,0,6
17,R,112,H RES 43,24-Jan-2011,6:53 PM,On Ordering the Previous Question,Providing for consideration of the resolution (H.Res. 38) to reduce spending through a transition to non-security spending at fiscal year 2008 levels,Passed,232,0,0,9,6,174,0,13,0,0,0,0,238,174,0,22
18,R,112,H RES 43,24-Jan-2011,7:01 PM,On Agreeing to the Resolution,Providing for consideration of the resolution (H.Res. 38) to reduce spending through a transition to non-security spending at fiscal year 2008 levels,Passed,232,0,0,9,8,168,0,17,0,0,0,0,240,168,0,26
19,R,112,H RES 38,25-Jan-2011,2:13 PM,On Motion to Recommit with Instructions,To reduce spending through a transition to non-security spending at fiscal year 2008 levels,Failed,0,238,0,3,184,4,1,4,0,0,0,0,184,242,1,7
20,R,112,H RES 38,25-Jan-2011,2:22 PM,On Agreeing to the Resolution,To reduce spending through a transition to non-security spending at fiscal year 2008 levels,Passed,239,0,0,2,17,165,0,11,0,0,0,0,256,165,0,13
21,R,112,H RES 49,25-Jan-2011,2:30 PM,On Motion to Suspend the Rules and Agree,Providing Capitol-flown flags for recipients of the Medal of Honor,Passed,238,0,0,3,186,0,0,7,0,0,0,0,424,0,0,10
22,R,112,H RES 54,26-Jan-2011,11:31 AM,On Ordering the Previous Question,"Providing for consideration of H.R. 359, to reduce Federal spending and the deficit by terminating taxpayer financing of presidential election campaigns and party conventions",Passed,232,0,0,9,2,178,0,13,0,0,0,0,234,178,0,22
23,R,112,H R 359,26-Jan-2011,1:35 PM,On Agreeing to the Amendment,None,Agreed to,232,0,0,9,164,7,0,22,0,0,0,0,396,7,0,31
24,R,112,H R 359,26-Jan-2011,2:06 PM,On Motion to Recommit with Instructions,To reduce Federal spending and the deficit by terminating taxpayer financing of presidential election campaigns and party conventions,Failed,1,227,0,13,172,1,0,20,0,0,0,0,173,228,0,33
25,R,112,H R 359,26-Jan-2011,2:12 PM,On Passage,To reduce Federal spending and the deficit by terminating taxpayer financing of presidential election campaigns and party conventions,Passed,229,1,0,11,10,159,0,24,0,0,0,0,239,160,0,35
26,R,112,H R 514,8-Feb-2011,7:04 PM,On Motion to Suspend the Rules and Pass,"To extend expiring provisions of the USA PATRIOT Improvement and Reauthorization Act of 2005 and Intelligence Reform and Terrorism Prevention Act of 2004 relating to access to business records, individual terrorists as agents of foreign powers, and roving wiretaps until December 8, 2011",Failed,210,26,0,5,67,122,0,4,0,0,0,0,277,148,0,9
27,R,112,S 188,9-Feb-2011,1:55 PM,On Motion to Suspend the Rules and Pass,"To designate the United States courthouse under construction at 98 West First Street, Yuma, Arizona, as the “John M. Roll United States Courthouse”",Passed,238,0,0,3,191,0,0,2,0,0,0,0,429,0,0,5
28,R,112,H R 519,9-Feb-2011,2:04 PM,On Motion to Suspend the Rules and Pass,United Nations Tax Equalization Refund Act,Failed,236,2,0,3,23,167,0,3,0,0,0,0,259,169,0,6
29,R,112,H RES 79,10-Feb-2011,3:11 PM,On Agreeing to the Resolution,"Providing for consideration of H.R. 514, to extend expiring provisions of the USA PATRIOT Improvement and Reauthorization Act of 2005 and Intelligence Reform and Terrorism Prevention Act of 2004",Passed,233,4,0,3,15,172,0,6,0,0,0,0,248,176,0,9
30,R,112,H RES 73,10-Feb-2011,3:19 PM,On Ordering the Previous Question,"Providing for consideration of H. Res. 72, directing certain standing committees to inventory and review existing, pending, and proposed regulations and orders from agencies of the Federal Government, particularly with respect to their effect on jobs and economic growth",Passed,234,0,0,6,6,180,0,7,0,0,0,0,240,180,0,13
31,R,112,H RES 73,10-Feb-2011,3:27 PM,On Agreeing to the Resolution,"Providing for consideration of H. Res. 72, directing certain standing committees to inventory and review existing, pending, and proposed regulations and orders from agencies of the Federal Government, particularly with respect to their effect on jobs and economic growth",Passed,237,0,0,3,18,169,0,6,0,0,0,0,255,169,0,9
32,R,112,H RES 72,11-Feb-2011,1:34 PM,On Motion to Recommit with Instructions,"Directing certain standing committees to inventory and review existing, pending, and proposed regulations and orders from agencies of the Federal Government, particularly with respect to their effect on jobs and economic growth",Failed,0,239,0,1,178,3,0,12,0,0,0,0,178,242,0,13
33,R,112,H RES 72,11-Feb-2011,1:51 PM,On Agreeing to the Resolution,"Directing certain standing committees to inventory and review existing, pending, and proposed regulations and orders from agencies of the Federal Government, particularly with respect to their effect on jobs and economic growth",Passed,238,0,0,2,153,28,0,12,0,0,0,0,391,28,0,14
34,R,112,JOURNAL,11-Feb-2011,1:58 PM,On Approving the Journal,None,Passed,225,4,1,10,119,46,0,28,0,0,0,0,344,50,1,38
35,R,112,H R 514,14-Feb-2011,6:55 PM,On Motion to Recommit with Instructions,"To extend expiring provisions of the USA PATRIOT Improvement and Reauthorization Act of 2005 and Intelligence Reform and Terrorism Prevention Act of 2004 relating to access to business records, individual terrorists as agents of foreign powers, and roving wiretaps until December 8, 2011",Failed,2,234,0,4,184,0,0,9,0,0,0,0,186,234,0,13
36,R,112,H R 514,14-Feb-2011,7:03 PM,On Passage,"To extend expiring provisions of the USA PATRIOT Improvement and Reauthorization Act of 2005 and Intelligence Reform and Terrorism Prevention Act of 2004 relating to access to business records, individual terrorists as agents of foreign powers, and roving wiretaps until December 8, 2011",Passed,210,27,0,3,65,117,0,11,0,0,0,0,275,144,0,14
37,R,112,JOURNAL,14-Feb-2011,7:10 PM,On Approving the Journal,None,Passed,220,10,3,7,132,49,0,12,0,0,0,0,352,59,3,19
38,R,112,H RES 92,15-Feb-2011,1:55 PM,On Ordering the Previous Question,"Providing for consideration of H.R. 1, making appropriations for the Department of Defense and other departments and agencies of the Government for the fiscal year ending September 30, 2011, and for other purposes",Passed,238,0,0,2,2,179,0,12,0,0,0,0,240,179,0,14
39,R,112,H RES 92,15-Feb-2011,2:06 PM,On Agreeing to the Resolution,"Providing for consideration of H.R. 1, making appropriations for the Department of Defense and other departments and agencies of the Government for the fiscal year ending September 30, 2011, and for other purposes",Passed,234,0,2,4,8,174,0,11,0,0,0,0,242,174,2,15
40,R,112,H CON RES 17,15-Feb-2011,2:13 PM,On Agreeing to the Resolution,Adjournment Resolution,Passed,235,3,0,2,8,173,0,12,0,0,0,0,243,176,0,14
41,R,112,H R 1,15-Feb-2011,7:08 PM,On Agreeing to the Amendment,None,Failed,92,148,0,0,115,75,0,3,0,0,0,0,207,223,0,3
42,R,112,H R 1,15-Feb-2011,7:13 PM,On Agreeing to the Amendment,None,Failed,71,169,0,0,1,189,0,3,0,0,0,0,72,358,0,3
43,R,112,H R 1,15-Feb-2011,7:18 PM,On Agreeing to the Amendment,None,Failed,17,223,0,0,88,103,0,2,0,0,0,0,105,326,0,2
44,R,112,H R 1,15-Feb-2011,7:24 PM,On Agreeing to the Amendment,None,Failed,104,135,0,1,5,185,0,3,0,0,0,0,109,320,0,4
45,R,112,H RES 93,16-Feb-2011,1:29 PM,On Agreeing to the Resolution,Providing for consideration of the Senate amendment to the bill (H.R. 514) to extend expiring provisions of the USA PATRIOT Improvement and Reauthorization Act of 2005 and Intelligence Reform and Terrorism Prevention Act of 2004,Passed,236,4,0,0,18,172,0,3,0,0,0,0,254,176,0,3
46,R,112,H R 1,16-Feb-2011,1:49 PM,On Agreeing to the Amendment,None,Agreed to,110,130,0,0,123,68,1,1,0,0,0,0,233,198,1,1
47,R,112,H R 1,16-Feb-2011,1:53 PM,On Agreeing to the Amendment,None,Failed,36,202,0,2,99,92,0,2,0,0,0,0,135,294,0,4
48,R,112,H R 1,16-Feb-2011,1:58 PM,On Agreeing to the Amendment,None,Failed,16,224,0,0,117,75,0,1,0,0,0,0,133,299,0,1
49,R,112,H R 1,16-Feb-2011,2:02 PM,On Agreeing to the Amendment,None,Failed,9,231,0,0,127,65,0,1,0,0,0,0,136,296,0,1
50,R,112,H R 1,16-Feb-2011,2:07 PM,On Agreeing to the Amendment,None,Agreed to,145,95,0,0,160,32,0,1,0,0,0,0,305,127,0,1
51,R,112,H R 1,16-Feb-2011,2:10 PM,On Agreeing to the Amendment,None,Agreed to,217,22,0,1,45,147,0,1,0,0,0,0,262,169,0,2
52,R,112,H R 1,16-Feb-2011,2:13 PM,On Agreeing to the Amendment,None,Failed,157,82,0,1,27,165,0,1,0,0,0,0,184,247,0,2
53,R,112,H R 1,16-Feb-2011,2:18 PM,On Agreeing to the Amendment,None,Agreed to,70,169,0,1,158,34,0,1,0,0,0,0,228,203,0,2
54,R,112,H R 1,16-Feb-2011,2:22 PM,On Agreeing to the Amendment,None,Failed,170,68,0,2,1,191,0,1,0,0,0,0,171,259,0,3
55,R,112,H R 1,16-Feb-2011,2:24 PM,On Agreeing to the Amendment,None,Failed,165,75,0,0,5,187,0,1,0,0,0,0,170,262,0,1
56,R,112,H R 1,16-Feb-2011,2:28 PM,On Agreeing to the Amendment,None,Failed,13,227,0,0,146,46,0,1,0,0,0,0,159,273,0,1
57,R,112,H R 1,16-Feb-2011,2:31 PM,On Agreeing to the Amendment,None,Failed,23,217,0,0,185,6,0,2,0,0,0,0,208,223,0,2
58,R,112,H R 1,16-Feb-2011,2:34 PM,On Agreeing to the Amendment,None,Failed,135,103,0,2,2,190,0,1,0,0,0,0,137,293,0,3
59,R,112,H R 1,16-Feb-2011,2:38 PM,On Agreeing to the Amendment,None,Failed,44,196,0,0,86,105,0,2,0,0,0,0,130,301,0,2
60,R,112,H R 1,16-Feb-2011,2:42 PM,On Agreeing to the Amendment,None,Agreed to,132,107,0,1,186,6,0,1,0,0,0,0,318,113,0,2
61,R,112,H R 1,16-Feb-2011,7:02 PM,On Agreeing to the Amendment,None,Failed,207,32,0,1,6,184,0,3,0,0,0,0,213,216,0,4
62,R,112,H R 1,16-Feb-2011,7:06 PM,On Agreeing to the Amendment,None,Failed,16,220,2,2,57,132,0,4,0,0,0,0,73,352,2,6
63,R,112,H R 1,16-Feb-2011,7:11 PM,On Agreeing to the Amendment,None,Failed,190,48,0,2,9,182,0,2,0,0,0,0,199,230,0,4
64,R,112,H R 1,16-Feb-2011,7:14 PM,On Agreeing to the Amendment,None,Agreed to,228,9,0,3,11,176,0,6,0,0,0,0,239,185,0,9
65,R,112,H R 1,16-Feb-2011,7:19 PM,On Agreeing to the Amendment,None,Agreed to,219,21,0,0,9,182,0,2,0,0,0,0,228,203,0,2
66,R,112,H R 514,17-Feb-2011,10:10 AM,On Motion to Concur in the Senate Amendment,"To extend expiring provisions of the USA PATRIOT Improvement and Reauthorization Act of 2005 and Intelligence Reform and Terrorism Prevention Act of 2004 relating to access to business records, individual terrorists as agents of foreign powers, and roving wiretaps until December 8, 2011",Passed,211,26,0,3,68,117,0,8,0,0,0,0,279,143,0,11
67,R,112,H R 1,17-Feb-2011,10:30 AM,On Agreeing to the Amendment,None,Failed,168,70,0,2,3,186,0,4,0,0,0,0,171,256,0,6
68,R,112,H R 1,17-Feb-2011,10:37 AM,On Agreeing to the Amendment,None,Agreed to,214,22,0,4,3,187,0,3,0,0,0,0,217,209,0,7
69,R,112,H R 1,17-Feb-2011,10:41 AM,On Agreeing to the Amendment,None,Agreed to,223,13,0,4,25,164,0,4,0,0,0,0,248,177,0,8
70,R,112,H R 1,17-Feb-2011,10:44 AM,On Agreeing to the Amendment,None,Agreed to,224,10,0,6,15,176,0,2,0,0,0,0,239,186,0,8
71,R,112,H R 1,17-Feb-2011,10:47 AM,On Agreeing to the Amendment,None,Failed,86,150,1,3,18,172,1,2,0,0,0,0,104,322,2,5
72,R,112,H R 1,17-Feb-2011,10:50 AM,On Agreeing to the Amendment,None,Failed,115,124,0,1,0,192,0,1,0,0,0,0,115,316,0,2
73,R,112,H R 1,17-Feb-2011,10:54 AM,On Agreeing to the Amendment,None,Agreed to,232,5,0,3,17,174,0,2,0,0,0,0,249,179,0,5
74,R,112,H R 1,17-Feb-2011,10:57 AM,On Agreeing to the Amendment,None,Agreed to,141,97,0,2,172,20,0,1,0,0,0,0,313,117,0,3
75,R,112,H R 1,17-Feb-2011,11:00 AM,On Agreeing to the Amendment,None,Failed,176,60,0,4,0,190,0,3,0,0,0,0,176,250,0,7
76,R,112,H R 1,17-Feb-2011,11:04 AM,On Agreeing to the Amendment,None,Agreed to,226,13,0,1,42,150,0,1,0,0,0,0,268,163,0,2
77,R,112,H R 1,17-Feb-2011,11:07 AM,On Agreeing to the Amendment,None,Agreed to,230,7,0,3,44,148,0,1,0,0,0,0,274,155,0,4
78,R,112,H R 1,17-Feb-2011,11:11 AM,On Agreeing to the Amendment,None,Failed,180,59,0,1,10,182,0,1,0,0,0,0,190,241,0,2
79,R,112,H R 1,17-Feb-2011,11:14 AM,On Agreeing to the Amendment,None,Failed,176,60,0,4,0,190,0,3,0,0,0,0,176,250,0,7
80,R,112,H R 1,17-Feb-2011,6:35 PM,On Agreeing to the Amendment,None,Failed,6,234,0,0,85,105,0,3,0,0,0,0,91,339,0,3
81,R,112,H R 1,17-Feb-2011,6:38 PM,On Agreeing to the Amendment,None,Agreed to,234,1,0,5,13,174,0,6,0,0,0,0,247,175,0,11
82,R,112,H R 1,17-Feb-2011,6:42 PM,On Agreeing to the Amendment,None,Agreed to,79,156,1,4,188,3,0,2,0,0,0,0,267,159,1,6
83,R,112,H R 1,17-Feb-2011,6:45 PM,On Agreeing to the Amendment,None,Agreed to,234,4,0,2,10,177,0,6,0,0,0,0,244,181,0,8
84,R,112,H R 1,17-Feb-2011,6:51 PM,On Agreeing to the Amendment,None,Failed,89,149,1,1,48,143,0,2,0,0,0,0,137,292,1,3
85,R,112,H R 1,17-Feb-2011,6:54 PM,On Agreeing to the Amendment,None,Agreed to,227,12,0,1,5,185,0,3,0,0,0,0,232,197,0,4
86,R,112,H R 1,17-Feb-2011,6:57 PM,On Agreeing to the Amendment,None,Agreed to,231,7,0,2,19,170,0,4,0,0,0,0,250,177,0,6
87,R,112,H R 1,17-Feb-2011,7:01 PM,On Agreeing to the Amendment,None,Agreed to,236,1,1,2,13,178,0,2,0,0,0,0,249,179,1,4
88,R,112,H R 1,17-Feb-2011,7:04 PM,On Agreeing to the Amendment,None,Failed,6,233,0,1,154,37,0,2,0,0,0,0,160,270,0,3
89,R,112,H R 1,17-Feb-2011,7:07 PM,On Agreeing to the Amendment,None,Failed,2,235,0,3,161,30,0,2,0,0,0,0,163,265,0,5
90,R,112,H R 1,18-Feb-2011,1:58 PM,On Agreeing to the Amendment,None,Failed,30,209,0,1,118,72,0,3,0,0,0,0,148,281,0,4
91,R,112,H R 1,18-Feb-2011,2:07 PM,On Agreeing to the Amendment,None,Failed,7,232,0,1,91,99,0,3,0,0,0,0,98,331,0,4
92,R,112,H R 1,18-Feb-2011,2:10 PM,On Agreeing to the Amendment,None,Agreed to,231,4,0,5,58,132,1,2,0,0,0,0,289,136,1,7
93,R,112,H R 1,18-Feb-2011,2:13 PM,On Agreeing to the Amendment,None,Agreed to,230,7,1,2,10,178,0,5,0,0,0,0,240,185,1,7
94,R,112,H R 1,18-Feb-2011,2:17 PM,On Agreeing to the Amendment,None,Agreed to,230,9,0,1,13,176,0,4,0,0,0,0,243,185,0,5
95,R,112,H R 1,18-Feb-2011,2:20 PM,On Agreeing to the Amendment,None,Failed,32,206,0,2,164,25,0,4,0,0,0,0,196,231,0,6
96,R,112,H R 1,18-Feb-2011,2:23 PM,On Agreeing to the Amendment,None,Agreed to,236,2,0,2,13,175,0,5,0,0,0,0,249,177,0,7
97,R,112,H R 1,18-Feb-2011,2:26 PM,On Agreeing to the Amendment,None,Agreed to,236,2,0,2,3,185,0,5,0,0,0,0,239,187,0,7
98,R,112,H R 1,18-Feb-2011,2:29 PM,On Agreeing to the Amendment,None,Agreed to,238,0,0,2,3,187,0,3,0,0,0,0,241,187,0,5
99,R,112,H R 1,18-Feb-2011,2:32 PM,On Agreeing to the Amendment,None,Agreed to,234,4,0,2,3,187,0,3,0,0,0,0,237,191,0,5
100,R,112,H R 1,18-Feb-2011,2:35 PM,On Agreeing to the Amendment,None,Agreed to,238,0,0,2,8,182,0,3,0,0,0,0,246,182,0,5
101,R,112,H R 1,18-Feb-2011,2:40 PM,On Agreeing to the Amendment,None,Failed,75,164,0,1,108,82,0,3,0,0,0,0,183,246,0,4
102,R,112,H R 1,18-Feb-2011,2:43 PM,On Agreeing to the Amendment,None,Failed,12,227,0,1,111,79,0,3,0,0,0,0,123,306,0,4
103,R,112,H R 1,18-Feb-2011,2:46 PM,On Agreeing to the Amendment,None,Failed,147,92,0,1,0,189,0,4,0,0,0,0,147,281,0,5
104,R,112,H R 1,18-Feb-2011,8:56 PM,On Agreeing to the Amendment,None,Failed,13,224,0,3,143,45,0,5,0,0,0,0,156,269,0,8
105,R,112,H R 1,18-Feb-2011,9:00 PM,On Agreeing to the Amendment,None,Failed,22,215,0,3,46,142,0,5,0,0,0,0,68,357,0,8
106,R,112,H R 1,18-Feb-2011,9:03 PM,On Agreeing to the Amendment,None,Failed,60,175,0,5,14,173,0,6,0,0,0,0,74,348,0,11
107,R,112,H R 1,18-Feb-2011,9:06 PM,On Agreeing to the Amendment,None,Failed,171,63,0,6,6,180,0,7,0,0,0,0,177,243,0,13
108,R,112,H R 1,18-Feb-2011,9:09 PM,On Agreeing to the Amendment,None,Failed,3,234,0,3,84,104,0,5,0,0,0,0,87,338,0,8
109,R,112,H R 1,18-Feb-2011,9:13 PM,On Agreeing to the Amendment,None,Failed,11,226,0,3,163,25,0,5,0,0,0,0,174,251,0,8
110,R,112,H R 1,18-Feb-2011,9:16 PM,On Agreeing to the Amendment,None,Agreed to,238,0,0,2,3,185,0,5,0,0,0,0,241,185,0,7
111,R,112,H R 1,18-Feb-2011,9:19 PM,On Agreeing to the Amendment,None,Agreed to,210,28,0,2,5,182,0,6,0,0,0,0,215,210,0,8
112,R,112,H R 1,18-Feb-2011,9:22 PM,On Agreeing to the Amendment,None,Failed,25,213,0,2,66,120,0,7,0,0,0,0,91,333,0,9
113,R,112,H R 1,18-Feb-2011,9:26 PM,On Agreeing to the Amendment,None,Agreed to,219,18,0,3,8,179,0,6,0,0,0,0,227,197,0,9
114,R,112,H R 1,18-Feb-2011,9:29 PM,On Agreeing to the Amendment,None,Failed,51,187,0,2,134,54,0,5,0,0,0,0,185,241,0,7
115,R,112,H R 1,18-Feb-2011,9:32 PM,On Agreeing to the Amendment,None,Agreed to,236,2,0,2,41,147,0,5,0,0,0,0,277,149,0,7
116,R,112,H R 1,18-Feb-2011,9:35 PM,On Agreeing to the Amendment,None,Agreed to,198,39,0,3,43,145,0,5,0,0,0,0,241,184,0,8
117,R,112,H R 1,18-Feb-2011,9:38 PM,On Agreeing to the Amendment,None,Failed,6,232,0,2,26,162,0,5,0,0,0,0,32,394,0,7
118,R,112,H R 1,18-Feb-2011,9:41 PM,On Agreeing to the Amendment,None,Failed,5,232,0,3,69,119,0,5,0,0,0,0,74,351,0,8
119,R,112,H R 1,18-Feb-2011,9:44 PM,On Agreeing to the Amendment,None,Agreed to,228,9,0,3,11,177,0,5,0,0,0,0,239,186,0,8
120,R,112,H R 1,18-Feb-2011,9:47 PM,On Agreeing to the Amendment,None,Agreed to,222,15,0,3,8,180,0,5,0,0,0,0,230,195,0,8
121,R,112,H R 1,18-Feb-2011,9:50 PM,On Agreeing to the Amendment,None,Agreed to,236,1,0,3,5,183,0,5,0,0,0,0,241,184,0,8
122,R,112,H R 1,18-Feb-2011,9:53 PM,On Agreeing to the Amendment,None,Failed,63,174,0,3,0,188,0,5,0,0,0,0,63,362,0,8
123,R,112,H R 1,18-Feb-2011,9:56 PM,On Agreeing to the Amendment,None,Agreed to,221,17,0,2,16,172,0,5,0,0,0,0,237,189,0,7
124,R,112,H R 1,18-Feb-2011,9:59 PM,On Agreeing to the Amendment,None,Agreed to,215,21,0,4,16,170,0,7,0,0,0,0,231,191,0,11
125,R,112,H R 1,19-Feb-2011,1:27 AM,On Agreeing to the Amendment,None,Agreed to,183,53,0,4,78,105,0,10,0,0,0,0,261,158,0,14
126,R,112,H R 1,19-Feb-2011,1:31 AM,On Agreeing to the Amendment,None,Failed,210,26,0,4,0,184,0,9,0,0,0,0,210,210,0,13
127,R,112,H R 1,19-Feb-2011,1:35 AM,On Agreeing to the Amendment,None,Agreed to,227,9,0,4,6,178,0,9,0,0,0,0,233,187,0,13
128,R,112,H R 1,19-Feb-2011,1:38 AM,On Agreeing to the Amendment,None,Failed,6,230,0,4,70,114,0,9,0,0,0,0,76,344,0,13
129,R,112,H R 1,19-Feb-2011,1:41 AM,On Agreeing to the Amendment,None,Agreed to,227,10,0,3,8,175,0,10,0,0,0,0,235,185,0,13
130,R,112,H R 1,19-Feb-2011,1:44 AM,On Agreeing to the Amendment,None,Agreed to,208,28,0,4,51,131,0,11,0,0,0,0,259,159,0,15
131,R,112,H R 1,19-Feb-2011,1:47 AM,On Agreeing to the Amendment,None,Agreed to,229,9,0,2,16,167,0,10,0,0,0,0,245,176,0,12
132,R,112,H R 1,19-Feb-2011,1:50 AM,On Agreeing to the Amendment,None,Agreed to,235,3,0,2,9,176,0,8,0,0,0,0,244,179,0,10
133,R,112,H R 1,19-Feb-2011,1:53 AM,On Agreeing to the Amendment,None,Failed,190,46,0,4,1,184,0,8,0,0,0,0,191,230,0,12
134,R,112,H R 1,19-Feb-2011,1:56 AM,On Agreeing to the Amendment,None,Agreed to,206,31,0,3,79,105,0,9,0,0,0,0,285,136,0,12
135,R,112,H R 1,19-Feb-2011,2:00 AM,On Agreeing to the Amendment,None,Agreed to,223,14,0,3,17,168,0,8,0,0,0,0,240,182,0,11
136,R,112,H R 1,19-Feb-2011,2:03 AM,On Agreeing to the Amendment,None,Agreed to,220,18,0,2,19,165,0,9,0,0,0,0,239,183,0,11
137,R,112,H R 1,19-Feb-2011,2:06 AM,On Agreeing to the Amendment,None,Agreed to,227,10,0,3,7,177,0,9,0,0,0,0,234,187,0,12
138,R,112,H R 1,19-Feb-2011,2:09 AM,On Agreeing to the Amendment,None,Agreed to,235,1,0,4,4,181,0,8,0,0,0,0,239,182,0,12
139,R,112,H R 1,19-Feb-2011,2:12 AM,On Agreeing to the Amendment,None,Failed,204,34,0,2,5,179,0,9,0,0,0,0,209,213,0,11
140,R,112,H R 1,19-Feb-2011,2:15 AM,On Agreeing to the Amendment,None,Agreed to,234,4,0,2,21,164,0,8,0,0,0,0,255,168,0,10
141,R,112,H R 1,19-Feb-2011,2:18 AM,On Agreeing to the Amendment,None,Agreed to,235,2,0,3,4,181,0,8,0,0,0,0,239,183,0,11
142,R,112,H R 1,19-Feb-2011,2:21 AM,On Agreeing to the Amendment,None,Failed,18,218,0,4,103,82,0,8,0,0,0,0,121,300,0,12
143,R,112,H R 1,19-Feb-2011,2:25 AM,On Agreeing to the Amendment,None,Failed,93,144,0,3,0,184,0,9,0,0,0,0,93,328,0,12
144,R,112,H R 1,19-Feb-2011,4:06 AM,On Agreeing to the Amendment,None,Failed,189,48,0,3,0,185,0,8,0,0,0,0,189,233,0,11
145,R,112,H R 1,19-Feb-2011,4:09 AM,On Agreeing to the Amendment,None,Agreed to,235,2,0,3,0,185,0,8,0,0,0,0,235,187,0,11
146,R,112,H R 1,19-Feb-2011,4:33 AM,On Motion to Recommit with Instructions,"Making appropriations for the Department of Defense and the other departments and agencies of the Government for the fisal year ending September 30, 2011, and for other purposes",Failed,0,238,0,2,186,0,0,7,0,0,0,0,186,238,0,9
147,R,112,H R 1,19-Feb-2011,4:40 AM,On Passage,"Making appropriations for the Department of Defense and the other departments and agencies of the Government for the fisal year ending September 30, 2011, and for other purposes",Passed,235,3,0,2,0,186,0,7,0,0,0,0,235,189,0,9
148,R,112,H R 394,28-Feb-2011,6:55 PM,"On Motion to Suspend the Rules and Pass, as Amended",Federal Courts Jurisdiction and Venue Clarification Act,Passed,226,0,0,14,176,0,0,16,0,0,0,0,402,0,0,30
149,R,112,H R 347,28-Feb-2011,7:03 PM,"On Motion to Suspend the Rules and Pass, as Amended",Federal Restricted Buildings and Grounds Improvement Act,Passed,223,3,0,14,176,0,0,16,0,0,0,0,399,3,0,30
150,R,112,H R 368,28-Feb-2011,7:09 PM,"On Motion to Suspend the Rules and Pass, as Amended",Removal Clarification Act,Passed,220,4,0,16,176,0,0,16,0,0,0,0,396,4,0,32
151,R,112,H RES 115,1-Mar-2011,1:59 PM,On Ordering the Previous Question,"Providing for consideration of the joint resolution (H.J.Res. 44) making further continuing appropriations for fiscal year 2011, and for other purposes",Passed,234,0,0,6,7,179,0,6,0,0,0,0,241,179,0,12
152,R,112,H RES 115,1-Mar-2011,2:05 PM,On Agreeing to the Resolution,"Providing for consideration of the joint resolution (H.J.Res. 44) making further continuing appropriations for fiscal year 2011, and for other purposes",Passed,236,0,0,4,15,170,0,7,0,0,0,0,251,170,0,11
153,R,112,H J RES 44,1-Mar-2011,4:05 PM,On Motion to Recommit with Instructions,Making further continuing appropriations for fiscal year 2011,Failed,0,236,0,4,176,13,0,3,0,0,0,0,176,249,0,7
154,R,112,H J RES 44,1-Mar-2011,4:14 PM,On Passage,Making further continuing appropriations for fiscal year 2011,Passed,231,6,0,3,104,85,0,3,0,0,0,0,335,91,0,6
155,R,112,H RES 128,2-Mar-2011,2:37 PM,On Agreeing to the Resolution,"Providing for consideration of the bill (H.R. 662) to provide an extension of Federal-aid highway, highway safety, motor carrier safety, transit, and other programs funded out of the Highway Trust Fund pending enactment of a multiyear law reauthorizing such programs",Passed,238,0,0,2,18,169,0,5,0,0,0,0,256,169,0,7
156,R,112,H RES 129,2-Mar-2011,2:45 PM,On Ordering the Previous Question,"Providing for consideration of the bill (H.R. 4) to repeal the expansion of information reporting requirements for payments of $600 or more to corporations, and for other purposes",Passed,239,0,0,1,4,185,0,3,0,0,0,0,243,185,0,4
157,R,112,H RES 129,2-Mar-2011,2:51 PM,On Agreeing to the Resolution,"Providing for consideration of the bill (H.R. 4) to repeal the expansion of information reporting requirements for payments of $600 or more to corporations, and for other purposes",Passed,238,0,0,2,14,175,0,3,0,0,0,0,252,175,0,5
158,R,112,H R 662,2-Mar-2011,4:09 PM,On Agreeing to the Amendment,None,Agreed to,236,0,0,4,186,0,0,6,0,0,0,0,422,0,0,10
159,R,112,H R 662,2-Mar-2011,4:37 PM,On Motion to Recommit with Instructions,Surface Transportation Extension Act of 2011,Failed,0,239,0,1,181,7,2,2,0,0,0,0,181,246,2,3
160,R,112,H R 662,2-Mar-2011,4:43 PM,On Passage,Surface Transportation Extension Act of 2011,Passed,232,3,0,5,189,1,0,2,0,0,0,0,421,4,0,7
161,R,112,H R 4,3-Mar-2011,1:43 PM,On Motion to Table the Appeal of the Ruling of the Chair,Small Business Paperwork Mandate Elimination Act of 2011,Passed,238,0,0,2,5,181,0,6,0,0,0,0,243,181,0,8
162,R,112,H R 4,3-Mar-2011,2:12 PM,On Passage,Small Business Paperwork Mandate Elimination Act of 2011,Passed,238,0,0,2,76,112,0,4,0,0,0,0,314,112,0,6
163,R,112,H R 570,8-Mar-2011,6:53 PM,On Motion to Suspend the Rules and Pass,Dental Emergency Responder Act of 2011,Passed,221,12,0,7,180,0,0,12,0,0,0,0,401,12,0,19
164,R,112,H R 525,8-Mar-2011,7:01 PM,On Motion to Suspend the Rules and Pass,Veterinary Public Health Amendments Act of 2011,Passed,95,138,0,7,185,0,0,7,0,0,0,0,280,138,0,14
165,R,112,H RES 150,9-Mar-2011,2:19 PM,On Ordering the Previous Question,Providing for consideration of the bill (H.R. 830) to rescind the unobligated funding for the FHA Refinance Program and to terminate the program,Passed,234,0,0,6,1,186,0,5,0,0,0,0,235,186,0,11
166,R,112,H RES 150,9-Mar-2011,2:26 PM,On Agreeing to the Resolution,Providing for consideration of the bill (H.R. 830) to rescind the unobligated funding for the FHA Refinance Program and to terminate the program,Passed,231,0,0,9,9,180,0,3,0,0,0,0,240,180,0,12
167,R,112,JOURNAL,9-Mar-2011,2:35 PM,On Approving the Journal,None,Passed,208,20,1,11,118,71,0,3,0,0,0,0,326,91,1,14
168,R,112,H R 830,10-Mar-2011,3:53 PM,On Agreeing to the Amendment,None,Failed,1,237,0,2,183,6,0,3,0,0,0,0,184,243,0,5
169,R,112,H R 830,10-Mar-2011,3:59 PM,On Agreeing to the Amendment,None,Agreed to,98,138,0,4,180,9,0,3,0,0,0,0,278,147,0,7
170,R,112,H R 830,10-Mar-2011,4:30 PM,On Motion to Recommit with Instructions,FHA Refinance Program Termination Act,Failed,0,239,0,1,185,4,0,3,0,0,0,0,185,243,0,4
171,R,112,H R 830,10-Mar-2011,4:37 PM,On Passage,FHA Refinance Program Termination Act,Passed,238,1,0,1,18,170,0,4,0,0,0,0,256,171,0,5
172,R,112,H R 836,11-Mar-2011,11:55 AM,On Agreeing to the Amendment,None,Failed,9,228,0,3,176,9,0,7,0,0,0,0,185,237,0,10
173,R,112,H R 836,11-Mar-2011,12:27 PM,On Motion to Recommit with Instructions,To rescind the unobligated funding for the Emergency Mortgage Relief Program and to terminate the program,Failed,1,238,0,1,181,0,0,11,0,0,0,0,182,238,0,12
174,R,112,H R 836,11-Mar-2011,12:33 PM,On Passage,To rescind the unobligated funding for the Emergency Mortgage Relief Program and to terminate the program,Passed,234,2,0,4,8,175,0,9,0,0,0,0,242,177,0,13
175,R,112,H R 793,14-Mar-2011,6:53 PM,On Motion to Suspend the Rules and Pass,"To designate the facility of the United States Postal Service located at 12781 Sir Francis Drake Boulevard in Inverness, California, as the “Specialist Jake Robert Velloza Post Office”",Passed,228,0,1,11,166,0,0,26,0,0,0,0,394,0,1,37
176,R,112,H CON RES 27,14-Mar-2011,7:02 PM,On Motion to Suspend the Rules and Agree,Providing for the acceptance of a statue of Gerald R. Ford from the people of Michigan for placement in the United States Capitol,Passed,228,0,0,12,168,0,0,24,0,0,0,0,396,0,0,36
177,R,112,H RES 167,15-Mar-2011,1:25 PM,On Agreeing to the Resolution,"Providing for consideration of the joint resolution (H.J.Res. 48) making further continuing appropriations for fiscal year 2011, and for other purposes",Passed,236,0,0,4,5,181,0,6,0,0,0,0,241,181,0,10
178,R,112,H J RES 48,15-Mar-2011,3:23 PM,On Motion to Recommit with Instructions,"Making further continuing appropriations for fiscal year 2011, and for other purposes",Failed,1,239,0,0,189,0,0,3,0,0,0,0,190,239,0,3
179,R,112,H J RES 48,15-Mar-2011,3:32 PM,On Passage,"Making further continuing appropriations for fiscal year 2011, and for other purposes",Passed,186,54,0,0,85,104,0,3,0,0,0,0,271,158,0,3
180,R,112,H CON RES 30,15-Mar-2011,3:42 PM,On Agreeing to the Resolution,Providing for an adjournment or recess of the two Houses,Passed,226,13,0,1,6,184,0,2,0,0,0,0,232,197,0,3
181,R,112,H RES 170,16-Mar-2011,1:59 PM,On Agreeing to the Resolution,"Rule providing for consideration of H.R. 839, the HAMP Termination Act; H.R. 861, the NSP Termination Act",Passed,238,0,0,2,3,180,0,9,0,0,0,0,241,180,0,11
182,R,112,H R 861,16-Mar-2011,3:49 PM,On Motion to Rise and Recommend that the Enacting Clause Be Stricken,NSP Termination Act,Failed,0,236,0,4,183,4,0,5,0,0,0,0,183,240,0,9
183,R,112,H R 861,16-Mar-2011,5:49 PM,On Agreeing to the Amendment,None,Failed,0,239,0,1,183,5,0,4,0,0,0,0,183,244,0,5
184,R,112,H R 861,16-Mar-2011,5:57 PM,On Agreeing to the Amendment,None,Failed,2,235,0,3,172,13,0,7,0,0,0,0,174,248,0,10
185,R,112,H R 861,16-Mar-2011,6:03 PM,On Agreeing to the Amendment,None,Failed,1,238,0,1,177,11,0,4,0,0,0,0,178,249,0,5
186,R,112,H R 861,16-Mar-2011,6:09 PM,On Agreeing to the Amendment,None,Failed,0,237,0,3,179,9,0,4,0,0,0,0,179,246,0,7
187,R,112,H R 861,16-Mar-2011,6:38 PM,On Motion to Recommit with Instructions,NSP Termination Act,Failed,0,238,0,2,153,34,0,5,0,0,0,0,153,272,0,7
188,R,112,H R 861,16-Mar-2011,6:45 PM,On Passage,NSP Termination Act,Passed,237,2,0,1,5,180,0,7,0,0,0,0,242,182,0,8
189,R,112,H RES 174,17-Mar-2011,10:46 AM,On Ordering the Previous Question,Providing for consideration of the bill (H.R. 1076) to prohibit Federal funding of National Public Radio and the use of Federal funds to acquire radio content,Passed,232,0,0,8,1,179,0,12,0,0,0,0,233,179,0,20
190,R,112,H RES 174,17-Mar-2011,10:57 AM,On Agreeing to the Resolution,Providing for consideration of the bill (H.R. 1076) to prohibit Federal funding of National Public Radio and the use of Federal funds to acquire radio content,Passed,235,0,0,5,1,181,0,10,0,0,0,0,236,181,0,15
191,R,112,H R 1076,17-Mar-2011,3:15 PM,On Motion to Recommit with Instructions,To prohibit Federal funding of National Public Radio and the use of Federal funds to acquire radio content,Failed,0,235,0,5,184,0,0,8,0,0,0,0,184,235,0,13
192,R,112,H R 1076,17-Mar-2011,3:24 PM,On Passage,To prohibit Federal funding of National Public Radio and the use of Federal funds to acquire radio content,Passed,228,7,1,4,0,185,0,7,0,0,0,0,228,192,1,11
193,R,112,H CON RES 28,17-Mar-2011,3:30 PM,On Agreeing to the Resolution,"Directing the President, pursuant to section 5(c) of the War Powers Resolution, to remove the United States Armed Forces from Afghanistan",Failed,8,222,1,9,85,99,0,8,0,0,0,0,93,321,1,17
194,R,112,H R 839,29-Mar-2011,6:58 PM,On Agreeing to the Amendment,None,Agreed to,235,2,0,3,12,168,0,12,0,0,0,0,247,170,0,15
195,R,112,H R 839,29-Mar-2011,7:03 PM,On Agreeing to the Amendment,None,Failed,4,233,0,3,178,6,0,8,0,0,0,0,182,239,0,11
196,R,112,H R 839,29-Mar-2011,7:09 PM,On Agreeing to the Amendment,None,Failed,1,234,0,5,172,15,0,5,0,0,0,0,173,249,0,10
197,R,112,H R 839,29-Mar-2011,7:38 PM,On Motion to Recommit with Instructions,The HAMP Termination Act of 2011,Failed,1,235,0,4,184,3,1,4,0,0,0,0,185,238,1,8
198,R,112,H R 839,29-Mar-2011,7:45 PM,On Passage,The HAMP Termination Act of 2011,Passed,234,2,0,4,18,168,1,5,0,0,0,0,252,170,1,9
199,R,112,H RES 186,30-Mar-2011,1:53 PM,On Ordering the Previous Question,"Providing for consideration of the bill (H.R. 471) to reauthorize the DC opportunity scholarship program, and for other purposes",Passed,236,0,0,4,1,182,0,9,0,0,0,0,237,182,0,13
200,R,112,H RES 186,30-Mar-2011,2:00 PM,On Agreeing to the Resolution,"Providing for consideration of the bill (H.R. 471) to reauthorize the DC opportunity scholarship program, and for other purposes",Passed,233,0,0,7,2,178,0,12,0,0,0,0,235,178,0,19
201,R,112,JOURNAL,30-Mar-2011,2:08 PM,On Approving the Journal,None,Passed,204,29,1,6,105,78,0,9,0,0,0,0,309,107,1,15
202,R,112,H R 471,30-Mar-2011,4:29 PM,On Agreeing to the Amendment,None,Failed,4,230,0,6,181,7,0,4,0,0,0,0,185,237,0,10
203,R,112,H R 471,30-Mar-2011,5:01 PM,On Motion to Recommit with Instructions,Scholarships for Opportunity and Results Act,Failed,0,235,0,5,185,3,0,4,0,0,0,0,185,238,0,9
204,R,112,H R 471,30-Mar-2011,5:08 PM,On Passage,Scholarships for Opportunity and Results Act,Passed,224,9,0,7,1,186,0,5,0,0,0,0,225,195,0,12
205,R,112,H RES 189,31-Mar-2011,2:45 PM,On Agreeing to the Resolution,"Providing for consideration of the bill (H.R. 658) to amend title 49, United States Code, to authorize appropriations for the Federal Aviation Administration for fiscal years 2011 through 2014",Passed,235,0,0,5,14,171,0,7,0,0,0,0,249,171,0,12
206,R,112,H R 872,31-Mar-2011,2:55 PM,"On Motion to Suspend the Rules and Pass, as Amended","To amend the Federal Insecticide, Fungicide, and Rodenticide Act and the Federal Water Pollution Control Act to clarify Congressional intent regarding the regulation of the use of pesticides in or near navigable waters, and for other purposes",Passed,235,0,0,5,57,130,0,5,0,0,0,0,292,130,0,10
207,R,112,H R 658,31-Mar-2011,6:48 PM,On Agreeing to the Amendment,None,Agreed to,235,0,0,5,16,168,0,8,0,0,0,0,251,168,0,13
208,R,112,H R 658,31-Mar-2011,6:56 PM,On Agreeing to the Amendment,None,Failed,22,213,0,5,98,90,0,4,0,0,0,0,120,303,0,9
209,R,112,H R 658,31-Mar-2011,7:00 PM,On Agreeing to the Amendment,None,Failed,6,229,0,5,155,34,0,3,0,0,0,0,161,263,0,8
210,R,112,H R 658,31-Mar-2011,7:03 PM,On Agreeing to the Amendment,None,Failed,2,228,0,10,172,13,0,7,0,0,0,0,174,241,0,17
211,R,112,H R 658,31-Mar-2011,7:07 PM,On Agreeing to the Amendment,None,Failed,12,221,0,7,175,14,0,3,0,0,0,0,187,235,0,10
212,R,112,H R 658,31-Mar-2011,7:11 PM,On Agreeing to the Amendment,None,Failed,192,41,0,7,3,186,0,3,0,0,0,0,195,227,0,10
213,R,112,H RES 194,1-Apr-2011,10:03 AM,On Consideration of the Resolution,"Providing for consideration of the bill (H.R. 1255) to prevent a shutdown of the government of the United States, and for other purposes",Passed,219,0,0,21,0,172,0,20,0,0,0,0,219,172,0,41
214,R,112,H R 658,1-Apr-2011,11:40 AM,On Agreeing to the Amendment,None,Failed,196,38,0,6,11,177,0,4,0,0,0,0,207,215,0,10
215,R,112,H R 658,1-Apr-2011,11:46 AM,On Agreeing to the Amendment,None,Failed,8,225,0,7,170,18,0,4,0,0,0,0,178,243,0,11
216,R,112,H R 658,1-Apr-2011,11:54 AM,On Agreeing to the Amendment,None,Failed,183,51,0,6,0,187,0,5,0,0,0,0,183,238,0,11
217,R,112,H R 658,1-Apr-2011,12:00 PM,On Agreeing to the Amendment,None,Failed,16,220,0,4,190,0,0,2,0,0,0,0,206,220,0,6
218,R,112,H R 658,1-Apr-2011,12:07 PM,On Agreeing to the Amendment,None,Agreed to,209,25,0,6,6,184,0,2,0,0,0,0,215,209,0,8
219,R,112,H R 658,1-Apr-2011,12:34 PM,On Motion to Recommit with Instructions,FAA Reauthorization and Reform Act of 2011,Failed,0,234,0,6,184,1,0,7,0,0,0,0,184,235,0,13
220,R,112,H R 658,1-Apr-2011,12:40 PM,On Passage,FAA Reauthorization and Reform Act of 2011,Passed,221,11,0,8,2,185,0,5,0,0,0,0,223,196,0,13
221,R,112,H RES 194,1-Apr-2011,12:46 PM,On Ordering the Previous Question,"Providing for consideration of the bill (H.R. 1255) to prevent a shutdown of the government of the United States, and for other purposes",Passed,230,0,0,10,0,187,0,5,0,0,0,0,230,187,0,15
222,R,112,H RES 194,1-Apr-2011,12:52 PM,On Agreeing to the Resolution,"Providing for consideration of the bill (H.R. 1255) to prevent a shutdown of the government of the United States, and for other purposes",Passed,229,1,0,10,0,186,0,6,0,0,0,0,229,187,0,16
223,R,112,H R 1255,1-Apr-2011,2:48 PM,On Motion to Recommit with Instructions,Government Shutdown Prevention Act,Failed,1,236,0,3,187,1,0,4,0,0,0,0,188,237,0,7
224,R,112,H R 1255,1-Apr-2011,2:55 PM,On Passage,Government Shutdown Prevention Act,Passed,221,15,1,3,0,187,0,5,0,0,0,0,221,202,1,8
225,R,112,H R 1246,4-Apr-2011,6:52 PM,On Motion to Suspend the Rules and Pass,To reduce the amounts otherwise authorized to be appropriated to the Department of Defense for printing and reproduction,Passed,226,0,0,14,167,0,0,25,0,0,0,0,393,0,0,39
226,R,112,H RES 200,5-Apr-2011,1:55 PM,On Ordering the Previous Question,"Providing for consideration of H.J.Res. 37, disapproving the rule submitted by the Federal Communications Commission with respect to regulating the Internet and broadband industry practices.",Passed,238,0,0,2,3,175,0,14,0,0,0,0,241,175,0,16
227,R,112,H RES 200,5-Apr-2011,2:03 PM,On Agreeing to the Resolution,"Providing for consideration of H.J.Res. 37, disapproving the rule submitted by the Federal Communications Commission with respect to regulating the Internet and broadband industry practices.",Passed,236,0,0,4,5,178,0,9,0,0,0,0,241,178,0,13
228,R,112,JOURNAL,5-Apr-2011,2:11 PM,On Approving the Journal,None,Passed,200,33,1,6,110,71,0,11,0,0,0,0,310,104,1,17
229,R,112,ADJOURN,6-Apr-2011,12:54 PM,On Motion to Adjourn,None,Failed,0,226,0,14,36,141,0,15,0,0,0,0,36,367,0,29
230,R,112,H RES 203,6-Apr-2011,2:23 PM,On Ordering the Previous Question,"Providing for consideration of (H.R. 910) to amend the Clean Air Act to prohibit the Administrator of the Environmental Protection Agency from promulgating any regulation concerning, taking action relating to, or taking into consideration the emission of a greenhouse gas to address climate change, for other purposes",Passed,238,0,0,2,28,158,0,6,0,0,0,0,266,158,0,8
231,R,112,H RES 203,6-Apr-2011,2:31 PM,On Agreeing to the Resolution,"Providing for consideration of (H.R. 910) to amend the Clean Air Act to prohibit the Administrator of the Environmental Protection Agency from promulgating any regulation concerning, taking action relating to, or taking into consideration the emission of a greenhouse gas to address climate change, for other purposes",Passed,238,0,0,2,12,172,0,8,0,0,0,0,250,172,0,10
232,R,112,JOURNAL,6-Apr-2011,2:39 PM,On Approving the Journal,None,Passed,205,29,1,5,116,69,0,7,0,0,0,0,321,98,1,12
233,R,112,H R 910,6-Apr-2011,6:43 PM,On Agreeing to the Amendment,None,Failed,0,238,0,2,161,21,0,10,0,0,0,0,161,259,0,12
234,R,112,H R 910,6-Apr-2011,6:47 PM,On Agreeing to the Amendment,None,Failed,0,239,0,1,157,27,0,8,0,0,0,0,157,266,0,9
235,R,112,H R 910,6-Apr-2011,6:50 PM,On Agreeing to the Amendment,None,Failed,5,233,0,2,177,7,0,8,0,0,0,0,182,240,0,10
236,R,112,H R 910,6-Apr-2011,6:57 PM,On Agreeing to the Amendment,None,Failed,1,237,0,2,183,3,0,6,0,0,0,0,184,240,0,8
237,R,112,H R 910,6-Apr-2011,7:02 PM,On Agreeing to the Amendment,None,Failed,1,238,0,1,167,19,0,6,0,0,0,0,168,257,0,7
238,R,112,H R 910,6-Apr-2011,7:05 PM,On Agreeing to the Amendment,None,Failed,0,238,0,2,156,28,0,8,0,0,0,0,156,266,0,10
239,R,112,H R 910,6-Apr-2011,7:09 PM,On Agreeing to the Amendment,None,Failed,0,239,0,1,165,21,0,6,0,0,0,0,165,260,0,7
240,R,112,H R 910,6-Apr-2011,7:12 PM,On Agreeing to the Amendment,None,Failed,1,236,0,3,172,14,0,6,0,0,0,0,173,250,0,9
241,R,112,H R 910,6-Apr-2011,7:17 PM,On Agreeing to the Amendment,None,Failed,1,238,0,1,159,26,0,7,0,0,0,0,160,264,0,8
242,R,112,H RES 206,7-Apr-2011,11:45 AM,On Ordering the Previous Question,"Providing for consideration of H.R. 1363, making appropriations for the Department of Defense for the fiscal year ending September 30, 2011, and for other purposes; and waiving a requirement of clause 6(a) of rule XIII with respect to consideration of certain resolutions reported from the Committee on Rules",Passed,236,0,0,4,2,185,0,5,0,0,0,0,238,185,0,9
243,R,112,H RES 206,7-Apr-2011,11:52 AM,On Agreeing to the Resolution,"Providing for consideration of H.R. 1363, making appropriations for the Department of Defense for the fiscal year ending September 30, 2011, and for other purposes; and waiving a requirement of clause 6(a) of rule XIII with respect to consideration of certain resolutions reported from the Committee on Rules",Passed,228,0,0,12,0,189,0,3,0,0,0,0,228,189,0,15
244,R,112,JOURNAL,7-Apr-2011,12:09 PM,On Approving the Journal,None,Passed,204,28,2,6,103,85,0,4,0,0,0,0,307,113,2,10
245,R,112,H R 1363,7-Apr-2011,2:03 PM,Table Appeal of the Ruling of the Chair,"Making appropriations for the Department of Defense for the fiscal year ending September 30, 2011, and for other purposes",Passed,236,0,0,4,0,187,0,5,0,0,0,0,236,187,0,9
246,R,112,H R 1363,7-Apr-2011,2:26 PM,On Motion to Recommit with Instructions,"Making appropriations for the Department of Defense for the fiscal year ending September 30, 2011, and for other purposes",Failed,1,236,0,3,190,0,0,2,0,0,0,0,191,236,0,5
247,R,112,H R 1363,7-Apr-2011,2:34 PM,On Passage,"Making appropriations for the Department of Defense for the fiscal year ending September 30, 2011, and for other purposes",Passed,232,6,0,2,15,175,0,2,0,0,0,0,247,181,0,4
248,R,112,H R 910,7-Apr-2011,3:01 PM,On Motion to Recommit with Instructions,Energy Tax Prevention Act of 2011,Failed,0,237,0,3,175,14,0,3,0,0,0,0,175,251,0,6
249,R,112,H R 910,7-Apr-2011,3:08 PM,On Passage,Energy Tax Prevention Act of 2011,Passed,236,0,0,4,19,172,0,1,0,0,0,0,255,172,0,5
250,R,112,H J RES 37,8-Apr-2011,1:39 PM,On Consideration of the Joint Resolution,Disapproving the rule submitted by the Federal Communications Commission with respect to regulating the Internet and broadband industry practices,Passed,234,0,0,6,4,174,0,14,0,0,0,0,238,174,0,20
251,R,112,H J RES 37,8-Apr-2011,3:33 PM,Table Appeal of the Ruling of the Chair,Disapproving the rule submitted by the Federal Communications Commission with respect to regulating the Internet and broadband industry practices,Passed,235,0,0,5,0,181,0,11,0,0,0,0,235,181,0,16
252,R,112,H J RES 37,8-Apr-2011,3:41 PM,On Passage,Disapproving the rule submitted by the Federal Communications Commission with respect to regulating the Internet and broadband industry practices,Passed,234,2,0,4,6,177,0,9,0,0,0,0,240,179,0,13
253,R,112,H R 1363,9-Apr-2011,12:40 AM,On Motion to Concur in the Senate Amendment,"Making appropriations for the Department of Defense for the fiscal year ending September 30, 2011, and for other purposes",Passed,208,28,0,4,140,42,0,10,0,0,0,0,348,70,0,14
254,R,112,H R 1308,12-Apr-2011,6:56 PM,On Motion to Suspend the Rules and Pass,"To amend the Ronald Reagan Centennial Commission Act to extend the termination date for the Commission, and for other purposes",Passed,229,2,0,9,165,16,0,11,0,0,0,0,394,18,0,20
255,R,112,S 307,12-Apr-2011,7:04 PM,On Motion to Suspend the Rules and Pass,"To designate the Federal building and United States courthouse located at 217 West King Street, Martinsburg, West Virginia, as the “W. Craig Broadwater Federal Building and United States Courthouse”",Passed,227,2,1,10,181,1,0,10,0,0,0,0,408,3,1,20
256,R,112,JOURNAL,12-Apr-2011,7:10 PM,On Approving the Journal,None,Passed,191,34,2,13,134,45,0,13,0,0,0,0,325,79,2,26
257,R,112,H RES 219,13-Apr-2011,2:59 PM,On Ordering the Previous Question,Providing for consideration of the bill (H.R. 1217) to repeal the Prevention and Public Health Fund,Passed,236,0,0,4,2,182,0,8,0,0,0,0,238,182,0,12
258,R,112,H RES 219,13-Apr-2011,3:05 PM,On Agreeing to the Resolution,Providing for consideration of the bill (H.R. 1217) to repeal the Prevention and Public Health Fund,Passed,233,0,0,7,4,180,0,8,0,0,0,0,237,180,0,15
259,R,112,H RES 218,13-Apr-2011,3:12 PM,On Ordering the Previous Question,"Providing for consideration of the bill (H.R. 1473) making appropriations for the Department of Defense and the other departments and agencies of the Government for the fiscal year ending September 30, 2011, and for other purposes",Passed,237,0,0,3,5,183,0,4,0,0,0,0,242,183,0,7
260,R,112,H RES 218,13-Apr-2011,3:19 PM,On Agreeing to the Resolution,"Providing for consideration of the bill (H.R. 1473) making appropriations for the Department of Defense and the other departments and agencies of the Government for the fiscal year ending September 30, 2011, and for other purposes",Passed,236,0,0,4,5,179,0,8,0,0,0,0,241,179,0,12
261,R,112,H R 1217,13-Apr-2011,5:01 PM,On Agreeing to the Amendment,None,Failed,1,236,0,3,186,1,0,5,0,0,0,0,187,237,0,8
262,R,112,H R 1217,13-Apr-2011,5:09 PM,On Agreeing to the Amendment,None,Failed,1,235,0,4,187,3,0,2,0,0,0,0,188,238,0,6
263,R,112,H R 1217,13-Apr-2011,5:36 PM,On Motion to Recommit with Instructions,To repeal the Prevention and Public Health Fund,Failed,0,234,0,6,189,0,0,3,0,0,0,0,189,234,0,9
264,R,112,H R 1217,13-Apr-2011,5:43 PM,On Passage,To repeal the Prevention and Public Health Fund,Passed,232,0,0,8,4,183,0,5,0,0,0,0,236,183,0,13
265,R,112,H RES 223,14-Apr-2011,12:56 PM,On Ordering the Previous Question,Providing for consideration of the concurrent resolution (H. Con. Res. 34) establishing the budget for the United States Government for fiscal year 2012 and setting forth appropriate budgetary levels for fiscal years 2013 through 2021,Passed,236,0,0,4,2,183,0,7,0,0,0,0,238,183,0,11
266,R,112,H RES 223,14-Apr-2011,1:05 PM,On Agreeing to the Resolution,Providing for consideration of the concurrent resolution (H. Con. Res. 34) establishing the budget for the United States Government for fiscal year 2012 and setting forth appropriate budgetary levels for fiscal years 2013 through 2021,Passed,238,0,0,2,5,181,0,6,0,0,0,0,243,181,0,8
267,R,112,JOURNAL,14-Apr-2011,1:13 PM,On Approving the Journal,None,Passed,192,41,2,5,119,65,0,8,0,0,0,0,311,106,2,13
268,R,112,H R 1473,14-Apr-2011,3:00 PM,On Passage,"Department of Defense and Full-Year Continuing Appropriations Act, 2011",Passed,179,59,0,3,81,108,0,3,0,0,0,0,260,167,0,6
269,R,112,H CON RES 43,14-Apr-2011,3:07 PM,On Agreeing to the Resolution,Providing for an adjournment or recess of the two Houses,Passed,226,9,0,5,17,169,0,6,0,0,0,0,243,178,0,11
270,R,112,H CON RES 35,14-Apr-2011,4:29 PM,On Agreeing to the Resolution,Directing the Clerk of the House of Representatives to make a correction in the enrollment of H.R. 1473,Passed,237,0,0,3,3,185,0,4,0,0,0,0,240,185,0,7
271,R,112,H CON RES 36,14-Apr-2011,4:39 PM,On Agreeing to the Resolution,Directing the Clerk of the House of Representatives to make a correction in the enrollment of H.R. 1473,Passed,231,7,1,1,10,178,0,4,0,0,0,0,241,185,1,5
272,R,112,ADJOURN,14-Apr-2011,4:55 PM,On Motion to Adjourn,None,Failed,3,234,0,3,8,178,0,6,0,0,0,0,11,412,0,9
273,R,112,H CON RES 34,15-Apr-2011,9:41 AM,On Agreeing to the Amendment,None,Failed,0,228,0,12,103,75,0,14,0,0,0,0,103,303,0,26
274,R,112,H CON RES 34,15-Apr-2011,11:35 AM,On Agreeing to the Amendment,None,Failed,0,239,0,1,77,108,0,7,0,0,0,0,77,347,0,8
275,R,112,H CON RES 34,15-Apr-2011,11:58 AM,On Agreeing to the Amendment,None,Failed,119,120,0,1,0,16,172,4,0,0,0,0,119,136,172,5
276,R,112,H CON RES 34,15-Apr-2011,1:12 PM,On Agreeing to the Amendment,None,Failed,0,236,0,4,166,23,0,3,0,0,0,0,166,259,0,7
277,R,112,H CON RES 34,15-Apr-2011,2:23 PM,On Agreeing to the Resolution,Establishing the budget for the United States Government for fiscal year 2012 and setting forth appropriate budgetary levels for fiscal years 2013 through 2021,Passed,235,4,0,1,0,189,0,3,0,0,0,0,235,193,0,4
278,R,112,H R 1423,2-May-2011,6:53 PM,On Motion to Suspend the Rules and Pass,"To designate the facility of the United States Postal Service located at 115 4th Avenue Southwest in Ardmore, Oklahoma, as the “Specialist Michael E. Phillips Post Office”",Passed,224,0,0,16,175,0,0,17,0,0,0,0,399,0,0,33
279,R,112,H RES 236,3-May-2011,1:40 PM,On Ordering the Previous Question,"Providing for consideration of H.R. 1213, to repeal mandatory funding provided to States in the Patient Protection and Affordable Care Act to establish American Health Benefit Exchanges; H.R. 1214, to repeal mandatory funding for school-based health center construction.",Passed,231,0,0,9,3,185,0,4,0,0,0,0,234,185,0,13
280,R,112,H RES 236,3-May-2011,1:47 PM,On Agreeing to the Resolution,"Providing for consideration of H.R. 1213, to repeal mandatory funding provided to States in the Patient Protection and Affordable Care Act to establish American Health Benefit Exchanges; H.R. 1214, to repeal mandatory funding for school-based health center construction.",Passed,233,0,0,7,4,185,0,3,0,0,0,0,237,185,0,10
281,R,112,H R 1213,3-May-2011,5:31 PM,On Agreeing to the Amendment,None,Failed,4,228,0,8,173,11,0,8,0,0,0,0,177,239,0,16
282,R,112,H R 1213,3-May-2011,5:38 PM,On Agreeing to the Amendment,None,Failed,0,231,0,9,178,11,0,3,0,0,0,0,178,242,0,12
283,R,112,H R 1213,3-May-2011,5:46 PM,On Agreeing to the Amendment,None,Failed,0,234,0,6,180,8,0,4,0,0,0,0,180,242,0,10
284,R,112,H R 1213,3-May-2011,6:15 PM,On Motion to Recommit with Instructions,To repeal mandatory funding provided to States in the Patient Protection and Affordable Care Act to establish American Health Benefit Exchanges,Failed,1,232,0,7,189,1,0,2,0,0,0,0,190,233,0,9
285,R,112,H R 1213,3-May-2011,6:22 PM,On Passage,To repeal mandatory funding provided to States in the Patient Protection and Affordable Care Act to establish American Health Benefit Exchanges,Passed,233,0,0,7,5,183,0,4,0,0,0,0,238,183,0,11
286,R,112,H RES 237,4-May-2011,1:56 PM,On Agreeing to the Resolution,"Providing for consideration of H.R. 3, No Taxpayer Funding for Abortion Act",Passed,231,0,0,9,12,177,0,3,0,0,0,0,243,177,0,12
287,R,112,H R 1214,4-May-2011,3:54 PM,On Agreeing to the Amendment,None,Failed,26,209,0,5,181,9,0,2,0,0,0,0,207,218,0,7
288,R,112,H R 1214,4-May-2011,4:03 PM,On Agreeing to the Amendment,None,Failed,28,202,0,10,177,8,0,7,0,0,0,0,205,210,0,17
289,R,112,H R 1214,4-May-2011,4:34 PM,On Motion to Recommit with Instructions,To repeal mandatory funding for school-based health center construction,Failed,0,222,0,18,180,8,0,4,0,0,0,0,180,230,0,22
290,R,112,H R 1214,4-May-2011,4:41 PM,On Passage,To repeal mandatory funding for school-based health center construction,Passed,232,4,0,4,3,187,0,2,0,0,0,0,235,191,0,6
291,R,112,H R 3,4-May-2011,5:13 PM,On Motion to Recommit with Instructions,No Taxpayer Funding for Abortion Act,Failed,1,235,0,4,191,0,0,1,0,0,0,0,192,235,0,5
292,R,112,H R 3,4-May-2011,5:20 PM,On Passage,No Taxpayer Funding for Abortion Act,Passed,235,0,0,5,16,175,0,1,0,0,0,0,251,175,0,6
293,R,112,H RES 245,5-May-2011,10:59 AM,On Ordering the Previous Question,"Providing for consideration of H.R. 1229, to amend the Outer Continental Shelf Lands Act to facilitate the safe and timely production of American energy resources from the Gulf of Mexico; and for consideration of H.R. 1230, to require the Secretary of the Interior to conduct certain offshore oil and gas lease sales",Passed,234,0,0,6,7,171,0,14,0,0,0,0,241,171,0,20
294,R,112,H RES 245,5-May-2011,11:06 AM,On Agreeing to the Resolution,"Providing for consideration of H.R. 1229, to amend the Outer Continental Shelf Lands Act to facilitate the safe and timely production of American energy resources from the Gulf of Mexico; and for consideration of H.R. 1230, to require the Secretary of the Interior to conduct certain offshore oil and gas lease sales",Passed,234,0,0,6,11,167,0,14,0,0,0,0,245,167,0,20
295,R,112,H R 1230,5-May-2011,1:06 PM,On Agreeing to the Amendment,None,Failed,8,226,0,6,166,14,0,12,0,0,0,0,174,240,0,18
296,R,112,H R 1230,5-May-2011,1:13 PM,On Agreeing to the Amendment,None,Failed,5,231,0,4,171,9,0,12,0,0,0,0,176,240,0,16
297,R,112,H R 1230,5-May-2011,1:39 PM,On Motion to Recommit with Instructions,Restarting American Offshore Leasing Now Act,Failed,1,234,0,5,170,4,0,18,0,0,0,0,171,238,0,23
298,R,112,H R 1230,5-May-2011,1:59 PM,On Passage,Restarting American Offshore Leasing Now Act,Passed,233,2,0,5,33,147,0,12,0,0,0,0,266,149,0,17
299,R,112,H R 1229,10-May-2011,6:57 PM,On Agreeing to the Amendment,None,Failed,3,230,0,6,164,15,0,13,0,0,0,0,167,245,0,19
300,R,112,H R 1229,10-May-2011,7:04 PM,On Agreeing to the Amendment,None,Failed,6,224,0,9,163,16,0,13,0,0,0,0,169,240,0,22
301,R,112,H R 1229,10-May-2011,7:12 PM,On Agreeing to the Amendment,None,Failed,11,222,0,6,165,15,0,12,0,0,0,0,176,237,0,18
302,R,112,H R 1229,11-May-2011,1:58 PM,On Agreeing to the Amendment,None,Failed,10,224,0,5,177,11,0,4,0,0,0,0,187,235,0,9
303,R,112,H R 1229,11-May-2011,2:04 PM,On Agreeing to the Amendment,None,Failed,2,233,0,4,177,14,0,1,0,0,0,0,179,247,0,5
304,R,112,H R 1229,11-May-2011,2:08 PM,On Agreeing to the Amendment,None,Failed,1,236,0,2,173,18,0,1,0,0,0,0,174,254,0,3
305,R,112,H R 1229,11-May-2011,2:12 PM,On Agreeing to the Amendment,None,Failed,1,235,0,3,168,23,0,1,0,0,0,0,169,258,0,4
306,R,112,H R 1229,11-May-2011,2:17 PM,On Agreeing to the Amendment,None,Failed,24,212,0,3,181,10,0,1,0,0,0,0,205,222,0,4
307,R,112,H R 1229,11-May-2011,2:22 PM,On Agreeing to the Amendment,None,Failed,2,231,0,6,183,8,0,1,0,0,0,0,185,239,0,7
308,R,112,H R 1229,11-May-2011,2:53 PM,On Motion to Recommit with Instructions,Putting the Gulf of Mexico Back to Work Act,Failed,1,235,0,3,185,4,0,3,0,0,0,0,186,239,0,6
309,R,112,H R 1229,11-May-2011,2:59 PM,On Passage,Putting the Gulf of Mexico Back to Work Act,Passed,235,0,0,4,28,163,0,1,0,0,0,0,263,163,0,5
310,R,112,H RES 257,11-May-2011,3:10 PM,On Ordering the Previous Question,"Providing for consideration of the bill (H.R. 1231) to amend the Outer Continental Shelf Lands Act to require that each 5-year offshore oil and gas leasing program offer leasing in the areas with the most prospective oil and gas resources, to establish a domestic oil and natural gas production goal",Passed,235,0,0,4,6,179,0,7,0,0,0,0,241,179,0,11
311,R,112,H RES 257,11-May-2011,3:29 PM,On Agreeing to the Resolution,"Providing for consideration of the bill (H.R. 1231) to amend the Outer Continental Shelf Lands Act to require that each 5-year offshore oil and gas leasing program offer leasing in the areas with the most prospective oil and gas resources, to establish a domestic oil and natural gas production goal",Passed,233,1,0,5,10,178,0,4,0,0,0,0,243,179,0,9
312,R,112,H R 1231,11-May-2011,6:14 PM,On Agreeing to the Amendment,None,Failed,17,216,0,6,176,12,0,4,0,0,0,0,193,228,0,10
313,R,112,H R 1231,11-May-2011,6:22 PM,On Agreeing to the Amendment,None,Failed,14,223,0,2,175,15,0,2,0,0,0,0,189,238,0,4
314,R,112,H R 1231,11-May-2011,6:30 PM,On Agreeing to the Amendment,None,Failed,11,224,0,4,175,16,0,1,0,0,0,0,186,240,0,5
315,R,112,H R 1231,12-May-2011,1:36 PM,On Agreeing to the Amendment,None,Failed,15,215,0,9,180,8,0,4,0,0,0,0,195,223,0,13
316,R,112,H R 1231,12-May-2011,1:41 PM,On Agreeing to the Amendment,None,Failed,5,222,0,12,129,57,0,6,0,0,0,0,134,279,0,18
317,R,112,H R 1231,12-May-2011,1:44 PM,On Agreeing to the Amendment,None,Failed,4,226,0,9,152,37,0,3,0,0,0,0,156,263,0,12
318,R,112,H R 1231,12-May-2011,1:49 PM,On Agreeing to the Amendment,None,Failed,10,220,0,9,150,36,0,6,0,0,0,0,160,256,0,15
319,R,112,H R 1231,12-May-2011,2:19 PM,On Motion to Recommit with Instructions,Reversing President Obama’s Offshore Moratorium Act,Failed,1,231,0,7,179,12,0,1,0,0,0,0,180,243,0,8
320,R,112,H R 1231,12-May-2011,2:26 PM,On Passage,Reversing President Obama’s Offshore Moratorium Act,Passed,222,9,0,8,21,170,0,1,0,0,0,0,243,179,0,9
321,R,112,H CON RES 50,12-May-2011,2:32 PM,On Agreeing to the Resolution,Providing for an adjournment of the House,Passed,220,11,0,8,7,147,0,38,0,0,0,0,227,158,0,46
322,R,112,H RES 264,12-May-2011,2:39 PM,On Agreeing to the Resolution,"Providing for consideration of the bill (H.R. 754) to authorize appropriations for fiscal year 2011 for intelligence and intelligence-related activities of the United States Government, the Community Management Account, and the Central Intelligence Agency Retirement and Disability System, and for other purposes",Passed,230,0,0,9,21,133,0,38,0,0,0,0,251,133,0,47
323,R,112,H R 754,13-May-2011,10:03 AM,On Agreeing to the Amendment,None,Agreed to,219,0,0,20,5,174,0,13,0,0,0,0,224,174,0,33
324,R,112,H R 754,13-May-2011,10:10 AM,On Agreeing to the Amendment,None,Agreed to,222,0,0,17,56,123,0,13,0,0,0,0,278,123,0,30
325,R,112,H R 754,13-May-2011,10:19 AM,On Agreeing to the Amendment,None,Failed,18,207,0,14,176,7,0,9,0,0,0,0,194,214,0,23
326,R,112,H R 754,13-May-2011,10:27 AM,On Agreeing to the Amendment,None,Agreed to,40,187,0,12,181,2,0,9,0,0,0,0,221,189,0,21
327,R,112,H R 754,13-May-2011,10:37 AM,On Agreeing to the Amendment,None,Agreed to,228,0,0,11,178,0,4,10,0,0,0,0,406,0,4,21
328,R,112,H R 754,13-May-2011,11:07 AM,On Motion to Recommit with Instructions,Intelligence Authorization Act for Fiscal Year 2011,Failed,0,228,0,11,182,0,1,9,0,0,0,0,182,228,1,20
329,R,112,H R 754,13-May-2011,11:14 AM,On Passage,Intelligence Authorization Act for Fiscal Year 2011,Passed,223,3,0,13,169,12,0,11,0,0,0,0,392,15,0,24
330,R,112,H R 1627,23-May-2011,6:54 PM,"On Motion to Suspend the Rules and Pass, as Amended",Honoring American Veterans Act of 2011,Passed,217,0,0,22,163,0,0,29,0,0,0,0,380,0,0,51
331,R,112,H R 1383,23-May-2011,7:02 PM,"On Motion to Suspend the Rules and Pass, as Amended",Restoring GI Bill Fairness Act of 2011,Passed,223,0,0,16,166,0,0,26,0,0,0,0,389,0,0,42
332,R,112,H R 1657,23-May-2011,7:08 PM,On Motion to Suspend the Rules and Pass,"To amend title 38, United States Code, to revise the enforcement penalties for misrepresentation of a business concern as a small business concern owned and controlled by veterans or as a small business concern owned and controlled by service-disabled veterans",Passed,220,1,0,18,165,0,0,27,0,0,0,0,385,1,0,45
333,R,112,H RES 269,24-May-2011,2:32 PM,On Ordering the Previous Question,"Consideration of HR 1216 to amend the Public Health Service Act to convert funding for graduate medical education in teaching health centers from direct appropriations to an authorization of appropriations; consideration of HR 1540, the National Defense Authorization Act, FY 2012; and waiving clause 6(a) of rule XIII",Passed,230,0,0,9,3,179,0,10,0,0,0,0,233,179,0,19
334,R,112,H RES 269,24-May-2011,2:40 PM,On Agreeing to the Resolution,"Consideration of HR 1216 to amend the Public Health Service Act to convert funding for graduate medical education in teaching health centers from direct appropriations to an authorization of appropriations; consideration of HR 1540, the National Defense Authorization Act, FY 2012; and waiving clause 6(a) of rule XIII",Passed,232,1,0,6,6,180,0,6,0,0,0,0,238,181,0,12
335,R,112,H R 1216,24-May-2011,6:30 PM,On Motion that the Committee Rise,To amend the Public Health Service Act to convert funding for graduate medical education in qualified teaching health centers from direct appropriations to an authorization of appropriations,Failed,1,233,0,5,13,164,0,15,0,0,0,0,14,397,0,20
336,R,112,H R 1216,24-May-2011,6:38 PM,On Agreeing to the Amendment,None,Failed,5,229,0,5,181,2,0,9,0,0,0,0,186,231,0,14
337,R,112,H R 1216,24-May-2011,6:45 PM,On Agreeing to the Amendment,None,Failed,2,229,0,8,180,3,0,9,0,0,0,0,182,232,0,17
338,R,112,H R 1216,25-May-2011,1:49 PM,On Agreeing to the Amendment,None,Agreed to,221,10,0,8,13,172,0,7,0,0,0,0,234,182,0,15
339,R,112,H R 1216,25-May-2011,2:32 PM,On Motion to Recommit with Instructions,To amend the Public Health Service Act to convert funding for graduate medical education in qualified teaching health centers from direct appropriations to an authorization of appropriations,Failed,1,234,0,4,183,2,0,7,0,0,0,0,184,236,0,11
340,R,112,H R 1216,25-May-2011,2:39 PM,On Passage,To amend the Public Health Service Act to convert funding for graduate medical education in qualified teaching health centers from direct appropriations to an authorization of appropriations,Passed,231,4,0,4,3,181,0,8,0,0,0,0,234,185,0,12
341,R,112,H RES 276,25-May-2011,2:51 PM,On Ordering the Previous Question,"Providing for further consideration of H.R. 1540, The National Defense Authorization Act for Fiscal Year 2012",Passed,236,0,0,3,3,181,0,8,0,0,0,0,239,181,0,11
342,R,112,H RES 276,25-May-2011,3:02 PM,On Agreeing to the Resolution,"Providing for further consideration of H.R. 1540, The National Defense Authorization Act for Fiscal Year 2012",Passed,230,1,0,8,13,169,0,10,0,0,0,0,243,170,0,18
343,R,112,H R 1540,25-May-2011,6:30 PM,On Agreeing to the Amendment,None,Failed,8,228,0,3,75,106,0,11,0,0,0,0,83,334,0,14
344,R,112,H R 1540,25-May-2011,6:34 PM,On Agreeing to the Amendment,None,Failed,199,35,0,5,4,178,0,10,0,0,0,0,203,213,0,15
345,R,112,H R 1540,25-May-2011,6:38 PM,On Agreeing to the Amendment,None,Failed,13,222,0,4,185,3,0,4,0,0,0,0,198,225,0,8
346,R,112,H R 1540,25-May-2011,6:42 PM,On Agreeing to the Amendment,None,Failed,25,208,0,6,183,4,0,5,0,0,0,0,208,212,0,11
347,R,112,H R 1540,25-May-2011,6:48 PM,On Agreeing to the Amendment,None,Agreed to,235,1,0,3,26,162,0,4,0,0,0,0,261,163,0,7
348,R,112,H R 1540,25-May-2011,6:53 PM,On Agreeing to the Amendment,None,Failed,6,230,0,3,162,26,0,4,0,0,0,0,168,256,0,7
349,R,112,H R 1540,25-May-2011,6:57 PM,On Agreeing to the Amendment,None,Failed,7,229,0,3,169,19,0,4,0,0,0,0,176,248,0,7
350,R,112,H R 1540,25-May-2011,7:03 PM,On Agreeing to the Amendment,None,Failed,61,175,0,3,123,65,0,4,0,0,0,0,184,240,0,7
351,R,112,H R 1540,25-May-2011,7:08 PM,On Agreeing to the Amendment,None,Failed,6,229,0,4,185,3,0,4,0,0,0,0,191,232,0,8
352,R,112,H R 1540,25-May-2011,7:11 PM,On Agreeing to the Amendment,None,Failed,3,233,0,3,175,13,0,4,0,0,0,0,178,246,0,7
353,R,112,H R 1540,25-May-2011,7:15 PM,On Agreeing to the Amendment,None,Failed,19,217,0,3,158,29,0,5,0,0,0,0,177,246,0,8
354,R,112,H R 1540,26-May-2011,12:51 PM,On Agreeing to the Amendment,None,Agreed to,217,18,0,4,43,142,0,7,0,0,0,0,260,160,0,11
355,R,112,H R 1540,26-May-2011,12:57 PM,On Agreeing to the Amendment,None,Agreed to,215,19,0,5,31,153,0,8,0,0,0,0,246,172,0,13
356,R,112,H R 1540,26-May-2011,1:00 PM,On Agreeing to the Amendment,None,Failed,3,231,0,5,162,22,0,8,0,0,0,0,165,253,0,13
357,R,112,H R 1540,26-May-2011,1:04 PM,On Agreeing to the Amendment,None,Agreed to,228,7,0,4,18,166,0,8,0,0,0,0,246,173,0,12
358,R,112,H R 1540,26-May-2011,1:09 PM,On Agreeing to the Amendment,None,Failed,1,234,0,4,90,95,0,7,0,0,0,0,91,329,0,11
359,R,112,H R 1540,26-May-2011,1:12 PM,On Agreeing to the Amendment,None,Agreed to,199,36,0,4,28,157,0,7,0,0,0,0,227,193,0,11
360,R,112,H R 1540,26-May-2011,1:16 PM,On Agreeing to the Amendment,None,Failed,4,231,0,4,168,15,0,9,0,0,0,0,172,246,0,13
361,R,112,H R 1540,26-May-2011,1:21 PM,On Agreeing to the Amendment,None,Failed,21,214,0,4,166,20,0,6,0,0,0,0,187,234,0,10
362,R,112,H R 1540,26-May-2011,1:24 PM,On Agreeing to the Amendment,None,Failed,54,179,0,6,9,175,0,8,0,0,0,0,63,354,0,14
363,R,112,H R 1540,26-May-2011,1:28 PM,On Agreeing to the Amendment,None,Failed,87,146,0,6,11,175,0,6,0,0,0,0,98,321,0,12
364,R,112,H R 1540,26-May-2011,1:31 PM,On Agreeing to the Amendment,None,Failed,16,217,0,6,107,77,0,8,0,0,0,0,123,294,0,14
365,R,112,H R 1540,26-May-2011,1:36 PM,On Agreeing to the Amendment,None,Failed,17,217,0,5,79,106,1,6,0,0,0,0,96,323,1,11
366,R,112,H R 1540,26-May-2011,1:39 PM,On Agreeing to the Amendment,None,Agreed to,233,2,0,4,183,3,0,6,0,0,0,0,416,5,0,10
367,R,112,H R 1540,26-May-2011,1:44 PM,On Agreeing to the Amendment,None,Agreed to,112,122,0,5,157,29,0,6,0,0,0,0,269,151,0,11
368,R,112,H R 1540,26-May-2011,1:47 PM,On Agreeing to the Amendment,None,Failed,12,220,0,7,164,21,0,7,0,0,0,0,176,241,0,14
369,R,112,H R 1540,26-May-2011,1:50 PM,On Agreeing to the Amendment,None,Failed,15,218,0,6,169,16,0,7,0,0,0,0,184,234,0,13
370,R,112,H R 1540,26-May-2011,1:54 PM,On Agreeing to the Amendment,None,Agreed to,234,0,0,5,185,0,0,7,0,0,0,0,419,0,0,12
371,R,112,H R 1540,26-May-2011,1:57 PM,On Agreeing to the Amendment,None,Agreed to,146,88,0,5,154,32,0,6,0,0,0,0,300,120,0,11
372,R,112,H R 1540,26-May-2011,2:01 PM,On Agreeing to the Amendment,None,Agreed to,216,18,0,5,10,176,0,6,0,0,0,0,226,194,0,11
373,R,112,H R 1540,26-May-2011,2:05 PM,On Agreeing to the Amendment,None,Failed,26,207,0,6,178,8,0,6,0,0,0,0,204,215,0,12
374,R,112,H R 1540,26-May-2011,2:33 PM,On Motion to Recommit with Instructions,"To authorize appropriations for fiscal year 2012 for military activities of the Department of Defense and for military construction, to prescribe military personnel strengths for fiscal year 2012, and for other purposes.",Failed,1,233,0,5,184,0,0,8,0,0,0,0,185,233,0,13
375,R,112,H R 1540,26-May-2011,2:40 PM,On Passage,"To authorize appropriations for fiscal year 2012 for military activities of the Department of Defense and for military construction, to prescribe military personnel strengths for fiscal year 2012, and for other purposes.",Passed,227,6,0,6,95,90,0,7,0,0,0,0,322,96,0,13
376,R,112,S 990,26-May-2011,7:56 PM,On Motion to Concur in the Senate Amendment to the House Amendment,Small Business Additional Temporary Extension Act of 2011,Passed,196,31,0,12,54,122,0,16,0,0,0,0,250,153,0,28
377,R,112,H R 1484,31-May-2011,6:52 PM,"On Motion to Suspend the Rules and Pass, as Amended",Veterans Appeal Improvement Act,Passed,234,1,0,4,185,0,0,7,0,0,0,0,419,1,0,11
378,R,112,S 1082,31-May-2011,7:01 PM,On Motion to Suspend the Rules and Pass,Small Business Additional Temporary Extension Act,Passed,224,11,0,4,163,22,0,7,0,0,0,0,387,33,0,11
379,R,112,H R 1954,31-May-2011,7:11 PM,On Motion to Suspend the Rules and Pass,To implement the President’s request to increase the statutory limit on the public debt,Failed,0,236,0,3,97,82,7,6,0,0,0,0,97,318,7,9
380,R,112,H RES 287,1-Jun-2011,1:16 PM,On Consideration of the Resolution,"Providing for consideration of H.R. 2017, making appropriations for the Department of Homeland Security for the fiscal year ending September 30, 2012, and for other purposes",Passed,234,0,0,5,0,183,0,9,0,0,0,0,234,183,0,14
381,R,112,H RES 287,1-Jun-2011,3:10 PM,On Ordering the Previous Question,"Providing for consideration of H.R. 2017, making appropriations for the Department of Homeland Security for the fiscal year ending September 30, 2012, and for other purposes",Passed,235,0,0,4,0,186,0,6,0,0,0,0,235,186,0,10
382,R,112,H RES 287,1-Jun-2011,3:26 PM,On Agreeing to the Resolution,"Providing for consideration of H.R. 2017, making appropriations for the Department of Homeland Security for the fiscal year ending September 30, 2012, and for other purposes",Passed,231,2,0,6,0,185,0,8,0,0,0,0,231,187,0,14
383,R,112,H R 802,1-Jun-2011,3:33 PM,"On Motion to Suspend the Rules and Pass, as Amended",To direct the Secretary of Veterans Affairs to establish a VetStar Award Program,Passed,222,11,0,6,186,0,0,7,0,0,0,0,408,11,0,13
384,R,112,H R 2017,1-Jun-2011,6:38 PM,On Agreeing to the Amendment,None,Agreed to,147,87,0,5,186,0,0,7,0,0,0,0,333,87,0,12
385,R,112,H R 2017,1-Jun-2011,6:44 PM,On Agreeing to the Amendment,None,Failed,10,223,0,6,144,43,0,6,0,0,0,0,154,266,0,12
386,R,112,H R 2017,1-Jun-2011,6:48 PM,On Agreeing to the Amendment,None,Agreed to,232,1,0,6,36,150,0,7,0,0,0,0,268,151,0,13
387,R,112,H R 2017,1-Jun-2011,6:51 PM,On Agreeing to the Amendment,None,Agreed to,205,29,0,5,122,64,0,7,0,0,0,0,327,93,0,12
388,R,112,H R 2017,1-Jun-2011,6:55 PM,On Agreeing to the Amendment,None,Failed,97,137,0,5,65,119,0,9,0,0,0,0,162,256,0,14
389,R,112,H R 2017,2-Jun-2011,1:29 PM,On Agreeing to the Amendment,None,Agreed to,143,92,0,4,130,58,0,5,0,0,0,0,273,150,0,9
390,R,112,H R 2017,2-Jun-2011,1:32 PM,On Agreeing to the Amendment,None,Agreed to,217,17,0,5,1,187,0,5,0,0,0,0,218,204,0,10
391,R,112,H R 2017,2-Jun-2011,1:36 PM,On Agreeing to the Amendment,None,Agreed to,228,3,0,8,10,174,0,9,0,0,0,0,238,177,0,17
392,R,112,H R 2017,2-Jun-2011,1:40 PM,On Agreeing to the Amendment,None,Agreed to,233,2,0,4,9,178,0,6,0,0,0,0,242,180,0,10
393,R,112,H R 2017,2-Jun-2011,1:44 PM,On Agreeing to the Amendment,None,Agreed to,78,155,0,6,186,2,0,5,0,0,0,0,264,157,0,11
394,R,112,H R 2017,2-Jun-2011,1:47 PM,On Agreeing to the Amendment,None,Failed,111,123,0,5,97,90,0,6,0,0,0,0,208,213,0,11
395,R,112,H R 2017,2-Jun-2011,1:50 PM,On Agreeing to the Amendment,None,Failed,182,52,0,5,1,182,0,10,0,0,0,0,183,234,0,15
396,R,112,H R 2017,2-Jun-2011,5:35 PM,On Agreeing to the Amendment,None,Failed,206,28,0,5,1,185,0,7,0,0,0,0,207,213,0,12
397,R,112,H R 2017,2-Jun-2011,5:47 PM,On Agreeing to the Amendment,None,Agreed to,230,3,1,5,21,165,0,7,0,0,0,0,251,168,1,12
398,R,112,H R 2017,2-Jun-2011,5:50 PM,On Agreeing to the Amendment,None,Agreed to,234,0,0,5,55,131,0,7,0,0,0,0,289,131,0,12
399,R,112,H R 2017,2-Jun-2011,5:53 PM,On Agreeing to the Amendment,None,Failed,106,129,0,4,21,166,0,6,0,0,0,0,127,295,0,10
400,R,112,H R 2017,2-Jun-2011,5:57 PM,On Agreeing to the Amendment,None,Failed,100,135,0,4,23,165,0,5,0,0,0,0,123,300,0,9
401,R,112,H R 2017,2-Jun-2011,6:00 PM,On Agreeing to the Amendment,None,Agreed to,231,2,0,6,26,162,0,5,0,0,0,0,257,164,0,11
402,R,112,H R 2017,2-Jun-2011,6:03 PM,On Agreeing to the Amendment,None,Failed,108,127,0,4,2,185,0,6,0,0,0,0,110,312,0,10
403,R,112,H R 2017,2-Jun-2011,6:06 PM,On Agreeing to the Amendment,None,Agreed to,217,18,0,4,1,187,0,5,0,0,0,0,218,205,0,9
404,R,112,H R 2017,2-Jun-2011,6:10 PM,On Agreeing to the Amendment,None,Agreed to,232,2,0,5,20,168,0,5,0,0,0,0,252,170,0,10
405,R,112,H R 2017,2-Jun-2011,6:13 PM,On Agreeing to the Amendment,None,Failed,196,39,0,4,3,185,0,5,0,0,0,0,199,224,0,9
406,R,112,H R 2017,2-Jun-2011,6:17 PM,On Agreeing to the Amendment,None,Agreed to,218,17,0,4,1,187,0,5,0,0,0,0,219,204,0,9
407,R,112,H R 2017,2-Jun-2011,6:21 PM,On Agreeing to the Amendment,None,Failed,0,232,0,7,107,81,0,5,0,0,0,0,107,313,0,12
408,R,112,H R 2017,2-Jun-2011,6:53 PM,On Motion to Recommit with Instructions,"Homeland Security, FY 2012",Failed,1,233,0,5,186,1,0,6,0,0,0,0,187,234,0,11
409,R,112,H R 2017,2-Jun-2011,6:59 PM,On Passage,"Homeland Security, FY 2012",Passed,214,20,0,5,17,168,0,8,0,0,0,0,231,188,0,13
410,R,112,H RES 294,3-Jun-2011,10:43 AM,On Agreeing to the Resolution,"Providing for consideration of H.Res. 292 declaring that the President shall not deploy, establish, or maintain the presence of U.S. Armed Forces in Libya, and for consideration of H.Con.Res. 51 directing the President, pursuant to section 5(c) of the War Powers Resolution, to remove the U.S. Armed Forces from Libya",Passed,232,0,0,7,25,156,0,12,0,0,0,0,257,156,0,19
411,R,112,H RES 292,3-Jun-2011,1:40 PM,On Agreeing to the Resolution,"Declaring that the President shall not deploy, establish, or maintain the presence of units and members of the United States Armed Forces on the ground in Libya, and for other purposes",Passed,223,10,0,6,45,135,1,12,0,0,0,0,268,145,1,18
412,R,112,H CON RES 51,3-Jun-2011,1:47 PM,On Agreeing to the Resolution,"Directing the President, pursuant to section 5(c) of the War Powers Resolution, to remove the United States Armed Froces from Libya",Failed,87,144,0,8,61,121,0,11,0,0,0,0,148,265,0,19
413,R,112,H R 2055,13-Jun-2011,6:54 PM,On Agreeing to the Amendment,None,Agreed to,27,202,0,10,177,1,0,15,0,0,0,0,204,203,0,25
414,R,112,H R 2055,13-Jun-2011,7:00 PM,On Agreeing to the Amendment,None,Failed,177,54,0,8,1,178,0,14,0,0,0,0,178,232,0,22
415,R,112,H R 2055,13-Jun-2011,7:07 PM,On Agreeing to the Amendment,None,Agreed to,138,93,0,8,110,70,0,13,0,0,0,0,248,163,0,21
416,R,112,H R 2055,13-Jun-2011,7:26 PM,On Retaining Title II (Department of Veterans Affairs),"Making appropriations for military construction, the Department of Veterans Affairs, and related agencies for the fiscal year ending September 30, 2012, and for other purposes",Passed,230,1,0,8,179,0,0,14,0,0,0,0,409,1,0,22
417,R,112,H R 2055,14-Jun-2011,2:19 PM,On Motion to Recommit with Instructions,"Making appropriations for military construction, the Department of Veterans Affairs, and related agencies for the fiscal year ending September 30, 2012, and for other purposes",Failed,2,234,0,3,182,0,0,11,0,0,0,0,184,234,0,14
418,R,112,H R 2055,14-Jun-2011,2:26 PM,On Passage,"Making appropriations for military construction, the Department of Veterans Affairs, and related agencies for the fiscal year ending September 30, 2012, and for other purposes",Passed,229,5,0,5,182,0,0,11,0,0,0,0,411,5,0,16
419,R,112,H RES 300,14-Jun-2011,2:33 PM,On Agreeing to the Resolution,"Providing for consideration of H.R. 2112, making appropriations for Agriculture, Rural Development, Food and Drug Administration, and Related Agencies programs for the fiscal year ending September 30, 2012, and for other purposes.",Passed,231,0,0,8,4,180,0,9,0,0,0,0,235,180,0,17
420,R,112,H R 2112,15-Jun-2011,4:02 PM,On Agreeing to the Amendment,None,Failed,12,224,0,3,181,2,0,10,0,0,0,0,193,226,0,13
421,R,112,H R 2112,15-Jun-2011,4:09 PM,On Agreeing to the Amendment,None,Agreed to,225,12,0,2,1,187,0,5,0,0,0,0,226,199,0,7
422,R,112,H R 2112,15-Jun-2011,4:13 PM,On Agreeing to the Amendment,None,Agreed to,170,66,0,3,182,4,0,7,0,0,0,0,352,70,0,10
423,R,112,H R 2112,15-Jun-2011,4:18 PM,On Agreeing to the Amendment,None,Failed,108,128,0,3,12,176,0,5,0,0,0,0,120,304,0,8
424,R,112,H R 2112,15-Jun-2011,4:21 PM,On Agreeing to the Amendment,None,Failed,83,151,0,5,0,187,0,6,0,0,0,0,83,338,0,11
425,R,112,H R 2112,15-Jun-2011,4:24 PM,On Agreeing to the Amendment,None,Failed,114,122,0,3,11,176,0,6,0,0,0,0,125,298,0,9
426,R,112,H R 2112,15-Jun-2011,4:28 PM,On Agreeing to the Amendment,None,Failed,20,216,0,3,122,66,0,5,0,0,0,0,142,282,0,8
427,R,112,H R 2112,15-Jun-2011,4:31 PM,On Agreeing to the Amendment,None,Failed,98,139,0,2,9,179,0,5,0,0,0,0,107,318,0,7
428,R,112,H R 2112,15-Jun-2011,4:34 PM,On Agreeing to the Amendment,None,Failed,31,205,0,3,169,19,0,5,0,0,0,0,200,224,0,8
429,R,112,H R 2112,15-Jun-2011,4:37 PM,On Agreeing to the Amendment,None,Failed,126,110,0,3,13,175,0,5,0,0,0,0,139,285,0,8
430,R,112,H R 2112,15-Jun-2011,4:41 PM,On Agreeing to the Amendment,None,Failed,64,173,0,2,0,187,0,6,0,0,0,0,64,360,0,8
431,R,112,H R 2112,15-Jun-2011,4:44 PM,On Agreeing to the Amendment,None,Failed,119,118,0,2,0,188,0,5,0,0,0,0,119,306,0,7
432,R,112,H R 2112,15-Jun-2011,4:47 PM,On Agreeing to the Amendment,None,Failed,96,139,0,4,3,185,0,5,0,0,0,0,99,324,0,9
433,R,112,H R 2112,15-Jun-2011,4:51 PM,On Agreeing to the Amendment,None,Failed,124,112,0,3,0,188,0,5,0,0,0,0,124,300,0,8
434,R,112,H R 2112,15-Jun-2011,4:55 PM,On Agreeing to the Amendment,None,Failed,108,128,0,3,0,188,0,5,0,0,0,0,108,316,0,8
435,R,112,H R 2112,15-Jun-2011,4:59 PM,On Agreeing to the Amendment,None,Failed,120,116,0,3,0,187,0,6,0,0,0,0,120,303,0,9
436,R,112,H R 2112,15-Jun-2011,5:02 PM,On Agreeing to the Amendment,None,Failed,161,73,0,5,3,184,0,6,0,0,0,0,164,257,0,11
437,R,112,H R 2112,16-Jun-2011,11:58 AM,On Agreeing to the Amendment,None,Failed,5,224,0,10,165,14,0,14,0,0,0,0,170,238,0,24
438,R,112,H R 2112,16-Jun-2011,12:03 PM,On Agreeing to the Amendment,None,Agreed to,210,21,0,8,2,180,0,11,0,0,0,0,212,201,0,19
439,R,112,H R 2112,16-Jun-2011,12:14 PM,On Agreeing to the Amendment,None,Agreed to,95,141,0,3,128,56,0,9,0,0,0,0,223,197,0,12
440,R,112,H R 2112,16-Jun-2011,12:18 PM,On Agreeing to the Amendment,None,Failed,7,229,0,3,171,12,0,10,0,0,0,0,178,241,0,13
441,R,112,H R 2112,16-Jun-2011,12:22 PM,On Agreeing to the Amendment,None,Failed,5,230,0,4,162,22,0,9,0,0,0,0,167,252,0,13
442,R,112,H R 2112,16-Jun-2011,12:27 PM,On Agreeing to the Amendment,None,Agreed to,90,146,0,3,131,52,0,10,0,0,0,0,221,198,0,13
443,R,112,H R 2112,16-Jun-2011,12:30 PM,On Agreeing to the Amendment,None,Failed,40,192,0,7,114,70,0,9,0,0,0,0,154,262,0,16
444,R,112,H R 2112,16-Jun-2011,12:35 PM,On Agreeing to the Amendment,None,Failed,155,78,0,6,0,184,0,9,0,0,0,0,155,262,0,15
445,R,112,H R 2112,16-Jun-2011,12:38 PM,On Agreeing to the Amendment,None,Agreed to,226,9,0,4,14,167,0,12,0,0,0,0,240,176,0,16
446,R,112,H R 2112,16-Jun-2011,12:42 PM,On Agreeing to the Amendment,None,Agreed to,229,7,0,3,2,182,0,9,0,0,0,0,231,189,0,12
447,R,112,H R 2112,16-Jun-2011,12:45 PM,On Agreeing to the Amendment,None,Failed,5,230,0,4,176,7,0,10,0,0,0,0,181,237,0,14
448,R,112,H R 2112,16-Jun-2011,12:48 PM,On Agreeing to the Amendment,None,Agreed to,228,5,0,6,10,174,0,9,0,0,0,0,238,179,0,15
449,R,112,H R 2112,16-Jun-2011,12:51 PM,On Agreeing to the Amendment,None,Failed,8,226,0,5,174,9,0,10,0,0,0,0,182,235,0,15
450,R,112,H R 2112,16-Jun-2011,12:56 PM,On Agreeing to the Amendment,None,Agreed to,107,129,0,3,181,3,0,9,0,0,0,0,288,132,0,12
451,R,112,H R 2112,16-Jun-2011,1:00 PM,On Agreeing to the Amendment,None,Failed,39,196,0,4,45,139,0,9,0,0,0,0,84,335,0,13
452,R,112,H R 2112,16-Jun-2011,1:06 PM,On Agreeing to the Amendment,None,Failed,29,207,0,3,103,80,0,10,0,0,0,0,132,287,0,13
453,R,112,H R 2112,16-Jun-2011,1:09 PM,On Agreeing to the Amendment,None,Failed,108,128,0,3,1,182,0,10,0,0,0,0,109,310,0,13
454,R,112,H R 2112,16-Jun-2011,1:12 PM,On Agreeing to the Amendment,None,Agreed to,190,45,0,4,93,83,0,17,0,0,0,0,283,128,0,21
455,R,112,H R 2112,16-Jun-2011,1:15 PM,On Agreeing to the Amendment,None,Failed,84,152,0,3,102,76,0,15,0,0,0,0,186,228,0,18
456,R,112,H R 2112,16-Jun-2011,1:18 PM,On Agreeing to the Amendment,None,Failed,68,167,0,4,94,87,0,12,0,0,0,0,162,254,0,16
457,R,112,H R 2112,16-Jun-2011,1:21 PM,On Agreeing to the Amendment,None,Failed,80,156,0,3,21,158,0,14,0,0,0,0,101,314,0,17
458,R,112,H R 2112,16-Jun-2011,1:52 PM,On Motion to Recommit with Instructions,"Making appropriations for Agriculture, Rural Development, Food and Drug Administration, and Related Agencies programs for the fiscal year ending September 30, 2012, and for other purposes",Failed,1,233,0,5,184,0,0,9,0,0,0,0,185,233,0,14
459,R,112,H R 2112,16-Jun-2011,2:01 PM,On Passage,"Making appropriations for Agriculture, Rural Development, Food and Drug Administration, and Related Agencies programs for the fiscal year ending September 30, 2012, and for other purposes",Passed,217,19,0,3,0,184,0,9,0,0,0,0,217,203,0,12
460,R,112,H R 1632,21-Jun-2011,6:54 PM,On Motion to Suspend the Rules and Pass,"To designate the facility of the United States Postal Service located at 5014 Gary Avenue in Lubbock, Texas, as the “Sergeant Chris Davis Post Office”",Passed,224,0,0,15,172,0,0,21,0,0,0,0,396,0,0,36
461,R,112,H R 771,21-Jun-2011,7:03 PM,On Motion to Suspend the Rules and Pass,"To designate the facility of the United States Postal Service located at 1081 Elbel Road in Schertz, Texas, as the “Schertz Veterans Post Office”",Passed,225,0,0,14,173,0,0,20,0,0,0,0,398,0,0,34
462,R,112,S 349,21-Jun-2011,7:11 PM,On Motion to Suspend the Rules and Pass,"To designate the facility of the United States Postal Service located at 4865 Tallmadge Road in Rootstown, Ohio, as the “Marine Sgt. Jeremy E. Murray Post Office”",Passed,225,0,0,14,172,0,0,21,0,0,0,0,397,0,0,35
463,R,112,H RES 316,22-Jun-2011,12:49 PM,On Question of Consideration of the Resolution,"Providing for consideration of the bill (H.R. 2021) to amend the Clean Air Act regarding air pollution from Outer Continental Shelf activities, and providing for consideration of the bill (H.R. 1249) to amend title 35, United States Code, to provide for patent reform",Passed,211,7,1,20,4,182,0,6,0,0,0,0,215,189,1,26
464,R,112,H RES 316,22-Jun-2011,2:23 PM,On Ordering the Previous Question,"Providing for consideration of the bill (H.R. 2021) to amend the Clean Air Act regarding air pollution from Outer Continental Shelf activities, and providing for consideration of the bill (H.R. 1249) to amend title 35, United States Code, to provide for patent reform",Passed,228,0,0,11,2,184,0,6,0,0,0,0,230,184,0,17
465,R,112,H RES 316,22-Jun-2011,2:37 PM,On Agreeing to the Resolution,"Providing for consideration of the bill (H.R. 2021) to amend the Clean Air Act regarding air pollution from Outer Continental Shelf activities, and providing for consideration of the bill (H.R. 1249) to amend title 35, United States Code, to provide for patent reform",Passed,226,8,0,5,13,178,0,1,0,0,0,0,239,186,0,6
466,R,112,H R 672,22-Jun-2011,2:44 PM,"On Motion to Suspend the Rules and Pass, as Amended","To terminate the Election Assistance Commission, and for other purposes",Failed,235,0,0,4,0,187,0,5,0,0,0,0,235,187,0,9
467,R,112,H R 2021,22-Jun-2011,5:59 PM,On Agreeing to the Amendment,None,Failed,2,231,0,6,174,17,0,1,0,0,0,0,176,248,0,7
468,R,112,H R 2021,22-Jun-2011,6:06 PM,On Agreeing to the Amendment,None,Failed,1,230,0,8,166,24,0,2,0,0,0,0,167,254,0,10
469,R,112,H R 2021,22-Jun-2011,6:13 PM,On Agreeing to the Amendment,None,Failed,10,222,0,7,173,16,0,3,0,0,0,0,183,238,0,10
470,R,112,H R 2021,22-Jun-2011,6:20 PM,On Agreeing to the Amendment,None,Failed,6,229,0,4,161,29,0,2,0,0,0,0,167,258,0,6
471,R,112,H R 2021,22-Jun-2011,6:26 PM,On Agreeing to the Amendment,None,Failed,1,234,0,4,171,19,0,2,0,0,0,0,172,253,0,6
472,R,112,H R 2021,22-Jun-2011,6:32 PM,On Agreeing to the Amendment,None,Failed,4,230,0,5,169,21,0,2,0,0,0,0,173,251,0,7
473,R,112,H R 2021,22-Jun-2011,6:38 PM,On Agreeing to the Amendment,None,Failed,6,229,0,4,177,11,0,4,0,0,0,0,183,240,0,8
474,R,112,H R 2021,22-Jun-2011,6:45 PM,On Agreeing to the Amendment,None,Failed,10,224,0,5,170,18,0,4,0,0,0,0,180,242,0,9
475,R,112,H R 2021,22-Jun-2011,6:51 PM,On Agreeing to the Amendment,None,Failed,8,226,0,5,178,12,0,2,0,0,0,0,186,238,0,7
476,R,112,H R 2021,22-Jun-2011,6:58 PM,On Agreeing to the Amendment,None,Failed,4,230,0,5,156,32,0,4,0,0,0,0,160,262,0,9
477,R,112,H R 2021,22-Jun-2011,7:23 PM,On Motion to Recommit with Instructions,Jobs and Energy Permitting Act of 2011,Failed,0,233,0,6,177,12,0,3,0,0,0,0,177,245,0,9
478,R,112,H R 2021,22-Jun-2011,7:30 PM,On Passage,Jobs and Energy Permitting Act of 2011,Passed,230,2,0,7,23,164,0,5,0,0,0,0,253,166,0,12
479,R,112,H RES 320,23-Jun-2011,1:34 PM,On Ordering the Previous Question,"Providing for the consideration of H.R. 2219, making appropriations for the Department of Defense for the fiscal year ending September 30, 2012, and for other purposes",Passed,236,0,0,3,11,168,0,13,0,0,0,0,247,168,0,16
480,R,112,H RES 320,23-Jun-2011,1:51 PM,On Agreeing to the Resolution,"Providing for the consideration of H.R. 2219, making appropriations for the Department of Defense for the fiscal year ending September 30, 2012, and for other purposes",Passed,235,1,0,3,16,172,0,4,0,0,0,0,251,173,0,7
481,R,112,H R 1249,23-Jun-2011,2:10 PM,On Agreeing to the Amendment,None,Agreed to,202,33,0,4,81,107,0,4,0,0,0,0,283,140,0,8
482,R,112,H R 1249,23-Jun-2011,4:41 PM,On Agreeing to the Amendment,None,Failed,37,198,0,4,68,118,0,6,0,0,0,0,105,316,0,10
483,R,112,H R 1249,23-Jun-2011,4:48 PM,On Agreeing to the Amendment,None,Failed,40,196,0,3,41,146,0,5,0,0,0,0,81,342,0,8
484,R,112,,23-Jun-2011,,,"This vote was vacated by unanimous consent on June 23, 2011. The vote on Conyers Amendment #9 is roll call 485.",,0,0,0,0,0,0,0,0,0,0,0,0,0,0,0,0
485,R,112,H R 1249,23-Jun-2011,4:59 PM,On Agreeing to the Amendment,None,Agreed to,68,167,0,4,155,31,0,6,0,0,0,0,223,198,0,10
486,R,112,H R 1249,23-Jun-2011,5:03 PM,On Agreeing to the Amendment,None,Failed,81,155,0,3,48,140,0,4,0,0,0,0,129,295,0,7
487,R,112,H R 1249,23-Jun-2011,5:07 PM,On Agreeing to the Amendment,None,Failed,79,154,0,6,13,175,0,4,0,0,0,0,92,329,0,10
488,R,112,H R 1249,23-Jun-2011,5:12 PM,On Agreeing to the Amendment,None,Failed,53,182,0,4,28,160,0,4,0,0,0,0,81,342,0,8
489,R,112,H R 1249,23-Jun-2011,5:15 PM,On Agreeing to the Amendment,None,Failed,65,170,0,4,93,92,1,6,0,0,0,0,158,262,1,10
490,R,112,H R 1249,23-Jun-2011,5:43 PM,On Motion to Recommit with Instructions,"To amend title 35, United States Code, to provide for patent reform",Failed,1,234,0,4,171,17,0,4,0,0,0,0,172,251,0,8
491,R,112,H R 1249,23-Jun-2011,5:49 PM,On Passage,"To amend title 35, United States Code, to provide for patent reform",Passed,168,67,0,4,136,50,0,6,0,0,0,0,304,117,0,10
492,R,112,H RES 328,24-Jun-2011,10:31 AM,On Agreeing to the Resolution,"Providing for consideration of H. J. Res. 68, Authorizing the limited use of United States Armed Forces in support of the Nato mission in Libya; and consideration of H. R. 2278, to limit the use of funds appropriated to the Department of Defense for United States Armed Forces in support of NATO operations in Libya",Passed,226,0,0,13,14,167,0,11,0,0,0,0,240,167,0,24
493,R,112,H J RES 68,24-Jun-2011,12:16 PM,On Passage,Authorizing the limited use of the United States Armed Forces in support of the NATO mission in Libya,Failed,8,225,0,6,115,70,0,7,0,0,0,0,123,295,0,13
494,R,112,H R 2278,24-Jun-2011,2:00 PM,On Passage,"To limit the use of funds appropriated to the Department of Defense for United States Armed Forces in support of North Atlantic Treaty Organization Operation Unified Protector with respect to Libya, unless otherwise specifically authorized by law",Failed,144,89,0,6,36,149,0,7,0,0,0,0,180,238,0,13
495,R,112,H R 2219,6-Jul-2011,7:00 PM,On Agreeing to the Amendment,None,Failed,4,228,0,7,171,13,0,8,0,0,0,0,175,241,0,15
496,R,112,H R 2219,6-Jul-2011,7:06 PM,On Agreeing to the Amendment,None,Failed,70,162,0,7,17,166,0,9,0,0,0,0,87,328,0,16
497,R,112,H R 2219,6-Jul-2011,7:09 PM,On Agreeing to the Amendment,None,Failed,7,226,0,6,145,40,0,7,0,0,0,0,152,266,0,13
498,R,112,H R 2219,6-Jul-2011,7:14 PM,On Agreeing to the Amendment,None,Agreed to,71,163,0,5,182,4,0,6,0,0,0,0,253,167,0,11
499,R,112,H R 2219,6-Jul-2011,7:20 PM,On Agreeing to the Amendment,None,Failed,17,217,0,5,81,105,0,6,0,0,0,0,98,322,0,11
500,R,112,H R 2219,6-Jul-2011,7:25 PM,On Agreeing to the Amendment,None,Agreed to,212,22,0,5,0,186,0,6,0,0,0,0,212,208,0,11
501,R,112,H R 2219,6-Jul-2011,7:30 PM,On Agreeing to the Amendment,None,Agreed to,215,19,0,5,2,185,0,5,0,0,0,0,217,204,0,10
502,R,112,H R 2219,7-Jul-2011,1:51 PM,On Agreeing to the Amendment,None,Failed,10,227,0,2,87,95,0,10,0,0,0,0,97,322,0,12
503,R,112,H R 2219,7-Jul-2011,1:57 PM,On Agreeing to the Amendment,None,Failed,13,225,0,1,120,70,0,2,0,0,0,0,133,295,0,3
504,R,112,H R 2219,7-Jul-2011,2:00 PM,On Agreeing to the Amendment,None,Failed,12,223,0,4,162,28,0,2,0,0,0,0,174,251,0,6
505,R,112,H R 2219,7-Jul-2011,2:04 PM,On Agreeing to the Amendment,None,Failed,82,156,0,1,49,141,0,2,0,0,0,0,131,297,0,3
506,R,112,H R 2219,7-Jul-2011,2:08 PM,On Agreeing to the Amendment,None,Failed,9,229,0,1,105,85,0,2,0,0,0,0,114,314,0,3
507,R,112,H R 2219,7-Jul-2011,2:11 PM,On Agreeing to the Amendment,None,Failed,61,176,0,2,149,41,0,2,0,0,0,0,210,217,0,4
508,R,112,H R 2219,7-Jul-2011,2:15 PM,On Agreeing to the Amendment,None,Failed,44,194,0,1,101,89,0,2,0,0,0,0,145,283,0,3
509,R,112,H R 2219,7-Jul-2011,2:19 PM,On Agreeing to the Amendment,None,Failed,29,207,0,3,90,99,0,3,0,0,0,0,119,306,0,6
510,R,112,H R 2219,7-Jul-2011,2:22 PM,On Agreeing to the Amendment,None,Failed,83,153,0,3,57,132,0,3,0,0,0,0,140,285,0,6
511,R,112,H R 2219,7-Jul-2011,2:27 PM,On Agreeing to the Amendment,None,Agreed to,90,148,0,1,136,53,0,3,0,0,0,0,226,201,0,4
512,R,112,H R 2219,7-Jul-2011,2:32 PM,On Agreeing to the Amendment,None,Failed,33,204,0,2,134,56,0,2,0,0,0,0,167,260,0,4
513,R,112,H R 2219,7-Jul-2011,2:39 PM,On Agreeing to the Amendment,None,Agreed to,177,60,0,2,48,141,0,3,0,0,0,0,225,201,0,5
514,R,112,H R 2219,7-Jul-2011,2:46 PM,On Agreeing to the Amendment,None,Failed,132,106,0,1,67,123,0,2,0,0,0,0,199,229,0,3
515,R,112,H R 2219,7-Jul-2011,6:18 PM,On Agreeing to the Amendment,None,Failed,130,108,0,1,46,141,0,5,0,0,0,0,176,249,0,6
516,R,112,H R 2219,7-Jul-2011,6:22 PM,On Agreeing to the Amendment,None,Agreed to,229,6,0,4,19,169,0,4,0,0,0,0,248,175,0,8
517,R,112,H R 2219,7-Jul-2011,6:27 PM,On Agreeing to the Amendment,None,Failed,65,172,0,2,70,118,0,4,0,0,0,0,135,290,0,6
518,R,112,H R 2219,7-Jul-2011,6:32 PM,On Agreeing to the Amendment,None,Agreed to,190,48,0,1,126,63,0,3,0,0,0,0,316,111,0,4
519,R,112,H R 2219,7-Jul-2011,6:36 PM,On Agreeing to the Amendment,None,Failed,62,176,0,1,27,162,0,3,0,0,0,0,89,338,0,4
520,R,112,H R 2219,7-Jul-2011,6:40 PM,On Agreeing to the Amendment,None,Failed,129,109,0,1,33,156,0,3,0,0,0,0,162,265,0,4
521,R,112,H R 2219,7-Jul-2011,6:43 PM,On Agreeing to the Amendment,None,Failed,23,215,0,1,146,42,0,4,0,0,0,0,169,257,0,5
522,R,112,H R 2219,7-Jul-2011,6:47 PM,On Agreeing to the Amendment,None,Agreed to,236,2,0,1,20,168,0,4,0,0,0,0,256,170,0,5
523,R,112,H R 2219,7-Jul-2011,6:51 PM,On Agreeing to the Amendment,None,Failed,47,190,0,2,134,54,0,4,0,0,0,0,181,244,0,6
524,R,112,H RES 268,7-Jul-2011,7:10 PM,On Motion to Suspend the Rules and Agree,"Reaffirming the United States commitment to a negotiated settlement of the Israeli-Palestinian conflict through direct Israeli-Palestinian negotiations, and for other purposes",Passed,235,3,0,1,172,3,13,4,0,0,0,0,407,6,13,5
525,R,112,H R 2219,8-Jul-2011,11:02 AM,On Agreeing to the Amendment,None,Failed,39,196,0,4,0,184,0,8,0,0,0,0,39,380,0,12
526,R,112,H R 2219,8-Jul-2011,11:06 AM,On Agreeing to the Amendment,None,Failed,54,178,0,7,64,117,0,11,0,0,0,0,118,295,0,18
527,R,112,H R 2219,8-Jul-2011,11:12 AM,On Agreeing to the Amendment,None,Failed,72,163,0,4,28,158,0,6,0,0,0,0,100,321,0,10
528,R,112,H R 2219,8-Jul-2011,11:17 AM,On Agreeing to the Amendment,None,Agreed to,227,9,0,3,9,175,0,8,0,0,0,0,236,184,0,11
529,R,112,H R 2219,8-Jul-2011,11:20 AM,On Agreeing to the Amendment,None,Failed,25,210,0,4,88,97,0,7,0,0,0,0,113,307,0,11
530,R,112,H R 2219,8-Jul-2011,11:24 AM,On Agreeing to the Amendment,None,Failed,119,116,0,4,50,135,0,7,0,0,0,0,169,251,0,11
531,R,112,H R 2219,8-Jul-2011,11:56 AM,On Motion to Recommit with Instructions,"Making appropriations for the Department of Defense for the fiscal year ending September 30, 2012, and for other purposes",Failed,3,233,0,3,185,1,0,6,0,0,0,0,188,234,0,9
532,R,112,H R 2219,8-Jul-2011,12:04 PM,On Passage,"Making appropriations for the Department of Defense for the fiscal year ending September 30, 2012, and for other purposes",Passed,224,12,0,3,112,75,0,5,0,0,0,0,336,87,0,8
533,R,112,H RES 340,8-Jul-2011,12:11 PM,On Agreeing to the Resolution,Providing for consideration of the bill (H.R. 1309) to extend the authorization of the national flood insurance program,Passed,231,0,0,8,38,146,0,8,0,0,0,0,269,146,0,16
534,R,112,H R 2354,11-Jul-2011,6:57 PM,On Agreeing to the Amendment,None,Failed,20,212,0,7,142,34,0,16,0,0,0,0,162,246,0,23
535,R,112,H R 2354,11-Jul-2011,7:01 PM,On Agreeing to the Amendment,None,Agreed to,204,26,0,9,12,164,0,16,0,0,0,0,216,190,0,25
536,R,112,H R 2354,11-Jul-2011,7:05 PM,On Agreeing to the Amendment,None,Agreed to,182,50,0,7,59,118,0,15,0,0,0,0,241,168,0,22
537,R,112,H R 2354,11-Jul-2011,7:08 PM,On Agreeing to the Amendment,None,Agreed to,216,16,0,7,2,175,0,15,0,0,0,0,218,191,0,22
538,R,112,H R 2354,11-Jul-2011,7:12 PM,On Agreeing to the Amendment,None,Failed,96,135,0,8,0,178,0,14,0,0,0,0,96,313,0,22
539,R,112,H R 2354,12-Jul-2011,2:06 PM,On Agreeing to the Amendment,None,Agreed to,222,16,0,1,2,180,0,10,0,0,0,0,224,196,0,11
540,R,112,H R 2354,12-Jul-2011,2:11 PM,On Agreeing to the Amendment,None,Failed,9,227,0,3,161,23,0,8,0,0,0,0,170,250,0,11
541,R,112,H R 2354,12-Jul-2011,2:14 PM,On Agreeing to the Amendment,None,Failed,6,230,0,3,148,36,0,8,0,0,0,0,154,266,0,11
542,R,112,H R 2354,12-Jul-2011,2:18 PM,On Agreeing to the Amendment,None,Failed,162,76,0,1,2,183,0,7,0,0,0,0,164,259,0,8
543,R,112,H R 2354,12-Jul-2011,2:23 PM,On Agreeing to the Amendment,None,Failed,10,226,0,3,163,23,0,6,0,0,0,0,173,249,0,9
544,R,112,H R 2354,12-Jul-2011,2:27 PM,On Agreeing to the Amendment,None,Failed,16,221,0,2,163,23,0,6,0,0,0,0,179,244,0,8
545,R,112,H R 2354,12-Jul-2011,2:30 PM,On Agreeing to the Amendment,None,Failed,130,107,0,2,1,185,0,6,0,0,0,0,131,292,0,8
546,R,112,H R 2354,12-Jul-2011,2:34 PM,On Agreeing to the Amendment,None,Failed,3,234,0,2,120,66,0,6,0,0,0,0,123,300,0,8
547,R,112,H R 2354,12-Jul-2011,2:38 PM,On Agreeing to the Amendment,None,Failed,125,112,0,2,2,184,0,6,0,0,0,0,127,296,0,8
548,R,112,H R 2354,12-Jul-2011,2:41 PM,On Agreeing to the Amendment,None,Failed,10,226,0,3,139,47,0,6,0,0,0,0,149,273,0,9
549,R,112,H R 2354,12-Jul-2011,2:45 PM,On Agreeing to the Amendment,None,Failed,146,91,0,2,3,183,0,6,0,0,0,0,149,274,0,8
550,R,112,H R 2354,12-Jul-2011,2:49 PM,On Agreeing to the Amendment,None,Failed,28,210,0,1,168,18,0,6,0,0,0,0,196,228,0,7
551,R,112,H R 2354,12-Jul-2011,2:53 PM,On Agreeing to the Amendment,None,Failed,117,121,0,1,2,184,0,6,0,0,0,0,119,305,0,7
552,R,112,H R 2354,12-Jul-2011,2:56 PM,On Agreeing to the Amendment,None,Failed,60,178,0,1,107,79,0,6,0,0,0,0,167,257,0,7
553,R,112,H R 2354,12-Jul-2011,3:00 PM,On Agreeing to the Amendment,None,Failed,4,233,0,2,141,43,0,8,0,0,0,0,145,276,0,10
554,R,112,H R 1309,12-Jul-2011,5:31 PM,On Agreeing to the Amendment,None,Failed,23,215,0,1,172,15,0,5,0,0,0,0,195,230,0,6
555,R,112,H R 1309,12-Jul-2011,5:36 PM,On Agreeing to the Amendment,None,Failed,111,125,0,3,7,180,0,5,0,0,0,0,118,305,0,8
556,R,112,H R 1309,12-Jul-2011,5:40 PM,On Agreeing to the Amendment,None,Agreed to,103,135,0,1,158,28,0,6,0,0,0,0,261,163,0,7
557,R,112,H R 1309,12-Jul-2011,5:44 PM,On Agreeing to the Amendment,None,Agreed to,229,9,0,1,12,174,0,6,0,0,0,0,241,183,0,7
558,R,112,H R 1309,12-Jul-2011,5:49 PM,On Agreeing to the Amendment,None,Failed,181,57,0,1,5,181,0,6,0,0,0,0,186,238,0,7
559,R,112,H R 1309,12-Jul-2011,5:52 PM,On Agreeing to the Amendment,None,Failed,21,216,0,2,171,14,0,7,0,0,0,0,192,230,0,9
560,R,112,H R 1309,12-Jul-2011,5:56 PM,On Agreeing to the Amendment,None,Failed,35,201,0,3,3,183,0,6,0,0,0,0,38,384,0,9
561,R,112,H R 1309,12-Jul-2011,6:31 PM,On Motion to Recommit with Instructions,"To extend the authorization of the national flood insurance program, to achieve reforms to improve the financial integrity and stability of the program, and to increase the role of private markets in the management of flood insurance risk, and for other purposes",Failed,3,235,0,1,178,9,0,5,0,0,0,0,181,244,0,6
562,R,112,H R 1309,12-Jul-2011,6:39 PM,On Passage,"To extend the authorization of the national flood insurance program, to achieve reforms to improve the financial integrity and stability of the program, and to increase the role of private markets in the management of flood insurance risk, and for other purposes",Passed,218,21,0,0,188,1,0,3,0,0,0,0,406,22,0,3
563,R,112,H R 2417,12-Jul-2011,6:45 PM,On Motion to Suspend the Rules and Pass,Better Use of Light Bulbs Act,Failed,228,10,1,0,5,183,0,4,0,0,0,0,233,193,1,4
564,R,112,H RES 347,13-Jul-2011,2:29 PM,On Agreeing to the Resolution,"Providing for consideration of the bill (H.R. 2018), to amend the Federal Water Pollution Control Act to preserve the authority of each State to make determinations relating to the State’s water quality standards, and for other purposes",Passed,238,0,0,1,12,171,0,9,0,0,0,0,250,171,0,10
565,R,112,H R 2018,13-Jul-2011,5:53 PM,On Agreeing to the Amendment,None,Failed,0,236,0,3,170,16,0,6,0,0,0,0,170,252,0,9
566,R,112,H R 2018,13-Jul-2011,6:02 PM,On Agreeing to the Amendment,None,Agreed to,233,1,0,5,35,151,0,6,0,0,0,0,268,152,0,11
567,R,112,H R 2018,13-Jul-2011,6:06 PM,On Agreeing to the Amendment,None,Failed,17,219,0,3,174,12,0,6,0,0,0,0,191,231,0,9
568,R,112,H R 2018,13-Jul-2011,6:10 PM,On Agreeing to the Amendment,None,Failed,11,225,0,3,170,15,0,7,0,0,0,0,181,240,0,10
569,R,112,H R 2018,13-Jul-2011,6:14 PM,On Agreeing to the Amendment,None,Failed,10,225,0,4,173,12,0,7,0,0,0,0,183,237,0,11
570,R,112,H R 2018,13-Jul-2011,6:18 PM,On Agreeing to the Amendment,None,Failed,2,233,0,4,171,14,0,7,0,0,0,0,173,247,0,11
571,R,112,H R 2018,13-Jul-2011,6:22 PM,On Agreeing to the Amendment,None,Failed,0,235,0,4,167,19,0,6,0,0,0,0,167,254,0,10
572,R,112,H R 2018,13-Jul-2011,6:49 PM,On Motion to Recommit with Instructions,"To amend the Federal Water Pollution Control Act to preserve the authority of each State to make determinations relating to the State’s water quality standards, and for other purposes",Failed,1,237,0,1,187,1,0,4,0,0,0,0,188,238,0,5
573,R,112,H R 2018,13-Jul-2011,6:56 PM,On Passage,"To amend the Federal Water Pollution Control Act to preserve the authority of each State to make determinations relating to the State’s water quality standards, and for other purposes",Passed,223,13,0,3,16,171,0,5,0,0,0,0,239,184,0,8
574,R,112,H R 2354,14-Jul-2011,2:42 PM,On Agreeing to the Amendment,None,Failed,6,233,0,0,162,24,0,6,0,0,0,0,168,257,0,6
575,R,112,H R 2354,14-Jul-2011,2:47 PM,On Agreeing to the Amendment,None,Agreed to,106,131,0,2,155,31,0,6,0,0,0,0,261,162,0,8
576,R,112,H R 2354,14-Jul-2011,2:51 PM,On Agreeing to the Amendment,None,Failed,6,232,0,1,158,29,0,5,0,0,0,0,164,261,0,6
577,R,112,H R 2354,14-Jul-2011,2:54 PM,On Agreeing to the Amendment,None,Failed,134,104,0,1,2,187,0,3,0,0,0,0,136,291,0,4
578,R,112,H R 2354,14-Jul-2011,2:58 PM,On Agreeing to the Amendment,None,Failed,98,140,0,1,1,188,0,3,0,0,0,0,99,328,0,4
579,R,112,H R 2354,14-Jul-2011,3:01 PM,On Agreeing to the Amendment,None,Agreed to,34,205,0,0,180,8,0,4,0,0,0,0,214,213,0,4
580,R,112,H R 2354,14-Jul-2011,3:04 PM,On Agreeing to the Amendment,None,Failed,112,125,0,2,2,184,0,6,0,0,0,0,114,309,0,8
581,R,112,H R 2354,14-Jul-2011,3:08 PM,On Agreeing to the Amendment,None,Agreed to,231,8,0,0,66,122,0,4,0,0,0,0,297,130,0,4
582,R,112,H R 2354,14-Jul-2011,3:12 PM,On Agreeing to the Amendment,None,Failed,181,57,0,1,6,182,0,4,0,0,0,0,187,239,0,5
583,R,112,H R 2354,15-Jul-2011,11:07 AM,On Agreeing to the Amendment,None,Agreed to,231,3,0,5,18,166,0,8,0,0,0,0,249,169,0,13
584,R,112,H R 2354,15-Jul-2011,11:12 AM,On Agreeing to the Amendment,None,Failed,8,228,0,3,150,36,0,6,0,0,0,0,158,264,0,9
585,R,112,H R 2354,15-Jul-2011,11:18 AM,On Agreeing to the Amendment,None,Failed,182,53,0,4,1,185,0,6,0,0,0,0,183,238,0,10
586,R,112,H R 2354,15-Jul-2011,11:23 AM,On Agreeing to the Amendment,None,Agreed to,33,203,0,3,179,7,0,6,0,0,0,0,212,210,0,9
587,R,112,H R 2354,15-Jul-2011,11:27 AM,On Agreeing to the Amendment,None,Failed,81,155,0,3,0,186,0,6,0,0,0,0,81,341,0,9
588,R,112,H R 2354,15-Jul-2011,11:32 AM,On Agreeing to the Amendment,None,Failed,1,235,0,3,151,34,0,7,0,0,0,0,152,269,0,10
589,R,112,H R 2354,15-Jul-2011,11:36 AM,On Agreeing to the Amendment,None,Failed,45,190,0,4,23,163,0,6,0,0,0,0,68,353,0,10
590,R,112,H R 2354,15-Jul-2011,11:39 AM,On Agreeing to the Amendment,None,Agreed to,161,73,0,5,110,75,0,7,0,0,0,0,271,148,0,12
591,R,112,H R 2354,15-Jul-2011,11:42 AM,On Agreeing to the Amendment,None,Failed,69,168,0,2,0,186,0,6,0,0,0,0,69,354,0,8
592,R,112,H R 2354,15-Jul-2011,11:46 AM,On Agreeing to the Amendment,None,Failed,90,146,0,3,0,186,0,6,0,0,0,0,90,332,0,9
593,R,112,H R 2354,15-Jul-2011,11:49 AM,On Agreeing to the Amendment,None,Agreed to,227,7,0,5,0,186,0,6,0,0,0,0,227,193,0,11
594,R,112,H R 2354,15-Jul-2011,11:52 AM,On Agreeing to the Amendment,None,Failed,128,107,0,4,1,185,0,6,0,0,0,0,129,292,0,10
595,R,112,H R 2354,15-Jul-2011,11:55 AM,On Agreeing to the Amendment,None,Failed,147,89,0,3,3,183,0,6,0,0,0,0,150,272,0,9
596,R,112,H R 2354,15-Jul-2011,11:59 AM,On Agreeing to the Amendment,None,Agreed to,226,10,0,3,10,175,0,7,0,0,0,0,236,185,0,10
597,R,112,H R 2354,15-Jul-2011,12:02 PM,On Agreeing to the Amendment,None,Failed,62,172,0,5,6,179,0,7,0,0,0,0,68,351,0,12
598,R,112,H R 2354,15-Jul-2011,12:10 PM,On Agreeing to the Amendment,None,Failed,181,49,0,9,0,184,0,8,0,0,0,0,181,233,0,17
599,R,112,H R 2354,15-Jul-2011,12:36 PM,On Motion to Recommit with Instructions,"Making appropriations for energy and water development and related agencies for the fiscal year ending September 30, 2012, and for other purposes",Failed,0,232,0,7,182,0,0,10,0,0,0,0,182,232,0,17
600,R,112,H R 2354,15-Jul-2011,12:42 PM,On Passage,"Making appropriations for energy and water development and related agencies for the fiscal year ending September 30, 2012, and for other purposes",Passed,209,21,0,9,10,175,0,7,0,0,0,0,219,196,0,16
601,R,112,H R 33,18-Jul-2011,6:58 PM,"On Motion to Suspend the Rules and Pass, as Amended",Church Plan Investment Clarification Act,Passed,181,1,0,57,129,0,0,63,0,0,0,0,310,1,0,120
602,R,112,JOURNAL,18-Jul-2011,7:05 PM,On Approving the Journal,None,Passed,149,29,1,60,95,27,0,70,0,0,0,0,244,56,1,130
603,R,112,H RES 355,19-Jul-2011,2:19 PM,On Ordering the Previous Question,"Providing for consideration of the bill (H.R. 2560) to cut, cap, and balance the Federal budget",Passed,233,0,0,6,2,175,0,15,0,0,0,0,235,175,0,21
604,R,112,H RES 355,19-Jul-2011,2:39 PM,On Agreeing to the Resolution,"Providing for consideration of the bill (H.R. 2560) to cut, cap, and balance the Federal budget",Passed,234,0,0,5,2,177,0,14,0,0,0,0,236,177,0,19
605,R,112,H R 2560,19-Jul-2011,8:17 PM,On Motion to Recommit with Instructions,"Cut, Cap, and Balance Act",Failed,1,236,0,2,187,0,0,6,0,0,0,0,188,236,0,8
606,R,112,H R 2560,19-Jul-2011,8:23 PM,On Passage,"Cut, Cap, and Balance Act",Passed,229,9,0,1,5,181,0,7,0,0,0,0,234,190,0,8
607,R,112,JOURNAL,19-Jul-2011,8:29 PM,On Approving the Journal,None,Passed,197,34,1,7,107,78,0,8,0,0,0,0,304,112,1,15
608,R,112,H RES 357,20-Jul-2011,1:30 PM,On Ordering the Previous Question,"Providing for consideration of the bill (H.R. 2553) to amend the Internal Revenue Code of 1986 to extend the funding and expenditure authority of the Airport and Airway Trust Fund, to amend title 49, United States Code, to extend the airport improvement program, and for other purposes",Passed,236,0,0,3,3,183,0,7,0,0,0,0,239,183,0,10
609,R,112,H RES 357,20-Jul-2011,1:37 PM,On Agreeing to the Resolution,"Providing for consideration of the bill (H.R. 2553) to amend the Internal Revenue Code of 1986 to extend the funding and expenditure authority of the Airport and Airway Trust Fund, to amend title 49, United States Code, to extend the airport improvement program, and for other purposes",Passed,234,2,0,3,8,176,0,9,0,0,0,0,242,178,0,12
610,R,112,H R 2553,20-Jul-2011,3:13 PM,On Motion to Recommit with Instructions,"To amend the Internal Revenue Code of 1986 to extend the funding and expenditure authority of the Airport and Airway Trust Fund, to amend title 49, United States Code, to extend the airport improvement program, and for other purposes",Failed,3,233,0,3,184,0,0,9,0,0,0,0,187,233,0,12
611,R,112,H R 2553,20-Jul-2011,3:23 PM,On Passage,"To amend the Internal Revenue Code of 1986 to extend the funding and expenditure authority of the Airport and Airway Trust Fund, to amend title 49, United States Code, to extend the airport improvement program, and for other purposes",Passed,230,6,0,3,13,171,0,9,0,0,0,0,243,177,0,12
612,R,112,H RES 358,21-Jul-2011,1:07 PM,On Question of Consideration of the Resolution,"Providing for consideration of the bill (H.R. 1315) to amend the Dodd-Frank Wall Street Reform and Consumer Protection Act to strengthen the review authority of the Financial Stability Oversight Council of regulations issued by the Bureau of Consumer Financial Protection, and for other purposes",Passed,224,0,0,15,3,173,0,17,0,0,0,0,227,173,0,32
613,R,112,H RES 359,21-Jul-2011,3:13 PM,On Agreeing to the Resolution,"Providing for consideration of the bill (H.R. 2551) making appropriations for the Legislative Branch for the fiscal year ending September 30, 2012, and for other purposes",Passed,230,0,0,9,9,172,0,12,0,0,0,0,239,172,0,21
614,R,112,H RES 358,21-Jul-2011,3:21 PM,On Agreeing to the Resolution,"Providing for consideration of the bill (H.R. 1315) to amend the Dodd-Frank Wall Street Reform and Consumer Protection Act to strengthen the review authority of the Financial Stability Oversight Council of regulations issued by the Bureau of Consumer Financial Protection, and for other purposes",Passed,232,0,0,7,6,177,0,10,0,0,0,0,238,177,0,17
615,R,112,H R 1315,21-Jul-2011,6:29 PM,On Agreeing to the Amendment,None,Failed,1,228,0,10,169,11,0,13,0,0,0,0,170,239,0,23
616,R,112,H R 1315,21-Jul-2011,6:34 PM,On Agreeing to the Amendment,None,Failed,1,231,0,7,174,7,0,12,0,0,0,0,175,238,0,19
617,R,112,H R 1315,21-Jul-2011,6:37 PM,On Agreeing to the Amendment,None,Failed,2,230,0,7,173,10,0,10,0,0,0,0,175,240,0,17
618,R,112,H R 1315,21-Jul-2011,6:41 PM,On Agreeing to the Amendment,None,Failed,2,229,0,8,166,15,0,12,0,0,0,0,168,244,0,20
619,R,112,H R 1315,21-Jul-2011,6:45 PM,On Agreeing to the Amendment,None,Agreed to,229,2,0,8,17,165,0,11,0,0,0,0,246,167,0,19
620,R,112,H R 1315,21-Jul-2011,7:19 PM,On Motion to Recommit with Instructions,To amend the Dodd-Frank Wall Street Reform and Consumer Protection Act to strengthen the review authority of the Financial Stability Oversight Council of regulations issued by the Bureau of Consumer Financial Protection,Failed,1,231,0,7,182,1,0,10,0,0,0,0,183,232,0,17
621,R,112,H R 1315,21-Jul-2011,7:27 PM,On Passage,To amend the Dodd-Frank Wall Street Reform and Consumer Protection Act to strengthen the review authority of the Financial Stability Oversight Council of regulations issued by the Bureau of Consumer Financial Protection,Passed,231,1,0,7,10,172,0,11,0,0,0,0,241,173,0,18
622,R,112,H R 2551,22-Jul-2011,10:37 AM,On Agreeing to the Amendment,None,Failed,73,156,0,10,29,146,7,11,0,0,0,0,102,302,7,21
623,R,112,H R 2551,22-Jul-2011,10:41 AM,On Agreeing to the Amendment,None,Agreed to,226,3,0,10,73,109,0,11,0,0,0,0,299,112,0,21
624,R,112,H R 2551,22-Jul-2011,10:46 AM,On Agreeing to the Amendment,None,Failed,142,88,0,9,11,172,0,10,0,0,0,0,153,260,0,19
625,R,112,H R 2551,22-Jul-2011,10:51 AM,On Agreeing to the Amendment,None,Agreed to,177,52,0,10,41,142,0,10,0,0,0,0,218,194,0,20
626,R,112,H R 2551,22-Jul-2011,10:57 AM,On Agreeing to the Amendment,None,Failed,126,104,0,9,4,179,0,10,0,0,0,0,130,283,0,19
627,R,112,H R 2551,22-Jul-2011,11:02 AM,On Agreeing to the Amendment,None,Failed,11,218,0,10,165,17,0,11,0,0,0,0,176,235,0,21
628,R,112,H R 2551,22-Jul-2011,11:06 AM,On Agreeing to the Amendment,None,Failed,8,222,0,9,171,12,0,10,0,0,0,0,179,234,0,19
629,R,112,H R 2551,22-Jul-2011,11:25 AM,On Passage,"Making appropriations for the Legislative Branch for the fiscal year ending September 30, 2012, and for other purposes.",Passed,213,16,0,10,39,143,0,11,0,0,0,0,252,159,0,21
630,R,112,H RES 363,25-Jul-2011,1:37 PM,On Agreeing to the Resolution,"Providing for consideration of H.R. 2584, making appropriations for the Department of the Interior, environment, and related agencies for the fiscal year ending September 30, 2012, and for other purposes",Passed,204,0,0,35,1,131,0,61,0,0,0,0,205,131,0,96
631,R,112,JOURNAL,25-Jul-2011,1:47 PM,On Approving the Journal,None,Passed,166,40,2,31,67,68,0,58,0,0,0,0,233,108,2,89
632,R,112,H R 2584,25-Jul-2011,6:37 PM,On Agreeing to the Amendment,None,Failed,6,227,0,6,169,10,0,14,0,0,0,0,175,237,0,20
633,R,112,H R 2584,25-Jul-2011,6:44 PM,On Agreeing to the Amendment,None,Failed,126,105,0,8,0,179,0,14,0,0,0,0,126,284,0,22
634,R,112,H R 2584,25-Jul-2011,6:50 PM,On Agreeing to the Amendment,None,Failed,8,225,0,6,157,23,0,13,0,0,0,0,165,248,0,19
635,R,112,H R 2584,25-Jul-2011,6:56 PM,On Agreeing to the Amendment,None,Agreed to,56,177,0,6,165,15,0,13,0,0,0,0,221,192,0,19
636,R,112,H R 2584,25-Jul-2011,7:03 PM,On Agreeing to the Amendment,None,Failed,0,233,0,6,141,38,0,14,0,0,0,0,141,271,0,20
637,R,112,H RES 370,26-Jul-2011,1:36 PM,On Agreeing to the Resolution,"Providing for consideration of H. R. 1938, North American-Made Energy Security Act",Passed,235,0,0,4,11,171,0,11,0,0,0,0,246,171,0,15
638,R,112,H R 1383,26-Jul-2011,1:44 PM,On Motion to Suspend the Rules and Concur in the Senate Amendments,Restoring GI Bill Fairness Act of 2011,Passed,237,0,0,2,187,0,0,6,0,0,0,0,424,0,0,8
639,R,112,JOURNAL,26-Jul-2011,1:50 PM,On Approving the Journal,None,Passed,193,42,2,2,120,69,0,4,0,0,0,0,313,111,2,6
640,R,112,H R 1938,26-Jul-2011,5:31 PM,On Agreeing to the Amendment,None,Failed,3,232,0,4,161,28,0,4,0,0,0,0,164,260,0,8
641,R,112,H R 1938,26-Jul-2011,5:38 PM,On Agreeing to the Amendment,None,Failed,2,235,1,1,162,26,0,5,0,0,0,0,164,261,1,6
642,R,112,H R 1938,26-Jul-2011,5:42 PM,On Agreeing to the Amendment,None,Failed,4,233,0,2,159,31,0,3,0,0,0,0,163,264,0,5
643,R,112,H R 1938,26-Jul-2011,5:46 PM,On Agreeing to the Amendment,None,Failed,0,237,0,2,155,35,0,3,0,0,0,0,155,272,0,5
644,R,112,H R 1938,26-Jul-2011,5:50 PM,On Agreeing to the Amendment,None,Failed,1,237,0,1,151,38,0,4,0,0,0,0,152,275,0,5
645,R,112,H R 1938,26-Jul-2011,5:55 PM,On Agreeing to the Amendment,None,Failed,4,233,0,2,157,32,0,4,0,0,0,0,161,265,0,6
646,R,112,H R 1938,26-Jul-2011,5:58 PM,On Agreeing to the Amendment,None,Failed,5,233,0,1,163,27,0,3,0,0,0,0,168,260,0,4
647,R,112,H R 1938,26-Jul-2011,6:04 PM,On Agreeing to the Amendment,None,Failed,1,235,0,3,162,28,0,3,0,0,0,0,163,263,0,6
648,R,112,H R 1938,26-Jul-2011,6:07 PM,On Agreeing to the Amendment,None,Failed,8,228,0,3,156,33,0,4,0,0,0,0,164,261,0,7
649,R,112,H R 1938,26-Jul-2011,6:38 PM,On Motion to Recommit with Instructions,North American-Made Energy Security Act,Failed,1,237,0,1,180,11,0,2,0,0,0,0,181,248,0,3
650,R,112,H R 1938,26-Jul-2011,6:45 PM,On Passage,North American-Made Energy Security Act,Passed,232,3,1,3,47,144,0,2,0,0,0,0,279,147,1,5
651,R,112,H R 2584,27-Jul-2011,1:40 PM,On Agreeing to the Amendment,None,Failed,15,220,0,4,158,31,0,4,0,0,0,0,173,251,0,8
652,R,112,H R 2584,27-Jul-2011,1:45 PM,On Agreeing to the Amendment,None,Agreed to,37,200,0,2,187,2,0,4,0,0,0,0,224,202,0,6
653,R,112,H R 2584,27-Jul-2011,1:49 PM,On Agreeing to the Amendment,None,Failed,39,196,0,4,145,42,0,6,0,0,0,0,184,238,0,10
654,R,112,H R 2584,27-Jul-2011,1:53 PM,On Agreeing to the Amendment,None,Failed,123,113,1,2,8,181,0,4,0,0,0,0,131,294,1,6
655,R,112,H R 2584,27-Jul-2011,1:56 PM,On Agreeing to the Amendment,None,Failed,68,169,0,2,69,122,0,2,0,0,0,0,137,291,0,4
656,R,112,H R 2584,27-Jul-2011,2:02 PM,On Agreeing to the Amendment,None,Agreed to,158,78,0,3,79,111,0,3,0,0,0,0,237,189,0,6
657,R,112,H R 2584,27-Jul-2011,2:06 PM,On Agreeing to the Amendment,None,Agreed to,212,25,0,2,3,188,0,2,0,0,0,0,215,213,0,4
658,R,112,H R 2584,27-Jul-2011,6:29 PM,On Agreeing to the Amendment,None,Failed,2,228,0,9,172,9,0,12,0,0,0,0,174,237,0,21
659,R,112,H R 2584,27-Jul-2011,6:36 PM,On Agreeing to the Amendment,None,Failed,9,226,0,4,165,24,0,4,0,0,0,0,174,250,0,8
660,R,112,H R 2584,27-Jul-2011,6:43 PM,On Agreeing to the Amendment,None,Agreed to,176,61,0,2,44,145,0,4,0,0,0,0,220,206,0,6
661,R,112,H R 2584,27-Jul-2011,6:49 PM,On Agreeing to the Amendment,None,Agreed to,224,13,0,2,11,178,0,4,0,0,0,0,235,191,0,6
662,R,112,H R 2584,27-Jul-2011,6:56 PM,On Agreeing to the Amendment,None,Failed,51,185,0,3,142,47,0,4,0,0,0,0,193,232,0,7
663,R,112,H RES 375,28-Jul-2011,2:01 PM,On Agreeing to the Resolution,"Providing for consideration of S. 627, to establish the Commission on Freedom of Information Act Processing Delays, and for other purposes",Passed,238,0,0,1,0,186,0,7,0,0,0,0,238,186,0,8
664,R,112,H R 2584,28-Jul-2011,2:20 PM,On Agreeing to the Amendment,None,Failed,114,124,0,1,0,190,0,3,0,0,0,0,114,314,0,4
665,R,112,H R 2584,28-Jul-2011,2:26 PM,On Agreeing to the Amendment,None,Failed,11,226,0,2,157,32,0,4,0,0,0,0,168,258,0,6
666,R,112,H R 2584,28-Jul-2011,2:32 PM,On Agreeing to the Amendment,None,Failed,157,80,0,2,4,183,0,6,0,0,0,0,161,263,0,8
667,R,112,H R 2584,28-Jul-2011,2:39 PM,On Agreeing to the Amendment,None,Failed,82,155,0,2,48,140,0,5,0,0,0,0,130,295,0,7
668,R,112,H R 2584,28-Jul-2011,2:45 PM,On Agreeing to the Amendment,None,Failed,195,40,0,4,3,187,0,3,0,0,0,0,198,227,0,7
669,R,112,H R 2584,28-Jul-2011,2:51 PM,On Agreeing to the Amendment,None,Failed,110,128,0,1,0,189,0,4,0,0,0,0,110,317,0,5
670,R,112,H R 2584,28-Jul-2011,2:58 PM,On Agreeing to the Amendment,None,Failed,181,55,1,2,0,185,0,8,0,0,0,0,181,240,1,10
671,R,112,H RES 382,29-Jul-2011,3:34 PM,On Ordering the Previous Question,Waiving a requirement of clause 6(a) of rule XIII with respect to consideration of certain resolutions reported from the Committee on Rules,Passed,237,0,0,2,0,185,0,8,0,0,0,0,237,185,0,10
672,R,112,H RES 382,29-Jul-2011,3:40 PM,On Agreeing to the Resolution,Waiving a requirement of clause 6(a) of rule XIII with respect to consideration of certain resolutions reported from the Committee on Rules,Passed,236,0,0,3,0,186,0,7,0,0,0,0,236,186,0,10
673,R,112,H R 440,29-Jul-2011,3:46 PM,"On Motion to Suspend the Rules and Pass, as Amended",To provide for the establishment of the Special Envoy to Promote Religious Freedom of Religious Minorities in the Near East and South Central Asia,Passed,216,20,0,3,186,0,0,7,0,0,0,0,402,20,0,10
674,R,112,H R 2244,29-Jul-2011,3:53 PM,On Motion to Suspend the Rules and Pass,"To designate the facility of the United States Postal Service located at 67 Castle Street in Geneva, New York, as the “Corporal Steven Blaine Riccione Post Office”.",Passed,235,0,1,3,183,1,0,9,0,0,0,0,418,1,1,12
675,R,112,H RES 383,29-Jul-2011,5:35 PM,On Agreeing to the Resolution,Providing for further consideration of the bill (S. 627) to establish the Commission on Freedom of Information Act Processing Delays,Passed,239,0,0,0,0,187,0,6,0,0,0,0,239,187,0,6
676,R,112,S 627,29-Jul-2011,6:09 PM,On Motion to Recommit with Instructions,Budget Control Act of 2011,Failed,1,238,0,0,182,6,0,5,0,0,0,0,183,244,0,5
677,R,112,S 627,29-Jul-2011,6:25 PM,On Passage,Budget Control Act of 2011,Passed,218,22,0,0,0,188,0,5,0,0,0,0,218,210,0,5
678,R,112,H R 2213,29-Jul-2011,6:39 PM,On Motion to Suspend the Rules and Pass,"To designate the facility of the United States Postal Service located at 801 West Eastport Street in Iuka, Mississippi, as the “Sergeant Jason W. Vaughn Post Office”.",Passed,236,0,0,3,184,0,0,9,0,0,0,0,420,0,0,12
679,R,112,H R 1975,30-Jul-2011,1:27 PM,On Motion to Suspend the Rules and Pass,"To designate the facility of the United States Postal Service located at 281 East Colorado Boulevard in Pasadena, California, as the “First Lieutenant Oliver Goodall Post Office Building”",Passed,234,0,0,5,182,0,0,11,0,0,0,0,416,0,0,16
680,R,112,H R 1843,30-Jul-2011,1:33 PM,On Motion to Suspend the Rules and Pass,"To designate the facility of the United States Postal Service located at 489 Army Drive in Barrigada, Guam, as the “John Pangelinan Gerber Post Office Building”",Passed,231,3,0,5,183,0,0,10,0,0,0,0,414,3,0,15
681,R,112,JOURNAL,30-Jul-2011,1:40 PM,On Approving the Journal,None,Passed,181,49,2,7,117,64,0,12,0,0,0,0,298,113,2,19
682,R,112,H R 2693,30-Jul-2011,3:13 PM,"On Motion to Suspend the Rules and Pass, as Amended","To cut spending, maintain existing commitments, and for other purposes",Failed,0,235,0,4,173,11,0,9,0,0,0,0,173,246,0,13
683,R,112,H R 2715,1-Aug-2011,2:28 PM,On Motion to Suspend the Rules and Pass,"To provide the Consumer Product Safety Commission with greater authority and discretion in enforcing the consumer product safety laws, and for other purposes",Passed,236,0,0,3,185,2,0,6,0,0,0,0,421,2,0,9
684,R,112,H R 398,1-Aug-2011,2:46 PM,On Motion to Suspend the Rules and Pass,"To amend the Immigration and Nationality Act to toll, during active-duty service abroad in the Armed Forces, the periods of time to file a petition and appear for an interview to remove the conditional basis for permanent resident status, and for other purposes",Passed,238,0,0,1,188,0,0,5,0,0,0,0,426,0,0,6
685,R,112,H R 1933,1-Aug-2011,2:54 PM,"On Motion to Suspend the Rules and Pass, as Amended",To amend the Immigration and Nationality Act to modify the requirements for admission of nonimmigrant nurses in health professional shortage areas,Passed,220,16,0,3,187,1,0,5,0,0,0,0,407,17,0,8
686,R,112,H RES 384,1-Aug-2011,4:32 PM,On Ordering the Previous Question,"Providing for consideration of S. 365, to make a technical amendment to the Education Sciences Reform Act of 2002",Passed,238,0,0,1,4,184,0,5,0,0,0,0,242,184,0,6
687,R,112,H RES 384,1-Aug-2011,4:48 PM,On Agreeing to the Resolution,"Providing for consideration of S. 365, to make a technical amendment to the Education Sciences Reform Act of 2002",Passed,239,0,0,0,10,178,0,5,0,0,0,0,249,178,0,5
688,R,112,JOURNAL,1-Aug-2011,5:00 PM,On Approving the Journal,None,Passed,194,41,1,3,110,74,0,9,0,0,0,0,304,115,1,12
689,R,112,QUORUM,1-Aug-2011,6:51 PM,Call of the House,None,Passed,0,0,238,1,0,0,181,12,0,0,0,0,0,0,419,13
690,R,112,S 365,1-Aug-2011,7:09 PM,On Passage,To make a technical amendment to the Education Sciences Reform Act of 2002,Passed,174,66,0,0,95,95,0,3,0,0,0,0,269,161,0,3
691,R,112,H R 2480,1-Aug-2011,7:33 PM,"On Motion to Suspend the Rules and Pass, as Amended",Administration Conference of the United States Reauthorization Act of 2011,Passed,201,23,0,15,181,0,0,12,0,0,0,0,382,23,0,27
692,R,112,H CON RES 67,7-Sep-2011,6:54 PM,On Motion to Suspend the Rules and Agree,Authorizing the use of the Capitol Grounds for the District of Columbia Special Olympics Law Enforcement Torch Run,Passed,217,0,0,22,162,0,0,30,0,0,0,0,379,0,0,52
693,R,112,H RES 392,8-Sep-2011,1:58 PM,On Ordering the Previous Question,"Providing for consideration of H.R. 2218, to amend the charter school program under the Elementary and Secondary Education Act; and for consideration of H.R. 1892, to authorize appropriations for FY 2012 for intelligence activities of the U.S. Government, the Community Management Account, and the CIA Retirement System",Passed,224,0,0,15,2,176,0,14,0,0,0,0,226,176,0,29
694,R,112,H RES 392,8-Sep-2011,2:04 PM,On Agreeing to the Resolution,"Providing for consideration of H.R. 2218, to amend the charter school program under the Elementary and Secondary Education Act; and for consideration of H.R. 1892, to authorize appropriations for FY 2012 for intelligence activities of the U.S. Government, the Community Management Account, and the CIA Retirement System",Passed,220,0,0,19,17,163,0,12,0,0,0,0,237,163,0,31
695,R,112,H R 1892,9-Sep-2011,10:53 AM,On Agreeing to the Amendment,None,Agreed to,220,0,0,19,177,0,0,15,0,0,0,0,397,0,0,34
696,R,112,H R 1892,9-Sep-2011,11:00 AM,On Agreeing to the Amendment,None,Agreed to,126,92,0,21,177,0,0,15,0,0,0,0,303,92,0,36
697,R,112,H R 1892,9-Sep-2011,11:32 AM,On Motion to Recommit with Instructions,Intelligence Authorization Act for Fiscal Year 2012,Failed,0,221,0,18,145,36,0,11,0,0,0,0,145,257,0,29
698,R,112,H R 1892,9-Sep-2011,11:38 AM,On Passage,Intelligence Authorization Act for Fiscal Year 2012,Passed,217,3,0,19,167,11,0,14,0,0,0,0,384,14,0,33
699,R,112,H R 2076,12-Sep-2011,6:57 PM,"On Motion to Suspend the Rules and Pass, as Amended",Investigative Assistance for Violent Crimes Act,Passed,204,9,0,26,154,0,0,38,0,0,0,0,358,9,0,64
700,R,112,H R 2633,12-Sep-2011,7:04 PM,"On Motion to Suspend the Rules and Pass, as Amended",Appeal Time Clarification Act,Passed,222,0,0,17,162,0,0,30,0,0,0,0,384,0,0,47
701,R,112,H R 1059,12-Sep-2011,7:11 PM,On Motion to Suspend the Rules and Pass,"To protect the safety of judges by extending the authority of the Judicial Conference to redact sensitve information contained in their financial disclosure reports, and for other purposes",Passed,223,0,0,16,161,0,0,31,0,0,0,0,384,0,0,47
702,R,112,H R 2218,13-Sep-2011,1:44 PM,On Agreeing to the Amendment,None,Failed,15,218,0,6,180,2,0,10,0,0,0,0,195,220,0,16
703,R,112,H R 2218,13-Sep-2011,1:50 PM,On Agreeing to the Amendment,None,Failed,43,189,0,7,0,185,0,7,0,0,0,0,43,374,0,14
704,R,112,H R 2218,13-Sep-2011,2:19 PM,On Motion to Recommit with Instructions,Empowering Parents through Quality Charter Schools Act,Failed,1,231,0,7,188,0,0,4,0,0,0,0,189,231,0,11
705,R,112,H R 2218,13-Sep-2011,2:27 PM,On Passage,Empowering Parents through Quality Charter Schools Act,Passed,219,13,0,7,146,41,0,5,0,0,0,0,365,54,0,12
706,R,112,H J RES 77,14-Sep-2011,3:02 PM,On Passage,"Relating to the disapproval of the President’s exercise of authority to increase the debt limit, as submitted under section 3101A of title 31, United States Code, on August 2, 2011",Passed,228,5,2,4,4,181,0,7,0,0,0,0,232,186,2,11
707,R,112,H RES 372,15-Sep-2011,10:46 AM,On Ordering the Previous Question,"Providing for consideration of H.R. 2587, the Protecting Jobs From Government Interference Act.",Passed,230,0,0,9,4,177,0,11,0,0,0,0,234,177,0,20
708,R,112,H RES 372,15-Sep-2011,11:06 AM,On Agreeing to the Resolution,"Providing for consideration of H.R. 2587, the Protecting Jobs From Government Interference Act.",Passed,233,0,0,8,6,176,0,10,0,0,0,0,239,176,0,18
709,R,112,H R 2867,15-Sep-2011,11:14 AM,"On Motion to Suspend the Rules and Pass, as Amended","To reauthorize the International Religious Freedom Act of 1998, and for other purposes",Passed,208,21,0,12,183,0,0,9,0,0,0,0,391,21,0,21
710,R,112,H R 2587,15-Sep-2011,1:12 PM,On Motion to Recommit with Instructions,Protecting Jobs From Government Interference Act,Failed,2,235,0,4,187,0,0,5,0,0,0,0,189,235,0,9
711,R,112,H R 2587,15-Sep-2011,1:22 PM,On Passage,Protecting Jobs From Government Interference Act,Passed,230,7,0,4,8,179,0,5,0,0,0,0,238,186,0,9
712,R,112,H R 2944,20-Sep-2011,6:54 PM,On Motion to Suspend the Rules and Pass,United States Parole Commission Extension Act of 2011,Passed,232,0,0,9,183,0,0,9,0,0,0,0,415,0,0,18
713,R,112,H R 2189,20-Sep-2011,7:03 PM,On Motion to Suspend the Rules and Pass,Death in Custody Reporting Act of 2011,Passed,214,18,0,9,184,0,0,8,0,0,0,0,398,18,0,17
714,R,112,H R 2646,20-Sep-2011,7:10 PM,"On Motion to Suspend the Rules and Pass, as Amended","To authorize certain Department of Veterans Affairs major medical facility projects and leases, to extend certain expiring provisions of law, and to modify certain authorities of the Secretary of Veterans Affairs, and for other purposes",Passed,228,3,0,10,184,0,0,8,0,0,0,0,412,3,0,18
715,R,112,H RES 405,21-Sep-2011,3:30 PM,On Ordering the Previous Question,"Providing for consideration of the Senate amendment to the bill (H.R. 2608) to provide for an additional temporary extension of programs under the Small Business Act and the Small Business Investment Act of 1958, and for other purposes",Passed,237,0,0,4,0,188,0,4,0,0,0,0,237,188,0,8
716,R,112,H RES 405,21-Sep-2011,3:37 PM,On Agreeing to the Resolution,"Providing for consideration of the Senate amendment to the bill (H.R. 2608) to provide for an additional temporary extension of programs under the Small Business Act and the Small Business Investment Act of 1958, and for other purposes",Passed,237,0,0,4,1,185,0,6,0,0,0,0,238,185,0,10
717,R,112,S CON RES 28,21-Sep-2011,3:46 PM,On Motion to Suspend the Rules and Agree,"Authorizing the use of Emancipation Hall in the Capitol Visitor Center for an event to award the Congressional Gold Medal, collectively, to the 100th Infantry Battalion, 442nd Regimental Combat Team, and the Military Intelligence Service, United States Army, in recognition of their dedicated service during World War II",Passed,238,0,0,3,186,0,0,6,0,0,0,0,424,0,0,9
718,R,112,S 846,21-Sep-2011,3:52 PM,On Motion to Suspend the Rules and Pass,"To designate the United States courthouse located at 80 Lafayette Street in Jefferson City, Missouri, as the Christopher S. Bond United States Courthouse",Passed,229,2,2,8,178,0,0,14,0,0,0,0,407,2,2,22
719,R,112,H R 2608,21-Sep-2011,5:44 PM,On Motion to Concur in the Senate Amendment with an Amendment,Small Business Program Extension and Reform Act of 2011,Failed,189,48,0,4,6,182,0,4,0,0,0,0,195,230,0,8
720,R,112,H R 2883,21-Sep-2011,5:51 PM,"On Motion to Suspend the Rules and Pass, as Amended","To amend part B of title IV of the Social Security Act to extend the child and family services program through fiscal year 2016, and for other purposes",Passed,211,25,0,5,184,0,0,8,0,0,0,0,395,25,0,13
721,R,112,H RES 409,22-Sep-2011,5:11 PM,On Ordering the Previous Question,Waiving a requirement of clause 6(a) of rule XIII with respect to consideration of certain resolutions reported from the Committee on Rules,Passed,238,0,0,3,2,180,0,10,0,0,0,0,240,180,0,13
722,R,112,H RES 409,22-Sep-2011,5:18 PM,On Agreeing to the Resolution,Waiving a requirement of clause 6(a) of rule XIII with respect to consideration of certain resolutions reported from the Committee on Rules,Passed,237,0,0,4,1,182,0,9,0,0,0,0,238,182,0,13
723,R,112,H RES 406,22-Sep-2011,5:26 PM,On Ordering the Previous Question,"Providing for consideration of the bill (H.R. 2401) to require analyses of the cumulative and incremental impacts of certain rules and actions of the Environmental Protection Agency, and for other purposes",Passed,236,0,0,5,1,184,0,7,0,0,0,0,237,184,0,12
724,R,112,H RES 406,22-Sep-2011,5:35 PM,On Agreeing to the Resolution,"Providing for consideration of the bill (H.R. 2401) to require analyses of the cumulative and incremental impacts of certain rules and actions of the Environmental Protection Agency, and for other purposes",Passed,236,0,0,5,9,175,0,8,0,0,0,0,245,175,0,13
725,R,112,H RES 412,22-Sep-2011,11:12 PM,On Ordering the Previous Question,"Providing for consideration of the Senate amendment to the bill (H.R. 2608) to provide for an additional temporary extension of programs under the Small Business Act and the Small Business Investment Act of 1958, and for other purposes",Passed,234,0,0,7,1,177,0,14,0,0,0,0,235,177,0,21
726,R,112,H RES 412,22-Sep-2011,11:19 PM,On Agreeing to the Resolution,"Providing for consideration of the Senate amendment to the bill (H.R. 2608) to provide for an additional temporary extension of programs under the Small Business Act and the Small Business Investment Act of 1958, and for other purposes",Passed,237,0,0,4,1,176,0,15,0,0,0,0,238,176,0,19
727,R,112,H R 2608,23-Sep-2011,12:50 AM,On Motion to Concur in the Senate Amendment with an Amendment,Small Business Program Extension and Reform Act of 2011,Passed,213,24,0,4,6,179,0,7,0,0,0,0,219,203,0,11
728,R,112,H R 2401,23-Sep-2011,11:55 AM,On Agreeing to the Amendment,None,Failed,7,227,0,7,166,9,0,17,0,0,0,0,173,236,0,24
729,R,112,H R 2401,23-Sep-2011,12:02 PM,On Agreeing to the Amendment,None,Failed,12,222,0,7,172,7,0,13,0,0,0,0,184,229,0,20
730,R,112,H R 2401,23-Sep-2011,12:06 PM,On Agreeing to the Amendment,None,Agreed to,160,73,0,8,177,3,0,12,0,0,0,0,337,76,0,20
731,R,112,H R 2401,23-Sep-2011,12:11 PM,On Agreeing to the Amendment,None,Failed,21,214,0,6,174,7,0,11,0,0,0,0,195,221,0,17
732,R,112,H R 2401,23-Sep-2011,12:15 PM,On Agreeing to the Amendment,None,Agreed to,233,1,0,7,36,144,0,12,0,0,0,0,269,145,0,19
733,R,112,H R 2401,23-Sep-2011,12:20 PM,On Agreeing to the Amendment,None,Agreed to,234,2,0,5,35,148,0,9,0,0,0,0,269,150,0,14
734,R,112,H R 2401,23-Sep-2011,12:24 PM,On Agreeing to the Amendment,None,Failed,0,236,0,5,165,18,0,9,0,0,0,0,165,254,0,14
735,R,112,H R 2401,23-Sep-2011,12:28 PM,On Agreeing to the Amendment,None,Failed,14,222,0,5,172,10,0,10,0,0,0,0,186,232,0,15
736,R,112,H R 2401,23-Sep-2011,12:32 PM,On Agreeing to the Amendment,None,Agreed to,165,71,0,5,181,3,0,8,0,0,0,0,346,74,0,13
737,R,112,H R 2401,23-Sep-2011,12:35 PM,On Agreeing to the Amendment,None,Agreed to,221,15,0,5,13,173,0,6,0,0,0,0,234,188,0,11
738,R,112,H R 2401,23-Sep-2011,12:39 PM,On Agreeing to the Amendment,None,Agreed to,223,11,0,7,4,181,0,7,0,0,0,0,227,192,0,14
739,R,112,H R 2401,23-Sep-2011,12:43 PM,On Agreeing to the Amendment,None,Failed,7,228,0,6,174,9,0,9,0,0,0,0,181,237,0,15
740,R,112,H R 2401,23-Sep-2011,1:11 PM,On Motion to Recommit with Instructions,"To require analyses of the cumulative and incremental impacts of certain rules and actions of the Environmental Protection Agency, and for other purposes",Failed,0,232,0,9,180,1,0,11,0,0,0,0,180,233,0,20
741,R,112,H R 2401,23-Sep-2011,1:18 PM,On Passage,"To require analyses of the cumulative and incremental impacts of certain rules and actions of the Environmental Protection Agency, and for other purposes",Passed,230,4,0,7,19,165,0,8,0,0,0,0,249,169,0,15
742,R,112,H R 686,3-Oct-2011,6:55 PM,"On Motion to Suspend the Rules and Pass, as Amended","To require the conveyance of certain public land within the boundaries of Camp Williams, Utah, to support the training and readiness of the Utah National Guard",Passed,226,0,0,15,174,0,0,18,0,0,0,0,400,0,0,33
743,R,112,H R 765,3-Oct-2011,7:02 PM,On Motion to Suspend the Rules and Pass,"To amend the National Forest Ski Area Permit Act of 1986 to clarify the authority of the Secretary of Agriculture regarding additional recreational uses of National Forest System land that is subject to ski area permits, and for other purposes",Passed,226,0,0,15,168,0,0,24,0,0,0,0,394,0,0,39
744,R,112,H R 670,3-Oct-2011,7:10 PM,On Motion to Suspend the Rules and Pass,"To convey certain submerged lands to the Commonwealth of the Northern Mariana Islands in order to give that territory the same benefits in its submerged lands as Guam, the Virgin Islands, and American Samoa have in their submerged lands",Passed,224,0,0,17,173,0,0,19,0,0,0,0,397,0,0,36
745,R,112,H R 2608,4-Oct-2011,2:09 PM,On Concurring in Senate Amdt to House Amdt to Senate Amdt,Small Business Program Extension and Reform Act of 2011,Passed,182,53,0,6,170,13,0,9,0,0,0,0,352,66,0,15
746,R,112,H RES 419,4-Oct-2011,2:17 PM,On Agreeing to the Resolution,"Providing for consideration of H.R. 2681, to provide additional time for the EPA to issue standards for cement manufacturing facilities, and for consideration of H.R. 2250, to provide additional time for the EPA to issue standards for industrial, commercial, and institutional boilers, process heaters, and incinerators",Passed,238,0,0,3,19,165,0,8,0,0,0,0,257,165,0,11
747,R,112,H R 2681,5-Oct-2011,6:11 PM,On Agreeing to the Amendment,None,Failed,6,234,0,1,160,12,0,20,0,0,0,0,166,246,0,21
748,R,112,H R 2681,5-Oct-2011,6:15 PM,On Agreeing to the Amendment,None,Failed,3,234,0,4,159,17,0,16,0,0,0,0,162,251,0,20
749,R,112,H R 2681,5-Oct-2011,6:18 PM,On Agreeing to the Amendment,None,Failed,0,235,0,6,158,19,0,15,0,0,0,0,158,254,0,21
750,R,112,H R 2681,5-Oct-2011,6:22 PM,On Agreeing to the Amendment,None,Failed,2,238,0,1,173,10,0,9,0,0,0,0,175,248,0,10
751,R,112,H R 2681,5-Oct-2011,6:26 PM,On Agreeing to the Amendment,None,Failed,2,235,0,4,165,19,0,8,0,0,0,0,167,254,0,12
752,R,112,H R 2681,5-Oct-2011,6:30 PM,On Agreeing to the Amendment,None,Failed,2,237,0,2,167,17,0,8,0,0,0,0,169,254,0,10
753,R,112,H R 2681,5-Oct-2011,6:33 PM,On Agreeing to the Amendment,None,Failed,0,237,0,4,166,16,0,10,0,0,0,0,166,253,0,14
754,R,112,H R 2681,5-Oct-2011,6:37 PM,On Agreeing to the Amendment,None,Failed,2,238,0,1,160,24,0,8,0,0,0,0,162,262,0,9
755,R,112,H R 2681,5-Oct-2011,6:40 PM,On Agreeing to the Amendment,None,Failed,2,237,0,2,173,11,0,8,0,0,0,0,175,248,0,10
756,R,112,H R 2681,5-Oct-2011,6:46 PM,On Agreeing to the Amendment,None,Failed,3,237,0,1,173,11,0,8,0,0,0,0,176,248,0,9
757,R,112,H R 2681,5-Oct-2011,6:50 PM,On Agreeing to the Amendment,None,Failed,4,236,0,1,170,13,0,9,0,0,0,0,174,249,0,10
758,R,112,H R 2681,5-Oct-2011,6:53 PM,On Agreeing to the Amendment,None,Failed,1,239,0,1,166,17,0,9,0,0,0,0,167,256,0,10
759,R,112,H R 2681,5-Oct-2011,6:57 PM,On Agreeing to the Amendment,None,Failed,2,238,0,1,168,14,0,10,0,0,0,0,170,252,0,11
760,R,112,H R 2681,6-Oct-2011,10:57 AM,On Agreeing to the Amendment,None,Failed,2,234,1,4,170,14,0,8,0,0,0,0,172,248,1,12
761,R,112,H R 2681,6-Oct-2011,11:02 AM,On Agreeing to the Amendment,None,Failed,0,237,0,4,162,20,0,10,0,0,0,0,162,257,0,14
762,R,112,H R 2681,6-Oct-2011,11:06 AM,On Agreeing to the Amendment,None,Failed,1,238,0,2,164,20,0,8,0,0,0,0,165,258,0,10
763,R,112,H R 2681,6-Oct-2011,11:38 AM,On Motion to Recommit with Instructions,"To provide additional time for the Administrator of the Environmental Protection Agency to issue achievable standards for cement manufacturing facilities, and for other purposes",Failed,1,238,0,2,175,9,0,8,0,0,0,0,176,247,0,10
764,R,112,H R 2681,6-Oct-2011,11:46 AM,On Passage,"To provide additional time for the Administrator of the Environmental Protection Agency to issue achievable standards for cement manufacturing facilities, and for other purposes",Passed,237,2,0,2,25,159,0,8,0,0,0,0,262,161,0,10
765,R,112,MOTION,6-Oct-2011,2:16 PM,Table Appeal of the Ruling of the Chair,None,Passed,230,0,0,11,1,173,0,18,0,0,0,0,231,173,0,29
766,R,112,H R 2250,6-Oct-2011,2:34 PM,On Agreeing to the Amendment,None,Failed,2,228,0,11,165,15,0,12,0,0,0,0,167,243,0,23
767,R,112,H R 2250,6-Oct-2011,2:37 PM,On Agreeing to the Amendment,None,Failed,1,222,0,18,155,20,0,17,0,0,0,0,156,242,0,35
768,R,112,H R 2250,6-Oct-2011,2:42 PM,On Agreeing to the Amendment,None,Failed,0,228,0,13,151,27,0,14,0,0,0,0,151,255,0,27
769,R,112,H R 2250,6-Oct-2011,2:46 PM,On Agreeing to the Amendment,None,Failed,1,230,0,10,152,24,0,16,0,0,0,0,153,254,0,26
770,R,112,H R 2250,6-Oct-2011,2:50 PM,On Agreeing to the Amendment,None,Failed,0,226,1,14,147,25,0,20,0,0,0,0,147,251,1,34
771,R,112,H RES 425,11-Oct-2011,7:00 PM,On Agreeing to the Resolution,"Providing for the consideration of the Senate amendment to H.R. 2832, to extend the Generalized System of Preferences; H.R. 3078, the United States-Colombia Trade Promotion Agreement; H.R. 3079, the United States-Panama Trade Promotion Agreement; H.R. 3080, the United States-Korea Free Trade Agreement",Passed,232,1,0,8,49,127,0,16,0,0,0,0,281,128,0,24
772,R,112,H R 2250,11-Oct-2011,7:19 PM,On Agreeing to the Amendment,None,Failed,2,234,0,5,162,20,0,10,0,0,0,0,164,254,0,15
773,R,112,H R 2250,11-Oct-2011,7:23 PM,On Agreeing to the Amendment,None,Failed,2,234,0,5,166,16,0,10,0,0,0,0,168,250,0,15
774,R,112,H R 2250,11-Oct-2011,7:28 PM,On Agreeing to the Amendment,None,Failed,2,234,0,5,164,18,0,10,0,0,0,0,166,252,0,15
775,R,112,H R 2250,11-Oct-2011,7:31 PM,On Agreeing to the Amendment,None,Failed,0,235,0,6,157,25,0,10,0,0,0,0,157,260,0,16
776,R,112,H R 2250,11-Oct-2011,7:34 PM,On Agreeing to the Amendment,None,Failed,2,234,0,5,167,15,0,10,0,0,0,0,169,249,0,15
777,R,112,H R 2250,11-Oct-2011,7:38 PM,On Agreeing to the Amendment,None,Failed,0,236,0,5,154,25,0,13,0,0,0,0,154,261,0,18
778,R,112,H R 2250,11-Oct-2011,7:41 PM,On Agreeing to the Amendment,None,Failed,4,232,0,5,165,17,0,10,0,0,0,0,169,249,0,15
779,R,112,H R 2250,11-Oct-2011,7:46 PM,On Agreeing to the Amendment,None,Failed,1,235,0,5,155,27,0,10,0,0,0,0,156,262,0,15
780,R,112,H R 3078,12-Oct-2011,5:57 PM,On Motion to Recommit with Instructions,To implement the United States-Colombia Trade Promotion Agreement,Failed,4,235,0,2,188,1,0,3,0,0,0,0,192,236,0,5
781,R,112,H R 3078,12-Oct-2011,6:04 PM,On Passage,To implement the United States-Colombia Trade Promotion Agreement,Passed,231,9,0,1,31,158,0,3,0,0,0,0,262,167,0,4
782,R,112,H R 3079,12-Oct-2011,6:10 PM,On Passage,To implement the United States-Panama Trade Promotion Agreement,Passed,234,6,0,1,66,123,0,3,0,0,0,0,300,129,0,4
783,R,112,H R 3080,12-Oct-2011,6:17 PM,On Passage,To implement the United States-Korea Trade Agreement,Passed,219,21,0,1,59,130,0,3,0,0,0,0,278,151,0,4
784,R,112,H R 2832,12-Oct-2011,6:27 PM,On Motion to Concur in the Senate Amendment,"To extend the Generalized System of Preferences, and for other purposes",Passed,118,122,0,1,189,0,0,3,0,0,0,0,307,122,0,4
785,R,112,H R 2433,12-Oct-2011,6:34 PM,"On Motion to Suspend the Rules and Pass, as Amended",Veterans Opportunity to Work Act,Passed,235,5,0,1,183,1,0,8,0,0,0,0,418,6,0,9
786,R,112,H RES 430,13-Oct-2011,2:07 PM,On Agreeing to the Resolution,Providing for consideration of the bill (H.R. 358) to amend the Patient Protection and Affordable Care Act to modify special rules relating to coverage of abortion services under such Act.,Passed,237,0,0,4,11,173,0,8,0,0,0,0,248,173,0,12
787,R,112,H R 2250,13-Oct-2011,2:25 PM,On Agreeing to the Amendment,None,Failed,3,236,0,2,171,14,0,7,0,0,0,0,174,250,0,9
788,R,112,H R 358,13-Oct-2011,7:13 PM,On Motion to Recommit with Instructions,To amend the Patient Protection and Affordable Care Act to modify special rules relating to coverage of abortion services under such Act,Failed,0,237,0,4,173,12,0,7,0,0,0,0,173,249,0,11
789,R,112,H R 358,13-Oct-2011,7:20 PM,On Passage,To amend the Patient Protection and Affordable Care Act to modify special rules relating to coverage of abortion services under such Act,Passed,236,2,0,3,15,170,0,7,0,0,0,0,251,172,0,10
790,R,112,H R 2250,13-Oct-2011,7:49 PM,On Motion to Recommit with Instructions,"To provide additional time for the Administrator of the Environmental Protection Agency to issue achievable standards for industrial, commercial, and institutional boilers, process heaters, and incinerators, and for other purposes",Failed,1,233,0,7,169,13,0,10,0,0,0,0,170,246,0,17
791,R,112,H R 2250,13-Oct-2011,7:56 PM,On Passage,"To provide additional time for the Administrator of the Environmental Protection Agency to issue achievable standards for industrial, commercial, and institutional boilers, process heaters, and incinerators, and for other purposes",Passed,234,0,0,7,41,142,0,9,0,0,0,0,275,142,0,16
792,R,112,H RES 431,14-Oct-2011,10:38 AM,On Ordering the Previous Question,"Providing for consideration of H.R. 2273, Coal Residuals Reuse and Management Act",Passed,230,0,0,11,7,166,0,19,0,0,0,0,237,166,0,30
793,R,112,H RES 431,14-Oct-2011,10:48 AM,On Agreeing to the Resolution,"Providing for consideration of H.R. 2273, Coal Residuals Reuse and Management Act",Passed,232,0,0,9,12,163,0,17,0,0,0,0,244,163,0,26
794,R,112,H R 2273,14-Oct-2011,1:22 PM,On Agreeing to the Amendment,None,Failed,4,226,0,11,167,10,0,15,0,0,0,0,171,236,0,26
795,R,112,H R 2273,14-Oct-2011,1:27 PM,On Agreeing to the Amendment,None,Failed,4,222,0,15,169,9,0,14,0,0,0,0,173,231,0,29
796,R,112,H R 2273,14-Oct-2011,1:30 PM,On Agreeing to the Amendment,None,Failed,12,218,0,11,173,5,0,14,0,0,0,0,185,223,0,25
797,R,112,H R 2273,14-Oct-2011,1:34 PM,On Agreeing to the Amendment,None,Failed,2,227,0,12,162,14,0,16,0,0,0,0,164,241,0,28
798,R,112,H R 2273,14-Oct-2011,1:38 PM,On Agreeing to the Amendment,None,Failed,9,221,0,11,165,14,0,13,0,0,0,0,174,235,0,24
799,R,112,H R 2273,14-Oct-2011,2:07 PM,On Motion to Recommit with Instructions,"To amend subtitle D of the Solid Waste Disposal Act to facilitate recovery and beneficial use, and provide for the proper management and disposal, of materials generated by the combustion of coal and other fossil fuels",Failed,0,233,0,8,172,5,0,15,0,0,0,0,172,238,0,23
800,R,112,H R 2273,14-Oct-2011,2:14 PM,On Passage,"To amend subtitle D of the Solid Waste Disposal Act to facilitate recovery and beneficial use, and provide for the proper management and disposal, of materials generated by the combustion of coal and other fossil fuels",Passed,230,3,0,8,37,141,0,14,0,0,0,0,267,144,0,22
801,R,112,H R 320,24-Oct-2011,6:54 PM,On Motion to Suspend the Rules and Pass,"To designate a Distinguished Flying Cross National Memorial at the March Field Air Museum in Riverside, California",Passed,224,1,0,16,168,0,0,24,0,0,0,0,392,1,0,40
802,R,112,H R 1160,24-Oct-2011,7:01 PM,"On Motion to Suspend the Rules and Pass, as Amended","To require the Secretary of the Interior to convey the McKinney Lake National Fish Hatchery to the State of North Carolina, and for other purposes",Passed,224,0,0,17,171,0,0,21,0,0,0,0,395,0,0,38
803,R,112,H RES 444,25-Oct-2011,3:29 PM,On Agreeing to the Resolution,"Providing for consideration of the bill (H.R. 1904) to facilitate the efficient extraction of mineral resources in southeast Arizona by authorizing and directing an exchange of Federal and non-Federal land, and for other purposes",Passed,237,0,0,4,8,178,0,6,0,0,0,0,245,178,0,10
804,R,112,H R 2447,25-Oct-2011,3:40 PM,On Motion to Suspend the Rules and Pass,To grant the congressional gold medal to the Montford Point Marines,Passed,237,0,0,4,185,0,0,7,0,0,0,0,422,0,0,11
805,R,112,H R 1904,26-Oct-2011,4:13 PM,On Agreeing to the Amendment,None,Failed,5,231,0,5,184,2,0,6,0,0,0,0,189,233,0,11
806,R,112,H R 1904,26-Oct-2011,4:17 PM,On Agreeing to the Amendment,None,Failed,3,229,0,9,170,9,0,13,0,0,0,0,173,238,0,22
807,R,112,H R 1904,26-Oct-2011,4:22 PM,On Agreeing to the Amendment,None,Failed,1,234,0,6,181,6,0,5,0,0,0,0,182,240,0,11
808,R,112,H R 1904,26-Oct-2011,4:53 PM,On Motion to Recommit with Instructions,Southeast Arizona Land Exchange and Conservation Act,Failed,0,237,0,4,187,0,0,5,0,0,0,0,187,237,0,9
809,R,112,H R 1904,26-Oct-2011,4:59 PM,On Passage,Southeast Arizona Land Exchange and Conservation Act,Passed,228,8,0,5,7,178,0,7,0,0,0,0,235,186,0,12
810,R,112,H RES 448,26-Oct-2011,5:06 PM,On Ordering the Previous Question,Providing for consideration of H.R. 2576 and H.R. 674,Passed,237,0,0,4,6,178,0,8,0,0,0,0,243,178,0,12
811,R,112,H RES 448,26-Oct-2011,5:13 PM,On Agreeing to the Resolution,Providing for consideration of H.R. 2576 and H.R. 674,Passed,237,0,0,4,16,172,0,4,0,0,0,0,253,172,0,8
812,R,112,H R 2527,26-Oct-2011,5:20 PM,"On Motion to Suspend the Rules and Pass, as Amended",National Baseball Hall of Fame Commemorative Coin Act,Passed,230,3,0,8,186,0,0,6,0,0,0,0,416,3,0,14
813,R,112,H R 2576,27-Oct-2011,10:58 AM,On Passage,To amend the Internal Revenue Code of 1986 to modify the calculation of modified adjusted gross income for purposes of determining eligibility for certain healthcare-related programs,Passed,235,0,0,6,27,157,0,8,0,0,0,0,262,157,0,14
814,R,112,H R 674,27-Oct-2011,11:28 AM,On Motion to Recommit with Instructions,To amend the Internal Revenue Code of 1986 to repeal the imposition of 3 percent withholding on certain payments made to vendors by government entities,Failed,0,233,0,8,183,2,0,7,0,0,0,0,183,235,0,15
815,R,112,H R 674,27-Oct-2011,11:45 AM,On Passage,To amend the Internal Revenue Code of 1986 to repeal the imposition of 3 percent withholding on certain payments made to vendors by government entities,Passed,235,0,0,6,170,16,0,6,0,0,0,0,405,16,0,12
816,R,112,H CON RES 13,1-Nov-2011,6:55 PM,On Motion to Suspend the Rules and Agree,"Reaffirming “In God We Trust” as the official motto of the United States and supporting and encouraging the public display of the national motto in all public buildings, public schools, and other government institutions",Passed,233,1,0,7,163,8,2,19,0,0,0,0,396,9,2,26
817,R,112,S 1280,1-Nov-2011,7:02 PM,On Motion to Suspend the Rules and Pass,Kate Puzey Peace Corps Volunteer Protection Act of 2011,Passed,234,0,0,7,172,0,0,20,0,0,0,0,406,0,0,27
818,R,112,H R 2061,2-Nov-2011,2:19 PM,"On Motion to Suspend the Rules and Pass, as Amended",Civilian Service Recognition Act,Passed,240,0,0,1,185,0,0,7,0,0,0,0,425,0,0,8
819,R,112,H R 1965,2-Nov-2011,2:28 PM,"On Motion to Suspend the Rules and Pass, as Amended","To amend the securities laws to establish certain thresholds for shareholder registration, and for other purposes",Passed,236,1,0,4,184,1,0,7,0,0,0,0,420,2,0,11
820,R,112,H R 1070,2-Nov-2011,2:35 PM,"On Motion to Suspend the Rules and Pass, as Amended",Small Company Capital Formation Act,Passed,238,0,0,3,183,1,0,8,0,0,0,0,421,1,0,11
821,R,112,H RES 453,3-Nov-2011,2:44 PM,On Ordering the Previous Question,"Providing for consideration of H.R. 2930, the Entrepreneur Access to Capital Act and H.R. 2940, the Access to Capital for Job Creators Act",Passed,238,0,0,3,3,184,0,5,0,0,0,0,241,184,0,8
822,R,112,H R 2112,3-Nov-2011,2:52 PM,On Motion to Instruct Conferees,"Making appropriations for Agriculture, Rural Development, Food and Drug Administration, and Related Agencies programs for the fiscal year ending September 30, 2012, and for other purposes",Passed,79,159,0,3,186,1,0,5,0,0,0,0,265,160,0,8
823,R,112,H R 2930,3-Nov-2011,5:43 PM,On Agreeing to the Amendment,None,Failed,3,234,0,4,186,0,0,6,0,0,0,0,189,234,0,10
824,R,112,H R 2930,3-Nov-2011,6:11 PM,On Motion to Recommit with Instructions,"To amend the securities laws to provide for registration exemptions for certain crowdfunded securities, and for other purposes",Failed,0,237,0,4,187,0,0,5,0,0,0,0,187,237,0,9
825,R,112,H R 2930,3-Nov-2011,6:18 PM,On Passage,"To amend the securities laws to provide for registration exemptions for certain crowdfunded securities, and for other purposes",Passed,238,0,0,3,169,17,0,6,0,0,0,0,407,17,0,9
826,R,112,H R 2940,3-Nov-2011,6:25 PM,On Agreeing to the Amendment,None,Failed,8,228,0,5,182,6,0,4,0,0,0,0,190,234,0,9
827,R,112,H R 2940,3-Nov-2011,6:49 PM,On Motion to Recommit with Instructions,To direct the Securities and Exchange Commission to eliminate the prohibition against general solicitation as a requirement for a certain exemption under Regulation D,Failed,2,236,0,3,188,0,0,4,0,0,0,0,190,236,0,7
828,R,112,H R 2940,3-Nov-2011,6:55 PM,On Passage,To direct the Securities and Exchange Commission to eliminate the prohibition against general solicitation as a requirement for a certain exemption under Regulation D,Passed,238,0,0,3,175,11,0,6,0,0,0,0,413,11,0,9
829,R,112,H RES 455,4-Nov-2011,10:48 AM,On Ordering the Previous Question,"Providing for consideration of the bill (H.R. 2838) to authorize appropriations for the Coast Guard for fiscal years 2012 through 2015, and for other purposes",Passed,233,0,0,8,1,177,0,14,0,0,0,0,234,177,0,22
830,R,112,H RES 455,4-Nov-2011,10:57 AM,On Agreeing to the Resolution,"Providing for consideration of the bill (H.R. 2838) to authorize appropriations for the Coast Guard for fiscal years 2012 through 2015, and for other purposes",Passed,234,0,0,7,11,166,0,15,0,0,0,0,245,166,0,22
831,R,112,H R 3321,4-Nov-2011,11:28 AM,On Motion to Suspend the Rules and Pass,"To facilitate the hosting in the United States of the 34th America’s Cup by authorizing certain eligible vessels to participate in activities related to the competition, and for other purposes",Passed,224,0,1,16,163,2,0,27,0,0,0,0,387,2,1,43
832,R,112,H R 2838,4-Nov-2011,1:50 PM,On Agreeing to the Amendment,None,Failed,1,226,0,14,173,1,0,18,0,0,0,0,174,227,0,32
833,R,112,H R 2838,4-Nov-2011,1:54 PM,On Agreeing to the Amendment,None,Failed,21,206,0,14,161,12,0,19,0,0,0,0,182,218,0,33
834,R,112,H R 2838,4-Nov-2011,2:01 PM,On Agreeing to the Amendment,None,Agreed to,206,22,0,13,158,15,0,19,0,0,0,0,364,37,0,32
835,R,112,H R 2838,4-Nov-2011,2:05 PM,On Agreeing to the Amendment,None,Failed,15,210,0,16,159,15,0,18,0,0,0,0,174,225,0,34
836,R,112,H R 2838,4-Nov-2011,2:09 PM,On Agreeing to the Amendment,None,Failed,16,209,0,16,145,28,0,19,0,0,0,0,161,237,0,35
837,R,112,S 1412,14-Nov-2011,6:54 PM,On Motion to Suspend the Rules and Pass,"To designate the facility of the United States Postal Service located at 462 Washington Street, Woburn, Massachusetts, as the “Officer John Maguire Post Office”",Passed,222,0,0,19,163,0,0,29,0,0,0,0,385,0,0,48
838,R,112,H R 298,14-Nov-2011,7:02 PM,On Motion to Suspend the Rules and Pass,"To designate the facility of the United States Postal Service located at 500 East Whitestone Boulevard in Cedar Park, Texas, as the “Army Specialist Matthew Troy Morris Post Office Building”",Passed,225,0,0,16,166,0,0,26,0,0,0,0,391,0,0,42
839,R,112,H R 2422,14-Nov-2011,7:08 PM,On Motion to Suspend the Rules and Pass,"To designate the facility of the United States Postal Service located at 45 Bay Street, Suite 2, in Staten Island, New York, as the “Sergeant Angel Mendez Post Office”",Passed,225,0,0,16,165,0,0,27,0,0,0,0,390,0,0,43
840,R,112,H R 2838,15-Nov-2011,2:17 PM,On Agreeing to the Amendment,None,Agreed to,205,30,0,6,117,70,0,5,0,0,0,0,322,100,0,11
841,R,112,H R 2838,15-Nov-2011,2:44 PM,On Motion to Recommit with Instructions,Coast Guard and Maritime Transportation Act,Failed,1,235,0,5,188,0,0,4,0,0,0,0,189,235,0,9
842,R,112,H RES 463,15-Nov-2011,2:55 PM,On Agreeing to the Resolution,"Providing for consideration of H.R. 822, National Right-to-Carry Reciprocity Act of 2011",Passed,236,0,0,5,35,153,0,4,0,0,0,0,271,153,0,9
843,R,112,H R 822,16-Nov-2011,4:44 PM,On Agreeing to the Amendment,None,Failed,14,220,0,7,126,63,0,3,0,0,0,0,140,283,0,10
844,R,112,H R 822,16-Nov-2011,4:48 PM,On Agreeing to the Amendment,None,Failed,4,231,0,6,143,43,0,6,0,0,0,0,147,274,0,12
845,R,112,H R 822,16-Nov-2011,4:54 PM,On Agreeing to the Amendment,None,Failed,1,234,0,6,147,43,0,2,0,0,0,0,148,277,0,8
846,R,112,H R 822,16-Nov-2011,4:57 PM,On Agreeing to the Amendment,None,Failed,1,233,0,7,138,51,0,3,0,0,0,0,139,284,0,10
847,R,112,H R 822,16-Nov-2011,5:01 PM,On Agreeing to the Amendment,None,Failed,0,235,0,6,144,46,0,2,0,0,0,0,144,281,0,8
848,R,112,H R 822,16-Nov-2011,5:05 PM,On Agreeing to the Amendment,None,Failed,1,235,0,5,149,41,0,2,0,0,0,0,150,276,0,7
849,R,112,H R 822,16-Nov-2011,5:08 PM,On Agreeing to the Amendment,None,Failed,0,234,0,7,123,65,0,4,0,0,0,0,123,299,0,11
850,R,112,H R 822,16-Nov-2011,5:12 PM,On Agreeing to the Amendment,None,Failed,1,234,0,6,145,43,0,4,0,0,0,0,146,277,0,10
851,R,112,H R 822,16-Nov-2011,5:43 PM,On Motion to Recommit with Instructions,"To amend title 18, United States Code, to provide a national standard in accordance with which nonresidents of a State may carry concealed firearms in the State",Failed,0,234,0,7,161,29,0,2,0,0,0,0,161,263,0,9
852,R,112,H R 822,16-Nov-2011,5:51 PM,On Passage,"To amend title 18, United States Code, to provide a national standard in accordance with which nonresidents of a State may carry concealed firearms in the State",Passed,229,7,0,5,43,147,0,2,0,0,0,0,272,154,0,7
853,R,112,H R 674,16-Nov-2011,6:00 PM,On Motion to Suspend the Rules and Concur in the Senate Amendment,To amend the Internal Revenue Code of 1986 to repeal the imposition of 3 percent withholding on certain payments made to vendors by government entities,Passed,232,0,0,9,190,0,0,2,0,0,0,0,422,0,0,11
854,R,112,H RES 466,17-Nov-2011,2:30 PM,On Ordering the Previous Question,Providing for consideration of motions to suspend the rules,Passed,230,0,0,11,13,173,0,6,0,0,0,0,243,173,0,17
855,R,112,H RES 466,17-Nov-2011,2:39 PM,On Agreeing to the Resolution,Providing for consideration of motions to suspend the rules,Passed,231,0,0,10,17,169,0,6,0,0,0,0,248,169,0,16
856,R,112,H RES 467,17-Nov-2011,2:46 PM,On Agreeing to the Resolution,"Providing for consideration of the conference report to accompany H.R. 2112, making appropriations for Agriculture, Rural Development, Food and Drug Administration, and Related Agencies programs for the fiscal year ending September 30, 2012, and for other purposes",Passed,232,0,0,9,30,156,0,6,0,0,0,0,262,156,0,15
857,R,112,H R 2112,17-Nov-2011,4:19 PM,On Agreeing to the Conference Report,"Making appropriations for Agriculture, Rural Development, Food and Drug Administration, and Related Agencies programs for the fiscal year ending September 30, 2012, and for other purposes",Passed,133,101,0,7,165,20,0,7,0,0,0,0,298,121,0,14
858,R,112,H J RES 2,18-Nov-2011,1:58 PM,"On Motion to Suspend the Rules and Pass, as Amended",Proposing a balanced budget amendment to the Constitution of the United States,Failed,236,4,0,2,25,161,0,6,0,0,0,0,261,165,0,8
859,R,112,H RES 470,18-Nov-2011,2:05 PM,On Agreeing to the Resolution,"Providing for consideration of H.R. 3094, to amend the National Labor Relations Act with respect to representation hearings and the timing of elections of labor organizations under that Act",Passed,234,0,0,7,5,167,0,20,0,0,0,0,239,167,0,27
860,R,112,H R 3012,29-Nov-2011,6:56 PM,"On Motion to Suspend the Rules and Pass, as Amended",Fairness for High Skilled Immigrants Act,Passed,210,13,0,18,179,2,0,11,0,0,0,0,389,15,0,29
861,R,112,H R 2192,29-Nov-2011,7:04 PM,On Motion to Suspend the Rules and Pass,National Guard and Reservist Debt Relief Extension Act,Passed,224,1,0,16,183,0,0,9,0,0,0,0,407,1,0,25
862,R,112,H R 1801,29-Nov-2011,7:11 PM,"On Motion to Suspend the Rules and Pass, as Amended",Risk-Based Security Screening for Members of the Armed Forces Act,Passed,225,0,0,16,179,0,0,13,0,0,0,0,404,0,0,29
863,R,112,H R 3094,30-Nov-2011,5:13 PM,On Motion to Rise With Recommendation That Enacting Clause Be Stricken,Workforce Democracy and Fairness Act,Failed,0,233,0,8,176,8,0,8,0,0,0,0,176,241,0,16
864,R,112,H R 3094,30-Nov-2011,5:18 PM,On Agreeing to the Amendment,None,Failed,6,226,0,9,181,2,0,9,0,0,0,0,187,228,0,18
865,R,112,H R 3094,30-Nov-2011,5:22 PM,On Agreeing to the Amendment,None,Failed,3,230,0,8,178,9,0,5,0,0,0,0,181,239,0,13
866,R,112,H R 3094,30-Nov-2011,5:27 PM,On Agreeing to the Amendment,None,Failed,14,220,0,7,186,1,0,5,0,0,0,0,200,221,0,12
867,R,112,H R 3094,30-Nov-2011,5:32 PM,On Agreeing to the Amendment,None,Failed,7,229,0,5,181,7,0,4,0,0,0,0,188,236,0,9
868,R,112,H R 3094,30-Nov-2011,6:01 PM,On Motion to Recommit with Instructions,Workforce Democracy and Fairness Act,Failed,1,235,0,5,184,4,0,4,0,0,0,0,185,239,0,9
869,R,112,H R 3094,30-Nov-2011,6:08 PM,On Passage,Workforce Democracy and Fairness Act,Passed,229,8,0,4,6,180,0,6,0,0,0,0,235,188,0,10
870,R,112,H RES 477,30-Nov-2011,6:15 PM,On Ordering the Previous Question,Providing for consideration of H. R. 3463; Providing for consideration of H. R. 527; and Providing for consideration of H. R. 3010,Passed,235,0,0,6,4,184,0,4,0,0,0,0,239,184,0,10
871,R,112,H RES 477,30-Nov-2011,6:22 PM,On Agreeing to the Resolution,Providing for consideration of H. R. 3463; Providing for consideration of H. R. 527; and Providing for consideration of H. R. 3010,Passed,232,0,0,9,7,178,0,7,0,0,0,0,239,178,0,16
872,R,112,H R 3463,1-Dec-2011,2:42 PM,On Motion to Recommit with Instructions,To reduce Federal spending and the deficit by terminating taxpayer financing of presidential election campaigns and party conventions and by terminating the Election Assistance Commission,Failed,1,236,0,4,189,0,0,3,0,0,0,0,190,236,0,7
873,R,112,H R 3463,1-Dec-2011,2:49 PM,On Passage,To reduce Federal spending and the deficit by terminating taxpayer financing of presidential election campaigns and party conventions and by terminating the Election Assistance Commission,Passed,235,1,0,5,0,189,0,3,0,0,0,0,235,190,0,8
874,R,112,H R 527,1-Dec-2011,5:07 PM,On Agreeing to the Amendment,None,Failed,1,233,0,7,172,11,0,9,0,0,0,0,173,244,0,16
875,R,112,H R 527,1-Dec-2011,5:12 PM,On Agreeing to the Amendment,None,Failed,0,235,0,6,171,13,0,8,0,0,0,0,171,248,0,14
876,R,112,H R 527,1-Dec-2011,5:16 PM,On Agreeing to the Amendment,None,Failed,2,233,0,6,177,10,0,5,0,0,0,0,179,243,0,11
877,R,112,H R 527,1-Dec-2011,5:19 PM,On Agreeing to the Amendment,None,Failed,5,231,0,5,167,19,0,6,0,0,0,0,172,250,0,11
878,R,112,H R 527,1-Dec-2011,5:24 PM,On Agreeing to the Amendment,None,Failed,0,234,0,7,170,16,0,6,0,0,0,0,170,250,0,13
879,R,112,H R 527,1-Dec-2011,5:55 PM,On Motion to Recommit with Instructions,"To amend chapter 6 of title 5, United States Code (commonly known as the Regulatory Flexibility Act), to ensure complete analysis of potential impacts on small entities of rules, and for other purposes",Failed,2,233,0,6,186,0,0,6,0,0,0,0,188,233,0,12
880,R,112,H R 527,1-Dec-2011,6:01 PM,On Passage,"To amend chapter 6 of title 5, United States Code (commonly known as the Regulatory Flexibility Act), to ensure complete analysis of potential impacts on small entities of rules, and for other purposes",Passed,235,0,0,6,28,159,0,5,0,0,0,0,263,159,0,11
881,R,112,H RES 364,1-Dec-2011,6:08 PM,On Motion to Suspend the Rules and Agree,Designating room HVC 215 of the Capitol Visitor Center as the “Gabriel Zimmerman Meeting Room”,Passed,233,0,0,8,186,0,0,6,0,0,0,0,419,0,0,14
882,R,112,H R 3010,2-Dec-2011,11:26 AM,On Agreeing to the Amendment,None,Failed,4,228,0,9,183,4,0,5,0,0,0,0,187,232,0,14
883,R,112,H R 3010,2-Dec-2011,11:30 AM,On Agreeing to the Amendment,None,Failed,0,230,0,11,162,20,0,10,0,0,0,0,162,250,0,21
884,R,112,H R 3010,2-Dec-2011,11:33 AM,On Agreeing to the Amendment,None,Failed,0,230,0,11,171,12,0,9,0,0,0,0,171,242,0,20
885,R,112,H R 3010,2-Dec-2011,11:38 AM,On Agreeing to the Amendment,None,Failed,1,233,0,7,173,14,0,5,0,0,0,0,174,247,0,12
886,R,112,H R 3010,2-Dec-2011,11:42 AM,On Agreeing to the Amendment,None,Failed,1,233,0,7,174,14,0,4,0,0,0,0,175,247,0,11
887,R,112,H R 3010,2-Dec-2011,12:12 PM,On Motion to Recommit with Instructions,Regulatory Accountability Act,Failed,2,230,0,9,184,3,0,5,0,0,0,0,186,233,0,14
888,R,112,H R 3010,2-Dec-2011,12:23 PM,On Passage,Regulatory Accountability Act,Passed,234,0,0,7,19,167,0,6,0,0,0,0,253,167,0,13
889,R,112,H RES 479,6-Dec-2011,4:07 PM,On Ordering the Previous Question,"Providing for consideration of the bill (H.R. 10) to amend chapter 8 of title 5, United States Code, to provide that major rules of the executive branch shall have no force or effect unless a joint resolution of approval is enacted into law, and for other purposes.",Passed,235,0,0,6,1,184,0,7,0,0,0,0,236,184,0,13
890,R,112,H RES 479,6-Dec-2011,4:13 PM,On Agreeing to the Resolution,"Providing for consideration of the bill (H.R. 10) to amend chapter 8 of title 5, United States Code, to provide that major rules of the executive branch shall have no force or effect unless a joint resolution of approval is enacted into law, and for other purposes.",Passed,230,0,0,11,5,180,0,7,0,0,0,0,235,180,0,18
891,R,112,H R 2471,6-Dec-2011,4:21 PM,"On Motion to Suspend the Rules and Pass, as Amended","To amend section 2710 of title 18, United States Code, to clarify that a video tape service provider may obtain a consumer’s informed, written consent on an ongoing basis and that consent may be obtained through the Internet",Passed,227,7,0,7,76,109,0,7,0,0,0,0,303,116,0,14
892,R,112,H R 1540,7-Dec-2011,1:38 PM,On Motion to Instruct Conferees,"To authorize appropriations for fiscal year 2012 for military activities of the Department of Defense and for military construction, to prescribe military personnel strengths for fiscal year 2012, and for other purposes.",Passed,236,2,0,3,185,0,0,7,0,0,0,0,421,2,0,10
893,R,112,H R 1540,7-Dec-2011,1:47 PM,On Motion to Close Portions of Conference,"To authorize appropriations for fiscal year 2012 for military activities of the Department of Defense and for military construction, to prescribe military personnel strengths for fiscal year 2012, and for other purposes.",Passed,235,2,1,3,171,15,0,6,0,0,0,0,406,17,1,9
894,R,112,H R 2055,7-Dec-2011,1:54 PM,On Motion to Instruct Conferees,"Making appropriations for military construction, the Department of Veterans Affairs, and related agencies for the fiscal year ending September 30, 2012, and for other purposes",Passed,226,12,0,3,183,1,0,8,0,0,0,0,409,13,0,11
895,R,112,H R 10,7-Dec-2011,4:37 PM,On Agreeing to the Amendment,None,Failed,3,233,0,5,184,3,0,5,0,0,0,0,187,236,0,10
896,R,112,H R 10,7-Dec-2011,4:42 PM,On Agreeing to the Amendment,None,Failed,4,231,0,6,179,7,0,6,0,0,0,0,183,238,0,12
897,R,112,H R 10,7-Dec-2011,4:45 PM,On Agreeing to the Amendment,None,Failed,0,236,0,5,177,10,0,5,0,0,0,0,177,246,0,10
898,R,112,H R 10,7-Dec-2011,4:49 PM,On Agreeing to the Amendment,None,Failed,0,235,0,6,177,7,0,8,0,0,0,0,177,242,0,14
899,R,112,H R 10,7-Dec-2011,4:53 PM,On Agreeing to the Amendment,None,Failed,1,235,0,5,182,5,0,5,0,0,0,0,183,240,0,10
900,R,112,H R 10,7-Dec-2011,5:23 PM,On Motion to Recommit with Instructions,"To amend chapter 8 of title 5, United States Code, to provide that major rules of the executive branch shall have no force or effect unless a joint resolution of approval is enacted into law",Failed,2,235,0,4,181,0,0,11,0,0,0,0,183,235,0,15
901,R,112,H R 10,7-Dec-2011,5:30 PM,On Passage,"To amend chapter 8 of title 5, United States Code, to provide that major rules of the executive branch shall have no force or effect unless a joint resolution of approval is enacted into law",Passed,237,0,0,4,4,184,0,4,0,0,0,0,241,184,0,8
902,R,112,H RES 487,8-Dec-2011,11:00 AM,On Ordering the Previous Question,"Providing for consideration of H.R. 1633, the Farm Dust Regulation Prevention Act of 2011",Passed,235,0,0,6,6,173,0,13,0,0,0,0,241,173,0,19
903,R,112,H RES 487,8-Dec-2011,11:06 AM,On Agreeing to the Resolution,"Providing for consideration of H.R. 1633, the Farm Dust Regulation Prevention Act of 2011",Passed,232,0,0,9,17,161,0,14,0,0,0,0,249,161,0,23
904,R,112,H R 1254,8-Dec-2011,11:13 AM,"On Motion to Suspend the Rules and Pass, as Amended",Synthetic Drug Control Act,Passed,220,16,0,5,97,82,0,13,0,0,0,0,317,98,0,18
905,R,112,JOURNAL,8-Dec-2011,11:19 AM,On Approving the Journal,None,Passed,193,38,1,9,119,56,0,17,0,0,0,0,312,94,1,26
906,R,112,H R 1633,8-Dec-2011,1:51 PM,On Agreeing to the Amendment,None,Failed,0,228,0,13,150,27,0,15,0,0,0,0,150,255,0,28
907,R,112,H R 1633,8-Dec-2011,1:55 PM,On Agreeing to the Amendment,None,Failed,1,228,0,12,158,22,0,12,0,0,0,0,159,250,0,24
908,R,112,H R 1633,8-Dec-2011,1:58 PM,On Agreeing to the Amendment,None,Failed,1,232,0,8,164,17,0,11,0,0,0,0,165,249,0,19
909,R,112,H R 1633,8-Dec-2011,2:02 PM,On Agreeing to the Amendment,None,Failed,2,232,0,7,156,25,0,11,0,0,0,0,158,257,0,18
910,R,112,H R 1633,8-Dec-2011,2:05 PM,On Agreeing to the Amendment,None,Failed,7,228,0,6,163,19,0,10,0,0,0,0,170,247,0,16
911,R,112,H R 1633,8-Dec-2011,2:36 PM,On Motion to Recommit with Instructions,"To establish a temporary prohibition against revising any national ambient air quality standard applicable to coarse particulate matter, to limit Federal regulation of nuisance dust in areas in which such dust is regulated under State, tribal, or local law, and for other purposes",Failed,0,235,0,6,166,17,0,9,0,0,0,0,166,252,0,15
912,R,112,H R 1633,8-Dec-2011,2:44 PM,On Passage,"To establish a temporary prohibition against revising any national ambient air quality standard applicable to coarse particulate matter, to limit Federal regulation of nuisance dust in areas in which such dust is regulated under State, tribal, or local law, and for other purposes",Passed,235,0,0,6,33,150,0,9,0,0,0,0,268,150,0,15
913,R,112,H R 3220,12-Dec-2011,6:56 PM,On Motion to Suspend the Rules and Pass,"To designate the facility of the United States Postal Service located at 170 Evergreen Square SW in Pine City, Minnesota, as the “Master Sergeant Daniel L. Fedder Post Office”",Passed,201,0,0,40,150,0,0,42,0,0,0,0,351,0,0,82
914,R,112,H R 2158,12-Dec-2011,7:04 PM,On Motion to Suspend the Rules and Pass,"To designate the facility of the United States Postal Service located at 14901 Adelfa Drive in La Mirada, California, as the “Wayne Grisham Post Office”",Passed,200,1,0,40,153,0,0,39,0,0,0,0,353,1,0,79
915,R,112,JOURNAL,12-Dec-2011,7:10 PM,On Approving the Journal,None,Passed,158,41,1,41,119,33,1,39,0,0,0,0,277,74,2,80
916,R,112,ADJOURN,12-Dec-2011,7:27 PM,On Motion to Adjourn,None,Failed,0,202,0,39,0,153,0,39,0,0,0,0,0,355,0,78
917,R,112,H RES 491,13-Dec-2011,1:22 PM,On Question of Consideration of the Resolution,"Providing for consideration of H.R. 3630, the Middle Class Tax Relief and Job Creation Act",Passed,225,0,0,16,2,174,0,16,0,0,0,0,227,174,0,32
918,R,112,H RES 491,13-Dec-2011,3:04 PM,On Ordering the Previous Question,"Providing for consideration of the bill (H.R. 3630) to provide incentives for the creation of jobs, and for other purposes",Passed,233,0,0,8,3,182,0,7,0,0,0,0,236,182,0,15
919,R,112,H RES 491,13-Dec-2011,3:12 PM,On Agreeing to the Resolution,"Providing for consideration of the bill (H.R. 3630) to provide incentives for the creation of jobs, and for other purposes",Passed,233,0,0,8,3,180,0,9,0,0,0,0,236,180,0,17
920,R,112,H R 3246,13-Dec-2011,3:19 PM,On Motion to Suspend the Rules and Pass,"To designate the facility of the United States Postal Service located at 15455 Manchester Road in Ballwin, Missouri, as the “Specialist Peter J. Navarro Post Office Building”",Passed,232,0,0,9,183,0,0,9,0,0,0,0,415,0,0,18
921,R,112,S 384,13-Dec-2011,3:26 PM,On Motion to Suspend the Rules and Pass,"To amend title 39, United States Code, to extend the authority of the United States Postal Service to issue a semipostal to raise funds for breast cancer research",Passed,232,1,0,8,185,0,0,7,0,0,0,0,417,1,0,15
922,R,112,H R 3630,13-Dec-2011,6:41 PM,On Motion to Recommit with Instructions,"To provide incentives for the creation of jobs, and for other purposes",Failed,0,238,0,3,183,6,0,3,0,0,0,0,183,244,0,6
923,R,112,H R 3630,13-Dec-2011,6:51 PM,On Passage,"To provide incentives for the creation of jobs, and for other purposes",Passed,224,14,0,3,10,179,0,3,0,0,0,0,234,193,0,6
924,R,112,H R 2767,13-Dec-2011,6:59 PM,On Motion to Suspend the Rules and Pass,"To designate the facility of the United States Postal Service located at 8 West Silver Street in Westfield, Massachusetts, as the “William T. Trant Post Office Building”",Passed,234,0,0,7,186,0,0,6,0,0,0,0,420,0,0,13
925,R,112,H RES 493,14-Dec-2011,1:54 PM,On Ordering the Previous Question,"Providing for consideration of the conference report to accompany H.R. 1540, to authorize appropriations for FY 2012 for military activities of the Department of Defense, for military construction, and for defense activities of the Department of Energy, to prescribe military personnel strengths for such fiscal year",Passed,230,0,0,11,5,173,0,14,0,0,0,0,235,173,0,25
926,R,112,H RES 493,14-Dec-2011,2:01 PM,On Agreeing to the Resolution,"Providing for consideration of the conference report to accompany H.R. 1540, to authorize appropriations for FY 2012 for military activities of the Department of Defense, for military construction, and for defense activities of the Department of Energy, to prescribe military personnel strengths for such fiscal year",Passed,232,2,0,7,13,167,0,12,0,0,0,0,245,169,0,19
927,R,112,H R 1905,14-Dec-2011,6:06 PM,"On Motion to Suspend the Rules and Pass, as Amended","To strengthen Iran sanctions laws for the purpose of compelling Iran to abandon its pursuit of nuclear weapons and other threatening activities, and for other purposes",Passed,233,2,0,6,177,9,0,6,0,0,0,0,410,11,0,12
928,R,112,H R 2105,14-Dec-2011,6:17 PM,"On Motion to Suspend the Rules and Pass, as Amended","To provide for the application of measures to foreign persons who transfer to Iran, North Korea, and Syria certain goods, services, or technology, and for other purposes",Passed,234,0,0,7,184,2,0,6,0,0,0,0,418,2,0,13
929,R,112,H R 3421,14-Dec-2011,6:24 PM,On Motion to Suspend the Rules and Pass,"To award Congressional Gold Medals in honor of the men and women who perished as a result of the terrorist attacks on the United States on September 11, 2001.",Passed,231,0,0,10,185,0,0,7,0,0,0,0,416,0,0,17
930,R,112,H R 1264,14-Dec-2011,6:31 PM,"On Motion to Suspend the Rules and Pass, as Amended","To designate the property between the United States Federal Courthouse and the Ed Jones Building located at 109 South Highland Avenue in Jackson, Tennessee, as the “M.D. Anderson Plaza” and to authorize the placement of a historical/identification marker on the grounds recognizing the achievements and philanthropy",Passed,232,1,0,8,186,0,0,6,0,0,0,0,418,1,0,14
931,R,112,H R 1540,14-Dec-2011,6:50 PM,On Motion to Recommit with Instructions,"To authorize appropriations for fiscal year 2012 for military activities of the Department of Defense, for military construction, and for defense activities of the Department of Energy, to prescribe military personnel strengths for such fiscal year, and for other purposes",Failed,0,233,0,8,183,1,0,8,0,0,0,0,183,234,0,16
932,R,112,H R 1540,14-Dec-2011,6:58 PM,On Agreeing to the Conference Report,"To authorize appropriations for fiscal year 2012 for military activities of the Department of Defense, for military construction, and for defense activities of the Department of Energy, to prescribe military personnel strengths for such fiscal year, and for other purposes",Passed,190,43,0,8,93,93,0,6,0,0,0,0,283,136,0,14
933,R,112,JOURNAL,15-Dec-2011,2:08 PM,On Approving the Journal,None,Passed,182,48,1,10,148,35,1,8,0,0,0,0,330,83,2,18
934,R,112,H R 886,15-Dec-2011,2:19 PM,"On Motion to Suspend the Rules and Pass, as Amended","To require the Secretary of the Treasury to mint coins in commemoration of the 225th anniversary of the establishment of the Nation’s first Federal law enforcement agency, the United States Marshals Service.",Passed,229,1,1,10,183,0,0,9,0,0,0,0,412,1,1,19
935,R,112,H R 2719,15-Dec-2011,2:27 PM,On Motion to Suspend the Rules and Pass,"To ensure public access to the summit of Rattlesnake Mountain in the Hanford Reach National Monument for educational, recreational, historical, scientific, cultural, and other purposes",Passed,233,0,0,8,183,0,0,9,0,0,0,0,416,0,0,17
936,R,112,H R 443,15-Dec-2011,2:34 PM,"On Motion to Suspend the Rules and Pass, as Amended","To provide for the conveyance of certain property from the United States to the Maniilaq Association located in Kotzebue, Alaska",Passed,226,4,0,11,181,0,0,11,0,0,0,0,407,4,0,22
937,R,112,H RES 500,16-Dec-2011,11:30 AM,On Ordering the Previous Question,"Providing for consideration of the conference report to accompany H.R. 2055, Military Construction, Veterans Affairs, and related agencies Appropriations for FY 2012; providing for consideration of H.R. 3672, making appropriations for disaster relief requirements for FY 2012",Passed,234,0,0,7,5,179,0,8,0,0,0,0,239,179,0,15
938,R,112,H RES 500,16-Dec-2011,11:37 AM,On Agreeing to the Resolution,"Providing for consideration of the conference report to accompany H.R. 2055, Military Construction, Veterans Affairs, and related agencies Appropriations for FY 2012; providing for consideration of H.R. 3672, making appropriations for disaster relief requirements for FY 2012",Passed,233,0,0,8,19,164,0,9,0,0,0,0,252,164,0,17
939,R,112,H R 1892,16-Dec-2011,11:47 AM,On Motion to Suspend the Rules and Concur in the Senate Amendment,Intelligence Authorization Act for Fiscal Year 2012,Passed,230,4,0,7,166,19,0,7,0,0,0,0,396,23,0,14
940,R,112,S 278,16-Dec-2011,11:54 AM,"On Motion to Suspend the Rules and Pass, as Amended","To provide for the exchange of certain land located in the Arapaho-Roosevelt National Forests in the State of Colorado, and for other purposes",Passed,231,0,0,10,182,0,0,10,0,0,0,0,413,0,0,20
941,R,112,H R 2055,16-Dec-2011,1:46 PM,On Agreeing to the Conference Report,"Making appropriations for military construction, the Department of Veterans Affairs, and related agencies for the fiscal year ending September 30, 2012, and for other purposes",Passed,147,86,0,8,149,35,0,8,0,0,0,0,296,121,0,16
942,R,112,H CON RES 94,16-Dec-2011,1:54 PM,On Agreeing to the Concurrent Resolution,Directing the Clerk of the House of Representatives to make corrections in the enrollment of H.R. 3672,Passed,234,0,0,7,21,165,0,6,0,0,0,0,255,165,0,13
943,R,112,H R 3672,16-Dec-2011,2:04 PM,On Passage,"Making appropriations for disaster relief requirements for the fiscal year ending September 30, 2012, and for other purposes",Passed,169,66,0,6,182,1,0,9,0,0,0,0,351,67,0,15
944,R,112,H RES 502,20-Dec-2011,11:03 AM,On Ordering the Previous Question,Providing for consideration of the Senate amendments to the bill (H.R. 3630) to provide incentives for the creation of jobs; and providing for consideration of the resolution (H.Res. 501),Passed,233,1,1,6,0,186,0,6,0,0,0,0,233,187,1,12
945,R,112,H RES 502,20-Dec-2011,11:10 AM,On Agreeing to the Resolution,Providing for consideration of the Senate amendments to the bill (H.R. 3630) to provide incentives for the creation of jobs; and providing for consideration of the resolution (H.Res. 501),Passed,231,1,1,8,0,186,0,6,0,0,0,0,231,187,1,14
946,R,112,H R 3630,20-Dec-2011,12:56 PM,On Motion to Go to Conference,"To provide incentives for the creation of jobs, and for other purposes",Passed,229,7,0,5,0,186,0,6,0,0,0,0,229,193,0,11
947,R,112,H RES 504,20-Dec-2011,3:52 PM,On Motion to Table,Resolution raising a question of the privileges of the House,Passed,231,3,0,7,0,185,0,7,0,0,0,0,231,188,0,14
948,R,112,H R 3630,20-Dec-2011,3:58 PM,On Motion to Instruct Conferees,"To provide incentives for the creation of jobs, and for other purposes",Failed,2,234,0,5,181,4,0,7,0,0,0,0,183,238,0,12
949,R,112,H RES 501,20-Dec-2011,4:16 PM,On Agreeing to the Resolution,"Expressing the sense of the House of Representatives regarding any final measure to extend the payroll tax holiday, extend Federally funded unemployment insurance benefits, or prevent decreases in reimbursement for physicians who provide care to Medicare beneficiaries",Passed,226,8,0,7,0,177,0,15,0,0,0,0,226,185,0,22
