Roll Call,Majority,Congress Num,Legislation Number,Date,Time,Question,Description,Result,Republican Yes,Republican No,Republican Present,Republican Not Voting,Democrat Yes,Democrat No,Democrat Present,Democrat Not Voting,Independent Yes,Independent No,Independent Present,Independent Not Voting,Total Yes,Total No,Total Present,Total Not Voting
1,R,112,QUORUM,17-Jan-2012,6:53 PM,Call of the House,None,Passed,0,0,225,17,0,0,153,39,0,0,0,0,0,0,378,56
2,R,112,H RES 515,18-Jan-2012,1:59 PM,On Ordering the Previous Question,"Addressing a motion to proceed under section 3101A of title 31, United States Code",Passed,235,0,1,5,3,176,0,13,0,0,0,0,238,176,1,18
3,R,112,JOURNAL,18-Jan-2012,2:07 PM,On Approving the Journal,None,Passed,197,37,1,6,95,83,0,14,0,0,0,0,292,120,1,20
4,R,112,H J RES 98,18-Jan-2012,4:26 PM,On Passage,"Relating to the disapproval of the President’s exercise of authority to increase the debt limit, as submitted under section 3101A of title 31, United States Code, on January 12, 2012",Passed,233,1,2,5,6,175,0,11,0,0,0,0,239,176,2,16
5,R,112,H R 3117,23-Jan-2012,6:55 PM,"On Motion to Suspend the Rules and Pass, as Amended",Permanent Electronic Duck Stamp Act,Passed,214,1,0,26,159,0,0,33,0,0,0,0,373,1,0,59
6,R,112,H R 1141,23-Jan-2012,7:08 PM,On Motion to Suspend the Rules and Pass,Rota Cultural and Natural Resources Study Act,Passed,116,100,0,25,162,0,0,30,0,0,0,0,278,100,0,55
7,R,112,H RES 516,24-Jan-2012,4:41 PM,On Motion to Suspend the Rules and Agree,Expressing the sense of the House of Representatives that the passage of a fiscal year 2013 Federal budget is of national importance,Passed,234,0,0,7,176,1,1,14,0,0,0,0,410,1,1,21
8,R,112,H R 2070,24-Jan-2012,4:49 PM,"On Motion to Suspend the Rules and Pass, as Amended",World War II Memorial Prayer Act of 2011,Passed,233,0,0,8,153,26,0,13,0,0,0,0,386,26,0,21
9,R,112,H R 3630,24-Jan-2012,4:56 PM,On Motion to Instruct Conferees,Temporary Payroll Tax Cut Continuation Act of 2011,Passed,218,16,0,7,179,0,0,13,0,0,0,0,397,16,0,20
10,R,112,H R 1022,25-Jan-2012,10:18 AM,On Motion to Suspend the Rules and Pass,Buffalo Soldiers in the National Parks Study Act,Passed,159,70,0,12,179,0,0,13,0,0,0,0,338,70,0,25
11,R,112,H R 3801,25-Jan-2012,10:55 AM,On Motion to Suspend the Rules and Pass,Ultralight Aircraft Smuggling Prevention Act,Passed,227,0,0,14,181,0,0,11,0,0,0,0,408,0,0,25
12,R,112,H RES 522,31-Jan-2012,6:54 PM,On Agreeing to the Resolution,Providing for consideration of the bill (H.R. 1173) to repeal the CLASS program,Passed,233,0,0,8,18,157,0,16,0,0,0,0,251,157,0,24
13,R,112,H R 1173,1-Feb-2012,6:15 PM,On Agreeing to the Amendment,None,Failed,1,236,0,4,160,27,0,4,0,0,0,0,161,263,0,8
14,R,112,H R 1173,1-Feb-2012,6:19 PM,On Agreeing to the Amendment,None,Failed,0,235,0,6,157,29,0,5,0,0,0,0,157,264,0,11
15,R,112,H R 1173,1-Feb-2012,6:24 PM,On Agreeing to the Amendment,None,Failed,0,237,0,4,164,23,0,4,0,0,0,0,164,260,0,8
16,R,112,H R 1173,1-Feb-2012,6:29 PM,On Agreeing to the Amendment,None,Failed,0,239,0,2,160,25,0,6,0,0,0,0,160,264,0,8
17,R,112,H R 1173,1-Feb-2012,6:59 PM,On Motion to Recommit with Instructions,Fiscal Responsibility and Retirement Security Act,Failed,0,236,0,5,175,11,0,5,0,0,0,0,175,247,0,10
18,R,112,H R 1173,1-Feb-2012,7:06 PM,On Passage,Fiscal Responsibility and Retirement Security Act,Passed,239,0,0,2,28,159,0,4,0,0,0,0,267,159,0,6
19,R,112,H R 3835,1-Feb-2012,7:13 PM,On Motion to Suspend the Rules and Pass,To extend the pay limitation for Members of Congress and Federal employees,Passed,237,2,0,2,72,115,0,4,0,0,0,0,309,117,0,6
20,R,112,H R 3567,1-Feb-2012,7:20 PM,"On Motion to Suspend the Rules and Pass, as Amended",Welfare Integrity Now for Children and Families Act of 2011,Passed,236,1,0,4,159,26,0,6,0,0,0,0,395,27,0,10
21,R,112,H RES 534,2-Feb-2012,1:49 PM,On Ordering the Previous Question,"Providing for consideration of H.R. 3578, to amend the Balanced Budget and Emergency Deficit Control Act of 1985 to reform the budget baseline, and providing for consideration of H.R. 3582, to amend the Congressional Budget Act of 1974 to provide for macroeconomic analysis of the impact of legislation",Passed,236,1,0,4,2,176,0,13,0,0,0,0,238,177,0,17
22,R,112,H RES 534,2-Feb-2012,1:57 PM,On Agreeing to the Resolution,"Providing for consideration of H.R. 3578, to amend the Balanced Budget and Emergency Deficit Control Act of 1985 to reform the budget baseline, and providing for consideration of H.R. 3582, to amend the Congressional Budget Act of 1974 to provide for macroeconomic analysis of the impact of legislation",Passed,235,0,0,6,3,179,0,9,0,0,0,0,238,179,0,15
23,R,112,H R 3630,2-Feb-2012,2:06 PM,On Motion to Instruct Conferees,Temporary Payroll Tax Cut Continuation Act of 2011,Failed,4,233,0,4,180,3,0,8,0,0,0,0,184,236,0,12
24,R,112,H R 3582,2-Feb-2012,4:45 PM,On Agreeing to the Amendment,None,Failed,0,237,0,4,174,7,0,10,0,0,0,0,174,244,0,14
25,R,112,H R 3582,2-Feb-2012,4:49 PM,On Agreeing to the Amendment,None,Failed,4,231,0,6,173,6,0,12,0,0,0,0,177,237,0,18
26,R,112,H R 3582,2-Feb-2012,4:52 PM,On Agreeing to the Amendment,None,Failed,2,234,0,5,169,9,0,13,0,0,0,0,171,243,0,18
27,R,112,H R 3582,2-Feb-2012,4:56 PM,On Agreeing to the Amendment,None,Failed,5,231,0,5,168,12,0,11,0,0,0,0,173,243,0,16
28,R,112,H R 3582,2-Feb-2012,5:01 PM,On Agreeing to the Amendment,None,Failed,0,238,0,3,174,7,0,10,0,0,0,0,174,245,0,13
29,R,112,H R 3582,2-Feb-2012,5:27 PM,On Motion to Recommit with Instructions,To amend the Congressional Budget Act of 1974 to provide for macroeconomic analysis of the impact of legislation,Failed,2,237,0,2,181,0,0,10,0,0,0,0,183,237,0,12
30,R,112,H R 3582,2-Feb-2012,5:34 PM,On Passage,To amend the Congressional Budget Act of 1974 to provide for macroeconomic analysis of the impact of legislation,Passed,238,0,0,3,4,179,0,8,0,0,0,0,242,179,0,11
31,R,112,H R 3578,3-Feb-2012,11:29 AM,On Motion to Recommit with Instructions,To amend the Balanced Budget and Emergency Deficit Control Act of 1985 to reform the budget baseline,Failed,0,235,0,6,177,3,0,11,0,0,0,0,177,238,0,17
32,R,112,H R 3578,3-Feb-2012,11:35 AM,On Passage,To amend the Balanced Budget and Emergency Deficit Control Act of 1985 to reform the budget baseline,Passed,231,0,0,10,4,177,0,10,0,0,0,0,235,177,0,20
33,R,112,H R 658,3-Feb-2012,11:42 AM,On Agreeing to the Conference Report,FAA Modernization and Reform Act,Passed,224,12,0,5,24,157,0,10,0,0,0,0,248,169,0,15
34,R,112,H RES 537,6-Feb-2012,6:56 PM,On Agreeing to the Resolution,"Providing for consideration of the bill (H.R. 1734) to decrease the deficit by realigning, consolidating, selling, disposing, and improving the efficiency of Federal buildings and other civilian real property, and for other purposes",Passed,226,0,0,15,7,155,0,29,0,0,0,0,233,155,0,44
35,R,112,H R 1162,6-Feb-2012,7:03 PM,"On Motion to Suspend the Rules and Pass, as Amended","To provide the Quileute Indian Tribe Tsunami and Flood Protection, and for other purposes",Passed,220,7,0,14,161,0,0,30,0,0,0,0,381,7,0,44
36,R,112,H R 1734,7-Feb-2012,1:53 PM,On Agreeing to the Amendment,None,Failed,11,227,0,3,180,3,0,8,0,0,0,0,191,230,0,11
37,R,112,H R 1734,7-Feb-2012,2:33 PM,On Motion to Recommit with Instructions,Civilian Property Realignment Act,Failed,1,237,0,3,185,1,0,6,0,0,0,0,186,238,0,9
38,R,112,H R 1734,7-Feb-2012,2:40 PM,On Passage,Civilian Property Realignment Act,Passed,238,1,0,2,21,163,0,8,0,0,0,0,259,164,0,10
39,R,112,H RES 539,7-Feb-2012,2:49 PM,On Agreeing to the Resolution,"Providing for consideration of H.R. 3581, the Budget and Accounting Transparency Act of 2012",Passed,235,0,0,6,4,181,0,7,0,0,0,0,239,181,0,13
40,R,112,H R 3581,7-Feb-2012,4:12 PM,On Agreeing to the Amendment,None,Failed,2,236,0,3,185,2,0,5,0,0,0,0,187,238,0,8
41,R,112,H R 3581,7-Feb-2012,4:37 PM,On Motion to Recommit with Instructions,Budget and Accounting Transparency Act,Failed,1,238,0,2,189,0,0,3,0,0,0,0,190,238,0,5
42,R,112,H R 3581,7-Feb-2012,4:44 PM,On Passage,Budget and Accounting Transparency Act,Passed,238,2,0,1,7,178,0,7,0,0,0,0,245,180,0,8
43,R,112,H RES 540,8-Feb-2012,2:02 PM,On Ordering the Previous Question,"Providing for the consideration of H.R. 3521, the Expedited Legislative Line-Item Veto and Rescissions Act",Passed,234,1,0,6,6,183,0,3,0,0,0,0,240,184,0,9
44,R,112,H RES 540,8-Feb-2012,2:08 PM,On Agreeing to the Resolution,"Providing for the consideration of H.R. 3521, the Expedited Legislative Line-Item Veto and Rescissions Act",Passed,228,1,0,12,10,174,0,8,0,0,0,0,238,175,0,20
45,R,112,H R 3521,8-Feb-2012,3:59 PM,On Agreeing to the Amendment,None,Failed,46,193,0,2,82,107,0,3,0,0,0,0,128,300,0,5
46,R,112,H R 3521,8-Feb-2012,4:17 PM,On Passage,"To amend the Congressional Budget and Impoundment Control Act of 1974 to provide for a legislative line-item veto to expedite consideration of rescissions, and for other purposes",Passed,197,41,0,3,57,132,0,3,0,0,0,0,254,173,0,6
47,R,112,S 2038,9-Feb-2012,10:35 AM,"On Motion to Suspend the Rules and Pass, as Amended","To prohibit Members of Congress and employees of Congress from using nonpublic information derived from their official positions for personal benefit, and for other purposes",Passed,232,2,0,7,185,0,0,7,0,0,0,0,417,2,0,14
48,R,112,H R 3630,9-Feb-2012,10:44 AM,On Motion to Instruct Conferees,Temporary Payroll Tax Cut Continuation Act of 2011,Passed,220,15,0,6,185,0,0,7,0,0,0,0,405,15,0,13
49,R,112,JOURNAL,14-Feb-2012,7:14 PM,On Approving the Journal,None,Passed,176,44,1,20,127,45,0,20,0,0,0,0,303,89,1,40
50,R,112,H RES 547,15-Feb-2012,2:06 PM,On Ordering the Previous Question,"Providing for consideration of H.R. 3408, to set clear rules for the development of U.S. oil shale resources and promote shale technology research and development; consideration of H.R. 3813, to secure the annuities of Federal employees; and consideration of H.R. 7, to authorize funds for transportation safety programs",Passed,227,0,0,14,2,181,0,9,0,0,0,0,229,181,0,23
51,R,112,H RES 547,15-Feb-2012,2:15 PM,On Agreeing to the Resolution,"Providing for consideration of H.R. 3408, to set clear rules for the development of U.S. oil shale resources and promote shale technology research and development; consideration of H.R. 3813, to secure the annuities of Federal employees; and consideration of H.R. 7, to authorize funds for transportation safety programs",Passed,232,4,0,5,3,182,0,7,0,0,0,0,235,186,0,12
52,R,112,H R 2079,15-Feb-2012,2:22 PM,On Motion to Suspend the Rules and Pass,"To designate the facility of the United States Postal Service located at 10 Main Street in East Rockaway, New York, as the “John J. Cook Post Office”",Passed,233,2,0,6,185,0,0,7,0,0,0,0,418,2,0,13
53,R,112,H R 3247,15-Feb-2012,2:29 PM,On Motion to Suspend the Rules and Pass,"To designate the facility of the United States Postal Service located at 1100 Town and Country Commons in Chesterfield, Missouri, as the “Lance Corporal Matthew P. Pathenos Post Office Building”",Passed,235,0,0,6,184,0,0,8,0,0,0,0,419,0,0,14
54,R,112,H R 3248,15-Feb-2012,2:35 PM,On Motion to Suspend the Rules and Pass,"To designate the facility of the United States Postal Service located at 112 South 5th Street in Saint Charles, Missoui, as the “Lance Corporal Drew W. Weaver Post Office Building”",Passed,233,0,0,8,179,0,0,13,0,0,0,0,412,0,0,21
55,R,112,H R 3408,15-Feb-2012,6:12 PM,On Agreeing to the Amendment,None,Failed,2,231,0,8,171,18,0,3,0,0,0,0,173,249,0,11
56,R,112,H R 3408,15-Feb-2012,6:17 PM,On Agreeing to the Amendment,None,Failed,9,230,0,2,164,24,0,4,0,0,0,0,173,254,0,6
57,R,112,H R 3408,15-Feb-2012,6:21 PM,On Agreeing to the Amendment,None,Failed,3,235,0,3,146,41,0,5,0,0,0,0,149,276,0,8
58,R,112,H R 3408,15-Feb-2012,6:25 PM,On Agreeing to the Amendment,None,Failed,14,225,0,2,179,9,0,4,0,0,0,0,193,234,0,6
59,R,112,H R 3408,15-Feb-2012,6:29 PM,On Agreeing to the Amendment,None,Failed,2,235,0,4,158,30,0,4,0,0,0,0,160,265,0,8
60,R,112,H R 3408,15-Feb-2012,6:33 PM,On Agreeing to the Amendment,None,Failed,2,237,0,2,158,30,0,4,0,0,0,0,160,267,0,6
61,R,112,H R 3408,15-Feb-2012,6:37 PM,On Agreeing to the Amendment,None,Failed,7,232,0,2,162,25,0,5,0,0,0,0,169,257,0,7
62,R,112,H R 3408,15-Feb-2012,6:41 PM,On Agreeing to the Amendment,None,Agreed to,228,10,0,3,38,149,0,5,0,0,0,0,266,159,0,8
63,R,112,H R 3408,15-Feb-2012,6:45 PM,On Agreeing to the Amendment,None,Failed,14,225,0,2,174,11,0,7,0,0,0,0,188,236,0,9
64,R,112,H R 3408,16-Feb-2012,5:24 PM,On Agreeing to the Amendment,None,Failed,5,229,0,7,162,24,0,6,0,0,0,0,167,253,0,13
65,R,112,H R 3408,16-Feb-2012,5:28 PM,On Agreeing to the Amendment,None,Failed,12,220,0,9,177,8,0,7,0,0,0,0,189,228,0,16
66,R,112,H R 3408,16-Feb-2012,5:34 PM,On Agreeing to the Amendment,None,Agreed to,232,4,0,5,18,167,0,7,0,0,0,0,250,171,0,12
67,R,112,H R 3408,16-Feb-2012,5:38 PM,On Agreeing to the Amendment,None,Failed,9,227,0,5,159,27,0,6,0,0,0,0,168,254,0,11
68,R,112,H R 3408,16-Feb-2012,5:42 PM,On Agreeing to the Amendment,None,Failed,14,222,0,5,169,16,0,7,0,0,0,0,183,238,0,12
69,R,112,H R 3408,16-Feb-2012,5:46 PM,On Agreeing to the Amendment,None,Agreed to,230,5,0,6,14,172,0,6,0,0,0,0,244,177,0,12
70,R,112,H R 3408,16-Feb-2012,6:14 PM,On Motion to Recommit with Instructions,"Protecting Investment in Oil Shale the Next Generation of Environmental, Energy, and Resource Security Act",Failed,2,232,0,7,174,9,0,9,0,0,0,0,176,241,0,16
71,R,112,H R 3408,16-Feb-2012,6:20 PM,On Passage,"Protecting Investment in Oil Shale the Next Generation of Environmental, Energy, and Resource Security Act",Passed,216,21,0,5,21,166,0,5,0,0,0,0,237,187,0,10
72,R,112,H R 3630,17-Feb-2012,11:40 AM,On Agreeing to the Conference Report,"To provide incentives for the creation of jobs, and for other purposes",Passed,146,91,0,4,147,41,0,4,0,0,0,0,293,132,0,8
73,R,112,H R 347,27-Feb-2012,6:54 PM,On Motion to Suspend the Rules and Concur in the Senate Amendment,Federal Restricted Buildings and Grounds Improvement Act of 2011,Passed,224,2,0,15,164,1,0,27,0,0,0,0,388,3,0,42
74,R,112,H RES 563,28-Feb-2012,1:26 PM,On Agreeing to the Resolution,Providing for consideration of the bill (H.R. 2117) to prohibit the Department of Education from overreaching into academic affairs and program eligibility under title IV of the Higher Education Act of 1965,Passed,234,0,0,7,10,171,0,11,0,0,0,0,244,171,0,18
75,R,112,H R 2117,28-Feb-2012,3:43 PM,On Agreeing to the Amendment,None,Failed,0,236,0,5,170,11,0,11,0,0,0,0,170,247,0,16
76,R,112,H R 2117,28-Feb-2012,3:52 PM,On Agreeing to the Amendment,None,Failed,1,232,0,8,159,23,0,10,0,0,0,0,160,255,0,18
77,R,112,H R 2117,28-Feb-2012,3:57 PM,On Agreeing to the Amendment,None,Failed,21,214,0,6,178,3,0,11,0,0,0,0,199,217,0,17
78,R,112,H R 2117,28-Feb-2012,4:24 PM,On Motion to Recommit with Instructions,Protecting Academic Freedom in Higher Education Act,Failed,0,233,0,8,176,8,0,8,0,0,0,0,176,241,0,16
79,R,112,H R 2117,28-Feb-2012,4:31 PM,On Passage,Protecting Academic Freedom in Higher Education Act,Passed,234,0,0,7,69,114,0,9,0,0,0,0,303,114,0,16
80,R,112,H RES 566,29-Feb-2012,2:07 PM,On Ordering the Previous Question,"Providing for consideration of the bill (H.R. 1837) to address certain water-related concerns on the San Joaquin River, and for other purposes",Passed,235,1,0,5,6,177,0,9,0,0,0,0,241,178,0,14
81,R,112,H RES 566,29-Feb-2012,2:15 PM,On Agreeing to the Resolution,"Providing for consideration of the bill (H.R. 1837) to address certain water-related concerns on the San Joaquin River, and for other purposes",Passed,236,0,0,5,9,173,0,10,0,0,0,0,245,173,0,15
82,R,112,JOURNAL,29-Feb-2012,2:22 PM,On Approving the Journal,None,Passed,176,52,1,12,107,75,1,9,0,0,0,0,283,127,2,21
83,R,112,H R 1837,29-Feb-2012,5:37 PM,On Agreeing to the Amendment,None,Failed,2,231,0,8,176,8,0,8,0,0,0,0,178,239,0,16
84,R,112,H R 1837,29-Feb-2012,5:41 PM,On Agreeing to the Amendment,None,Failed,1,236,0,4,177,6,0,9,0,0,0,0,178,242,0,13
85,R,112,H R 1837,29-Feb-2012,5:44 PM,On Agreeing to the Amendment,None,Failed,1,234,0,6,176,9,0,7,0,0,0,0,177,243,0,13
86,R,112,H R 1837,29-Feb-2012,5:48 PM,On Agreeing to the Amendment,None,Failed,2,236,0,3,179,7,0,6,0,0,0,0,181,243,0,9
87,R,112,H R 1837,29-Feb-2012,5:52 PM,On Agreeing to the Amendment,None,Failed,1,237,0,3,173,13,0,6,0,0,0,0,174,250,0,9
88,R,112,H R 1837,29-Feb-2012,5:55 PM,On Agreeing to the Amendment,None,Failed,0,239,0,2,178,8,0,6,0,0,0,0,178,247,0,8
89,R,112,H R 1837,29-Feb-2012,6:00 PM,On Agreeing to the Amendment,None,Failed,1,236,0,4,179,8,0,5,0,0,0,0,180,244,0,9
90,R,112,H R 1837,29-Feb-2012,6:30 PM,On Motion to Recommit with Instructions,Sacramento-San Joaquin Valley Water Reliability Act,Failed,0,239,0,2,178,9,0,5,0,0,0,0,178,248,0,7
91,R,112,H R 1837,29-Feb-2012,6:36 PM,On Passage,Sacramento-San Joaquin Valley Water Reliability Act,Passed,236,1,0,4,10,174,1,7,0,0,0,0,246,175,1,11
92,R,112,H RES 562,1-Mar-2012,10:43 AM,On Agreeing to the Resolution,"Directing the Office of the Historian to compile oral histories from current and former Members of the House of Representatives involved in the historic and annual Selma to Montgomery, Alabama, marches, as well as the civil rights movement in general, for the purposes of expanding or augmenting the historic record",Passed,235,0,0,6,183,0,0,9,0,0,0,0,418,0,0,15
93,R,112,S 1134,1-Mar-2012,10:52 AM,On Motion to Suspend the Rules and Pass,St. Croix River Crossing Project Authorization Act,Passed,219,16,0,6,120,64,0,8,0,0,0,0,339,80,0,14
94,R,112,H RES 556,1-Mar-2012,11:01 AM,"On Motion to Suspend the Rules and Agree, as Amended","Condemning the Government of Iran for its continued persecution, imprisonment, and sentencing of Youcef Nadarkhani of the charge of apostasy",Passed,234,0,0,7,183,1,0,8,0,0,0,0,417,1,0,15
95,R,112,H R 3637,5-Mar-2012,6:57 PM,On Motion to Suspend the Rules and Pass,Roy Schallern Rood Post Office Building,Passed,217,2,0,22,145,0,0,47,0,0,0,0,362,2,0,69
96,R,112,H R 4105,6-Mar-2012,2:08 PM,On Motion to Suspend the Rules and Pass,"To apply the countervailing duty provisions of the Tariff Act of 1930 to nonmarket economy countries, and for other purposes",Passed,194,39,0,8,176,0,0,16,0,0,0,0,370,39,0,24
97,R,112,H RES 570,6-Mar-2012,2:34 PM,On Ordering the Previous Question,"Providing for consideration of H.R. 2842, the Bureau of Reclamation Small Conduit Hydropower Development and Rural Jobs Act",Passed,228,0,0,13,4,177,0,11,0,0,0,0,232,177,0,24
98,R,112,H R 2842,7-Mar-2012,2:05 PM,On Agreeing to the Amendment,None,Failed,0,238,0,3,168,15,0,8,0,0,0,0,168,253,0,11
99,R,112,H R 2842,7-Mar-2012,2:34 PM,On Motion to Recommit with Instructions,Bureau of Reclamation Small Conduit Hydropower Development and Rural Jobs Act,Failed,1,235,0,5,181,2,0,8,0,0,0,0,182,237,0,13
100,R,112,H R 2842,7-Mar-2012,2:43 PM,On Passage,Bureau of Reclamation Small Conduit Hydropower Development and Rural Jobs Act,Passed,237,0,0,4,28,154,0,9,0,0,0,0,265,154,0,13
101,R,112,H RES 572,7-Mar-2012,2:50 PM,On Ordering the Previous Question,"Providing for consideration of H. R. 3606, to increase American job creation and economic growth by improving access to the public capital markets for emerging growth companies",Passed,235,1,0,5,9,176,0,6,0,0,0,0,244,177,0,11
102,R,112,H RES 572,7-Mar-2012,3:01 PM,On Agreeing to the Resolution,"Providing for consideration of H. R. 3606, to increase American job creation and economic growth by improving access to the public capital markets for emerging growth companies",Passed,235,0,0,6,17,166,0,8,0,0,0,0,252,166,0,14
103,R,112,H R 3606,7-Mar-2012,6:22 PM,On Agreeing to the Amendment,None,Failed,1,232,0,8,163,13,0,15,0,0,0,0,164,245,0,23
104,R,112,H R 3606,7-Mar-2012,6:26 PM,On Agreeing to the Amendment,None,Failed,3,232,0,6,166,12,0,13,0,0,0,0,169,244,0,19
105,R,112,H R 3606,7-Mar-2012,6:33 PM,On Agreeing to the Amendment,None,Failed,0,237,0,4,161,22,0,8,0,0,0,0,161,259,0,12
106,R,112,H R 3606,7-Mar-2012,6:37 PM,On Agreeing to the Amendment,None,Failed,12,225,0,4,173,11,0,7,0,0,0,0,185,236,0,11
107,R,112,H R 3606,8-Mar-2012,12:18 PM,On Agreeing to the Amendment,None,Failed,3,230,0,8,172,9,0,10,0,0,0,0,175,239,0,18
108,R,112,H R 3606,8-Mar-2012,12:22 PM,On Agreeing to the Amendment,None,Failed,5,226,0,10,167,10,0,14,0,0,0,0,172,236,0,24
109,R,112,H R 3606,8-Mar-2012,12:50 PM,On Motion to Recommit with Instructions,To increase American job creation and economic growth by improving access to the public capital markets for emerging growth companies,Failed,1,232,0,8,169,12,0,10,0,0,0,0,170,244,0,18
110,R,112,H R 3606,8-Mar-2012,1:04 PM,On Passage,To increase American job creation and economic growth by improving access to the public capital markets for emerging growth companies,Passed,232,0,0,9,158,23,0,10,0,0,0,0,390,23,0,19
111,R,112,H R 3992,19-Mar-2012,6:55 PM,On Motion to Suspend the Rules and Pass,To allow otherwise eligible Israeli nationals to receive E-2 nonimmigrant visas if similarly situated United States nationals are eligible for similar nonimmigrant status in Israel,Passed,218,0,0,23,153,0,0,38,0,0,0,0,371,0,0,61
112,R,112,H RES 587,20-Mar-2012,2:32 PM,On Consideration of the Resolution,"Providing for consideration of H. R. 2087, to remove restrictions from a parcel of land situated in the Atlantic District, Accomack County, Virginia",Passed,226,0,0,15,1,172,0,17,0,0,0,0,227,172,0,32
113,R,112,H RES 587,20-Mar-2012,3:17 PM,On Agreeing to the Resolution,"Providing for consideration of H. R. 2087, to remove restrictions from a parcel of land situated in the Atlantic District, Accomack County, Virginia",Passed,227,0,0,14,5,170,0,15,0,0,0,0,232,170,0,29
114,R,112,H R 665,20-Mar-2012,3:26 PM,"On Motion to Suspend the Rules and Pass, as Amended",Excess Federal Building and Property Disposal Act,Passed,227,0,0,14,176,0,0,14,0,0,0,0,403,0,0,28
115,R,112,H R 2087,20-Mar-2012,4:49 PM,On Agreeing to the Amendment,None,Failed,5,220,0,16,173,6,0,11,0,0,0,0,178,226,0,27
116,R,112,H R 2087,20-Mar-2012,5:16 PM,On Motion to Recommit with Instructions,"To remove restrictions from a parcel of land situated in the Atlantic District, Accomack County, Virginia",Failed,1,224,0,16,179,2,0,9,0,0,0,0,180,226,0,25
117,R,112,H R 2087,20-Mar-2012,5:25 PM,On Passage,"To remove restrictions from a parcel of land situated in the Atlantic District, Accomack County, Virginia",Passed,223,3,0,15,17,161,0,12,0,0,0,0,240,164,0,27
118,R,112,H RES 591,21-Mar-2012,2:42 PM,On Ordering the Previous Question,Providing for consideration of the bill (H.R. 5) to improve patient access to health care services and provide improved medical care by reducing the excessive burden the liability system places on the health care delivery system,Passed,229,1,1,10,2,178,0,10,0,0,0,0,231,179,1,20
119,R,112,H RES 591,21-Mar-2012,2:51 PM,On Agreeing to the Resolution,Providing for consideration of the bill (H.R. 5) to improve patient access to health care services and provide improved medical care by reducing the excessive burden the liability system places on the health care delivery system,Passed,228,4,1,8,5,178,0,7,0,0,0,0,233,182,1,15
120,R,112,H R 886,21-Mar-2012,2:58 PM,On Motion to Suspend the Rules and Concur in the Senate Amendment,"To require the Secretary of the Treasury to mint coins in commemoration of the 225th anniversary of the establishment of the Nation’s first Federal law enforcement agency, the United States Marshals Service",Passed,227,1,2,11,182,1,0,7,0,0,0,0,409,2,2,18
121,R,112,JOURNAL,21-Mar-2012,3:05 PM,On Approving the Journal,None,Passed,179,47,2,13,129,54,1,6,0,0,0,0,308,101,3,19
122,R,112,H R 5,22-Mar-2012,11:45 AM,On Agreeing to the Amendment,None,Agreed to,223,5,2,11,11,168,0,11,0,0,0,0,234,173,2,22
123,R,112,H R 5,22-Mar-2012,11:50 AM,On Agreeing to the Amendment,None,Failed,4,224,1,12,175,4,0,11,0,0,0,0,179,228,1,23
124,R,112,H R 5,22-Mar-2012,11:56 AM,On Agreeing to the Amendment,None,Agreed to,224,4,1,12,27,153,0,10,0,0,0,0,251,157,1,22
125,R,112,H R 5,22-Mar-2012,12:29 PM,On Motion to Recommit with Instructions,To improve patient access to health care services and provide improved medical care by reducing the excessive burden the liability system places on the health care delivery system,Failed,1,228,2,10,179,1,0,10,0,0,0,0,180,229,2,20
126,R,112,H R 5,22-Mar-2012,12:36 PM,On Passage,To improve patient access to health care services and provide improved medical care by reducing the excessive burden the liability system places on the health care delivery system,Passed,216,10,4,11,7,171,0,12,0,0,0,0,223,181,4,23
127,R,112,H R 2779,26-Mar-2012,6:56 PM,"On Motion to Suspend the Rules and Pass, as Amended",To exempt inter-affiliate swaps from certain regulatory requirements put in place by the Dodd-Frank Wall Street Reform and Consumer Protection Act,Passed,223,0,0,18,134,36,0,20,0,0,0,0,357,36,0,38
128,R,112,H R 2682,26-Mar-2012,7:03 PM,"On Motion to Suspend the Rules and Pass, as Amended",Business Risk Mitigation and Price Stabilization Act,Passed,224,0,0,17,146,24,0,20,0,0,0,0,370,24,0,37
129,R,112,JOURNAL,26-Mar-2012,7:11 PM,On Approving the Journal,None,Passed,182,39,2,18,128,41,2,19,0,0,0,0,310,80,4,37
130,R,112,H RES 595,27-Mar-2012,2:01 PM,On Ordering the Previous Question,"Providing for consideration of H. R. 3309, Federal Communications Commission Process Reform Act of 2012",Passed,235,0,0,6,1,182,0,7,0,0,0,0,236,182,0,13
131,R,112,H RES 595,27-Mar-2012,2:10 PM,On Agreeing to the Resolution,"Providing for consideration of H. R. 3309, Federal Communications Commission Process Reform Act of 2012",Passed,235,0,0,6,7,177,0,6,0,0,0,0,242,177,0,12
132,R,112,H R 3606,27-Mar-2012,2:17 PM,On Motion to Suspend the Rules and Concur in the Senate Amendment,To increase American job creation and economic growth by improving access to the public capital markets for emerging growth companies,Passed,235,0,0,6,145,41,0,4,0,0,0,0,380,41,0,10
133,R,112,H R 3298,27-Mar-2012,2:26 PM,On Motion to Suspend the Rules and Pass,Homes for Heroes Act,Passed,230,5,0,6,184,0,0,6,0,0,0,0,414,5,0,12
134,R,112,H R 3309,27-Mar-2012,5:54 PM,On Agreeing to the Amendment,None,Failed,18,216,0,7,178,3,0,9,0,0,0,0,196,219,0,16
135,R,112,H R 3309,27-Mar-2012,5:58 PM,On Agreeing to the Amendment,None,Failed,5,230,0,6,174,8,0,8,0,0,0,0,179,238,0,14
136,R,112,H R 3309,27-Mar-2012,6:02 PM,On Agreeing to the Amendment,None,Failed,13,220,0,8,181,2,0,7,0,0,0,0,194,222,0,15
137,R,112,H R 3309,27-Mar-2012,6:31 PM,On Motion to Recommit with Instructions,To amend the Communications Act of 1934 to provide for greater transparency and efficiency in the procedures followed by the Federal Communications Commission,Failed,1,234,0,6,183,2,0,5,0,0,0,0,184,236,0,11
138,R,112,H R 3309,27-Mar-2012,6:37 PM,On Passage,To amend the Communications Act of 1934 to provide for greater transparency and efficiency in the procedures followed by the Federal Communications Commission,Passed,235,0,0,6,12,174,0,4,0,0,0,0,247,174,0,10
139,R,112,H RES 597,28-Mar-2012,2:26 PM,On Ordering the Previous Question,"Providing for consideration of H. Con. Res. 112, establishing the budget for the United States Government for fiscal year 2013 and setting forth appropriate budgetary levels for fiscal years 2014 through 2022, and providing for consideration of motions to suspend the rules",Passed,234,0,0,7,1,183,0,6,0,0,0,0,235,183,0,13
140,R,112,H RES 597,28-Mar-2012,2:41 PM,On Agreeing to the Resolution,"Providing for consideration of H. Con. Res. 112, establishing the budget for the United States Government for fiscal year 2013 and setting forth appropriate budgetary levels for fiscal years 2014 through 2022, and providing for consideration of motions to suspend the rules",Passed,236,3,0,2,5,181,0,4,0,0,0,0,241,184,0,6
141,R,112,H R 1339,28-Mar-2012,2:49 PM,"On Motion to Suspend the Rules and Pass, as Amended","To amend title 32, United States Code, the body of laws of the United States dealing with the National Guard, to recognize the City of Salem, Massachusetts, as the Birthplace of the National Guard of the United States",Passed,227,6,4,4,186,0,0,4,0,0,0,0,413,6,4,8
142,R,112,JOURNAL,28-Mar-2012,2:56 PM,On Approving the Journal,None,Passed,178,55,2,6,122,56,2,10,0,0,0,0,300,111,4,16
143,R,112,H CON RES 112,28-Mar-2012,9:32 PM,On Agreeing to the Amendment,None,Failed,0,239,0,2,0,175,0,15,0,0,0,0,0,414,0,17
144,R,112,H CON RES 112,28-Mar-2012,9:39 PM,On Agreeing to the Amendment,None,Failed,0,239,0,2,107,75,0,8,0,0,0,0,107,314,0,10
145,R,112,H CON RES 112,28-Mar-2012,9:46 PM,On Agreeing to the Amendment,None,Failed,16,223,0,2,22,159,2,7,0,0,0,0,38,382,2,9
146,R,112,H RES 600,29-Mar-2012,10:29 AM,On Ordering the Previous Question,"Providing for consideration of the bill (H.R. 4281) to provide an extension of Federal-aid highway, highway safety, motor carrier safety, transit, and other programs funded out of the Highway Trust Fund pending enactment of a multiyear law reauthorizing such programs, and for other purposes",Passed,236,0,0,5,1,178,0,11,0,0,0,0,237,178,0,16
147,R,112,H R 4281,29-Mar-2012,11:55 AM,On Passage,"To provide an extension of Federal-aid highway, highway safety, motor carrier safety, transit, and other programs funded out of the Highway Trust Fund pending enactment of a multiyear law reauthorizing such programs",Passed,229,10,0,2,37,148,0,5,0,0,0,0,266,158,0,7
148,R,112,H CON RES 112,29-Mar-2012,12:14 PM,On Agreeing to the Amendment,None,Failed,0,239,0,2,78,107,0,5,0,0,0,0,78,346,0,7
149,R,112,H CON RES 112,29-Mar-2012,1:27 PM,On Agreeing to the Amendment,None,Failed,136,104,0,1,0,181,3,6,0,0,0,0,136,285,3,7
150,R,112,H CON RES 112,29-Mar-2012,2:37 PM,On Agreeing to the Amendment,None,Failed,0,240,0,1,163,22,0,5,0,0,0,0,163,262,0,6
151,R,112,H CON RES 112,29-Mar-2012,3:27 PM,On Agreeing to the Resolution,Establishing the budget for the United States Government for fiscal year 2013 and setting forth appropriate budgetary levels for fiscal years 2014 through 2022,Passed,228,10,0,3,0,181,0,9,0,0,0,0,228,191,0,12
152,R,112,H R 3001,16-Apr-2012,6:52 PM,On Motion to Suspend the Rules and Pass,Raoul Wallenberg Centennial Celebration Act,Passed,216,0,0,25,161,0,0,29,0,0,0,0,377,0,0,54
153,R,112,H R 4040,16-Apr-2012,7:00 PM,On Motion to Suspend the Rules and Pass,To provide for the award of a gold medal on behalf of Congress to Jack Nicklaus in recognition of his service to the Nation in promoting excellence and good sportsmanship in golf,Passed,213,4,1,23,160,0,0,30,0,0,0,0,373,4,1,53
154,R,112,H RES 614,17-Apr-2012,1:17 PM,On Question of Consideration of the Resolution,"Providing for consideration of the bill (H.R. 4089) to protect and enhance opportunities for recreational hunting, fishing and shooting, and for other purposes",Passed,233,0,0,8,1,175,0,14,0,0,0,0,234,175,0,22
155,R,112,H RES 614,17-Apr-2012,2:55 PM,On Ordering the Previous Question,"Providing for consideration of the bill (H.R. 4089) to protect and enhance opportunities for recreational hunting, fishing and shooting, and for other purposes",Passed,234,1,0,6,1,178,0,11,0,0,0,0,235,179,0,17
156,R,112,H RES 614,17-Apr-2012,3:05 PM,On Agreeing to the Resolution,"Providing for consideration of the bill (H.R. 4089) to protect and enhance opportunities for recreational hunting, fishing and shooting, and for other purposes",Passed,228,4,0,9,0,180,0,10,0,0,0,0,228,184,0,19
157,R,112,H R 1815,17-Apr-2012,3:12 PM,On Motion to Suspend the Rules and Pass,Lena Horne Recognition Act,Passed,230,2,0,9,180,0,0,10,0,0,0,0,410,2,0,19
158,R,112,H R 4089,17-Apr-2012,6:18 PM,On Agreeing to the Amendment,None,Failed,6,228,0,7,146,32,0,12,0,0,0,0,152,260,0,19
159,R,112,H R 4089,17-Apr-2012,6:22 PM,On Agreeing to the Amendment,None,Failed,2,234,0,5,136,45,0,9,0,0,0,0,138,279,0,14
160,R,112,H R 4089,17-Apr-2012,6:26 PM,On Agreeing to the Amendment,None,Failed,10,226,0,5,145,36,0,9,0,0,0,0,155,262,0,14
161,R,112,H R 4089,17-Apr-2012,6:30 PM,On Agreeing to the Amendment,None,Failed,8,228,0,5,168,16,0,6,0,0,0,0,176,244,0,11
162,R,112,H R 4089,17-Apr-2012,6:35 PM,On Agreeing to the Amendment,None,Agreed to,216,21,0,4,7,177,0,6,0,0,0,0,223,198,0,10
163,R,112,H R 4089,17-Apr-2012,7:04 PM,On Motion to Recommit with Instructions,Sportsmen’s Heritage Act of 2012,Failed,1,236,0,4,159,25,0,6,0,0,0,0,160,261,0,10
164,R,112,H R 4089,17-Apr-2012,7:13 PM,On Passage,Sportsmen’s Heritage Act of 2012,Passed,235,2,0,4,39,144,0,7,0,0,0,0,274,146,0,11
165,R,112,H RES 619,18-Apr-2012,1:39 PM,On Ordering the Previous Question,"Providing for consideration of the bill (H.R. 4348) to provide an extension of Federal-aid highway, highway safety, motor carrier safety, transit, and other programs funded out of the Highway Trust Fund pending enactment of multiyear law reauthorizing such programs, and for other purposes",Passed,239,0,0,2,4,180,0,6,0,0,0,0,243,180,0,8
166,R,112,H RES 619,18-Apr-2012,1:46 PM,On Agreeing to the Resolution,"Providing for consideration of the bill (H.R. 4348) to provide an extension of Federal-aid highway, highway safety, motor carrier safety, transit, and other programs funded out of the Highway Trust Fund pending enactment of multiyear law reauthorizing such programs, and for other purposes",Passed,239,0,0,2,7,177,0,6,0,0,0,0,246,177,0,8
167,R,112,JOURNAL,18-Apr-2012,1:52 PM,On Approving the Journal,None,Passed,174,60,1,6,121,58,1,10,0,0,0,0,295,118,2,16
168,R,112,H R 4348,18-Apr-2012,4:18 PM,On Agreeing to the Amendment,None,Agreed to,237,1,0,3,18,164,0,8,0,0,0,0,255,165,0,11
169,R,112,H R 4348,18-Apr-2012,4:48 PM,On Motion to Recommit with Instructions,"To provide an extension of Federal-aid highway, highway safety, motor carrier safety, transit, and other programs funded out of the Highway Trust Fund pending enactment of a multiyear law reauthorizing such programs, and for other purposes",Failed,1,237,0,3,175,5,0,10,0,0,0,0,176,242,0,13
170,R,112,H R 4348,18-Apr-2012,4:58 PM,On Passage,"To provide an extension of Federal-aid highway, highway safety, motor carrier safety, transit, and other programs funded out of the Highway Trust Fund pending enactment of a multiyear law reauthorizing such programs, and for other purposes",Passed,224,14,0,3,69,113,0,8,0,0,0,0,293,127,0,11
171,R,112,H R 2453,18-Apr-2012,5:06 PM,"On Motion to Suspend the Rules and Pass, as Amended",Mark Twain Commemorative Coin Act,Passed,228,4,2,7,180,0,0,10,0,0,0,0,408,4,2,17
172,R,112,H RES 620,19-Apr-2012,10:41 AM,On Ordering the Previous Question,"Providing for consideration of H.R. 9, Small Business Tax Cut Act",Passed,229,0,0,12,5,179,0,6,0,0,0,0,234,179,0,18
173,R,112,H RES 620,19-Apr-2012,10:50 AM,"On Agreeing to the Resolution, as Amended","Providing for consideration of H.R. 9, Small Business Tax Cut Act",Passed,227,0,0,14,7,178,0,5,0,0,0,0,234,178,0,19
174,R,112,JOURNAL,19-Apr-2012,10:57 AM,On Approving the Journal,None,Passed,175,51,2,13,115,67,1,7,0,0,0,0,290,118,3,20
175,R,112,H R 9,19-Apr-2012,1:17 PM,On Agreeing to the Amendment,None,Failed,0,229,0,12,175,7,0,8,0,0,0,0,175,236,0,20
176,R,112,H R 9,19-Apr-2012,1:45 PM,On Motion to Recommit with Instructions,Small Business Tax Cut Act,Failed,1,227,0,13,178,2,0,10,0,0,0,0,179,229,0,23
177,R,112,H R 9,19-Apr-2012,1:55 PM,On Passage,Small Business Tax Cut Act,Passed,217,10,1,13,18,163,0,9,0,0,0,0,235,173,1,22
178,R,112,H R 2157,24-Apr-2012,7:13 PM,On Motion to Suspend the Rules and Pass,"To facilitate a land exchange involoving certain National Forest System lands in the Inyo National Forest, and for other purposes",Passed,217,2,0,22,159,0,0,31,0,0,0,0,376,2,0,53
179,R,112,H R 4348,25-Apr-2012,5:11 PM,On Motion to Instruct Conferees,"To provide an extension of Federal-aid highway, highway safety, motor carrier safety, transit, and other programs funded out of the Highway Trust Fund pending enactment of a multiyear law reauthorizing such programs, and for other purposes",Failed,1,238,0,2,180,4,0,6,0,0,0,0,181,242,0,8
180,R,112,H R 3336,25-Apr-2012,5:19 PM,"On Motion to Suspend the Rules and Pass, as Amended",Small Business Credit Availability Act,Passed,239,0,0,2,73,111,0,6,0,0,0,0,312,111,0,8
181,R,112,H R 1038,25-Apr-2012,5:26 PM,"On Motion to Suspend the Rules and Pass, as Amended",To authorize the conveyance of two small parcels of land within the boundaries of the Coconino National Forest containing private improvements that were developed based upon the reliance of the landowners in an erroneous survey conducted in May 1960,Passed,237,1,0,3,184,0,0,6,0,0,0,0,421,1,0,9
182,R,112,H RES 631,26-Apr-2012,2:05 PM,On Ordering the Previous Question,Providing for consideration of the bill (H.R. 3523) Cyber Intelligence Sharing and Protection Act; providing for consideration of motions to suspend the rules; providing for consideration of the bill (H.R. 4628) to extend student loan interest rates for undergraduate Federal Direct Stafford Loans,Passed,236,0,0,5,5,179,0,6,0,0,0,0,241,179,0,11
183,R,112,H RES 631,26-Apr-2012,2:14 PM,On Agreeing to the Resolution,Providing for consideration of the bill (H.R. 3523) Cyber Intelligence Sharing and Protection Act; providing for consideration of motions to suspend the rules; providing for consideration of the bill (H.R. 4628) to extend student loan interest rates for undergraduate Federal Direct Stafford Loans,Passed,234,1,0,6,2,184,0,4,0,0,0,0,236,185,0,10
184,R,112,H R 3523,26-Apr-2012,5:23 PM,On Agreeing to the Amendment,None,Failed,11,222,0,8,156,21,0,13,0,0,0,0,167,243,0,21
185,R,112,H R 3523,26-Apr-2012,5:27 PM,On Agreeing to the Amendment,None,Agreed to,233,0,0,8,179,0,0,11,0,0,0,0,412,0,0,19
186,R,112,H R 3523,26-Apr-2012,5:31 PM,On Agreeing to the Amendment,None,Agreed to,231,2,0,8,179,1,0,10,0,0,0,0,410,3,0,18
187,R,112,H R 3523,26-Apr-2012,5:36 PM,On Agreeing to the Amendment,None,Agreed to,234,0,0,7,181,0,0,9,0,0,0,0,415,0,0,16
188,R,112,H R 3523,26-Apr-2012,5:40 PM,On Agreeing to the Amendment,None,Agreed to,234,0,0,7,182,0,0,8,0,0,0,0,416,0,0,15
189,R,112,H R 3523,26-Apr-2012,5:44 PM,On Agreeing to the Amendment,None,Agreed to,233,0,0,8,181,1,0,8,0,0,0,0,414,1,0,16
190,R,112,H R 3523,26-Apr-2012,5:47 PM,On Agreeing to the Amendment,None,Agreed to,233,1,0,7,180,2,0,8,0,0,0,0,413,3,0,15
191,R,112,H R 3523,26-Apr-2012,6:23 PM,On Motion to Recommit with Instructions,"To provide for the sharing of certain cyber threat intelligence and cyber threat information between the intelligence community and cybersecurity entities, and for other purposes",Failed,1,233,0,7,182,0,0,8,0,0,0,0,183,233,0,15
192,R,112,H R 3523,26-Apr-2012,6:31 PM,On Passage,"To provide for the sharing of certain cyber threat intelligence and cyber threat information between the intelligence community and cybersecurity entities, and for other purposes",Passed,206,28,0,7,42,140,0,8,0,0,0,0,248,168,0,15
193,R,112,H R 2096,27-Apr-2012,12:04 PM,"On Motion to Suspend the Rules and Pass, as Amended","To advance cybersecurity research, development, and technical standards, and for other purposes",Passed,220,10,0,11,175,0,0,15,0,0,0,0,395,10,0,26
194,R,112,H R 4628,27-Apr-2012,12:32 PM,On Motion to Recommit with Instructions,To extend student loan interest rates for undergraduate Federal Direct Stafford Loans,Failed,0,231,0,10,178,0,0,12,0,0,0,0,178,231,0,22
195,R,112,H R 4628,27-Apr-2012,12:45 PM,On Passage,To extend student loan interest rates for undergraduate Federal Direct Stafford Loans,Passed,202,30,0,10,13,165,0,12,0,0,0,0,215,195,0,22
196,R,112,H CON RES 105,7-May-2012,6:55 PM,On Motion to Suspend the Rules and Agree,Authorizing the use of Emancipation Hall in the Capitol Visitor Center for an event to celebrate the birthday of King Kamehameha,Passed,213,0,0,28,163,0,0,27,0,0,0,0,376,0,0,55
197,R,112,H CON RES 117,7-May-2012,7:03 PM,On Motion to Suspend the Rules and Agree,Authorizing the use of the Capitol Grounds for the National Peace Officers’ Memorial Service,Passed,216,0,0,25,161,0,0,29,0,0,0,0,377,0,0,54
198,R,112,H CON RES 118,7-May-2012,7:10 PM,On Motion to Suspend the Rules and Agree,Authorizing the use of the Capitol Grounds for the District of Columbia Special Olympics Law Enforcement Torch Run,Passed,215,0,0,26,160,0,0,30,0,0,0,0,375,0,0,56
199,R,112,H RES 643,8-May-2012,1:48 PM,On Ordering the Previous Question,"Providing for consideration of H.R. 5326, making appropriations for the Departments of Commerce and Justice, Science, and Related Agencies for the fiscal year ending September 30, 2013, and for other purposes",Passed,231,0,0,10,4,174,0,12,0,0,0,0,235,174,0,22
200,R,112,H RES 643,8-May-2012,1:57 PM,On Agreeing to the Resolution,"Providing for consideration of H.R. 5326, making appropriations for the Departments of Commerce and Justice, Science, and Related Agencies for the fiscal year ending September 30, 2013, and for other purposes",Passed,228,0,0,13,0,181,0,9,0,0,0,0,228,181,0,22
201,R,112,JOURNAL,8-May-2012,2:04 PM,On Approving the Journal,None,Passed,175,53,2,11,121,55,1,13,0,0,0,0,296,108,3,24
202,R,112,H R 5326,8-May-2012,6:02 PM,On Agreeing to the Amendment,None,Failed,14,216,0,11,127,45,0,18,0,0,0,0,141,261,0,29
203,R,112,H R 5326,8-May-2012,6:08 PM,On Agreeing to the Amendment,None,Failed,133,100,0,8,4,170,0,16,0,0,0,0,137,270,0,24
204,R,112,H R 5326,8-May-2012,6:13 PM,On Agreeing to the Amendment,None,Failed,121,112,0,8,0,175,0,15,0,0,0,0,121,287,0,23
205,R,112,H R 5326,8-May-2012,6:17 PM,On Agreeing to the Amendment,None,Failed,48,185,0,8,142,33,0,15,0,0,0,0,190,218,0,23
206,R,112,H R 5326,8-May-2012,6:20 PM,On Agreeing to the Amendment,None,Failed,172,61,0,8,2,172,0,16,0,0,0,0,174,233,0,24
207,R,112,H R 5326,8-May-2012,6:24 PM,On Agreeing to the Amendment,None,Failed,129,104,0,8,0,175,0,15,0,0,0,0,129,279,0,23
208,R,112,H R 5326,8-May-2012,6:27 PM,On Agreeing to the Amendment,None,Failed,147,86,0,8,0,173,0,17,0,0,0,0,147,259,0,25
209,R,112,H R 5326,8-May-2012,6:32 PM,On Agreeing to the Amendment,None,Agreed to,216,17,0,8,3,172,0,15,0,0,0,0,219,189,0,23
210,R,112,H R 5326,8-May-2012,6:37 PM,On Agreeing to the Amendment,None,Agreed to,163,70,0,8,46,129,0,15,0,0,0,0,209,199,0,23
211,R,112,H R 5326,8-May-2012,6:41 PM,On Agreeing to the Amendment,None,Failed,163,70,0,8,5,169,0,16,0,0,0,0,168,239,0,24
212,R,112,H R 5326,8-May-2012,6:46 PM,On Agreeing to the Amendment,None,Agreed to,227,6,0,8,98,75,0,17,0,0,0,0,325,81,0,25
213,R,112,H R 5326,8-May-2012,11:50 PM,On Agreeing to the Amendment,None,Failed,3,229,0,9,96,82,0,12,0,0,0,0,99,311,0,21
214,R,112,H R 5326,8-May-2012,11:54 PM,On Agreeing to the Amendment,None,Agreed to,61,171,0,9,145,33,0,12,0,0,0,0,206,204,0,21
215,R,112,H R 5326,8-May-2012,11:57 PM,On Agreeing to the Amendment,None,Failed,193,38,0,10,6,173,0,11,0,0,0,0,199,211,0,21
216,R,112,H R 5326,9-May-2012,12:00 AM,On Agreeing to the Amendment,None,Failed,4,229,0,8,92,85,0,13,0,0,0,0,96,314,0,21
217,R,112,H R 5326,9-May-2012,12:04 AM,On Agreeing to the Amendment,None,Failed,121,112,0,8,0,179,0,11,0,0,0,0,121,291,0,19
218,R,112,H R 5326,9-May-2012,12:07 AM,On Agreeing to the Amendment,None,Failed,163,69,0,9,2,177,0,11,0,0,0,0,165,246,0,20
219,R,112,H R 5326,9-May-2012,12:10 AM,On Agreeing to the Amendment,None,Failed,122,110,0,9,0,179,0,11,0,0,0,0,122,289,0,20
220,R,112,H R 5326,9-May-2012,12:14 AM,On Agreeing to the Amendment,None,Agreed to,226,6,0,9,12,167,0,11,0,0,0,0,238,173,0,20
221,R,112,H R 5326,9-May-2012,12:16 AM,On Agreeing to the Amendment,None,Failed,156,77,0,8,4,174,0,12,0,0,0,0,160,251,0,20
222,R,112,H R 5326,9-May-2012,12:19 AM,On Agreeing to the Amendment,None,Failed,105,128,0,8,0,179,0,11,0,0,0,0,105,307,0,19
223,R,112,H R 5326,9-May-2012,12:25 AM,On Agreeing to the Amendment,None,Agreed to,197,35,0,9,23,156,0,11,0,0,0,0,220,191,0,20
224,R,112,H R 2072,9-May-2012,2:30 PM,"On Motion to Suspend the Rules and Pass, as Amended","To reauthorize the Export-Import Bank of the United States, and for other purposes",Passed,147,93,0,1,183,0,0,7,0,0,0,0,330,93,0,8
225,R,112,H R 4133,9-May-2012,2:38 PM,"On Motion to Suspend the Rules and Pass, as Amended","To express the sense of Congress regarding the United States-Israel strategic relationship, to direct the President to submit to Congress reports on United States actions to enhance this relationship and to assist in the defense of Israel, and for other purposes",Passed,236,1,1,3,175,1,8,6,0,0,0,0,411,2,9,9
226,R,112,H R 5326,9-May-2012,6:29 PM,On Agreeing to the Amendment,None,Agreed to,239,0,0,2,142,41,0,7,0,0,0,0,381,41,0,9
227,R,112,H R 5326,9-May-2012,6:32 PM,On Agreeing to the Amendment,None,Failed,34,203,0,4,126,57,0,7,0,0,0,0,160,260,0,11
228,R,112,H R 5326,9-May-2012,6:36 PM,On Agreeing to the Amendment,None,Agreed to,220,17,0,4,9,177,0,4,0,0,0,0,229,194,0,8
229,R,112,H R 5326,9-May-2012,6:40 PM,On Agreeing to the Amendment,None,Agreed to,225,13,0,3,7,179,0,4,0,0,0,0,232,192,0,7
230,R,112,H R 5326,9-May-2012,6:44 PM,On Agreeing to the Amendment,None,Agreed to,233,4,0,4,5,181,0,4,0,0,0,0,238,185,0,8
231,R,112,H R 5326,9-May-2012,6:47 PM,On Agreeing to the Amendment,None,Agreed to,231,7,0,3,1,183,0,6,0,0,0,0,232,190,0,9
232,R,112,H R 5326,9-May-2012,6:50 PM,On Agreeing to the Amendment,None,Agreed to,228,10,0,3,4,180,0,6,0,0,0,0,232,190,0,9
233,R,112,H R 5326,9-May-2012,6:54 PM,On Agreeing to the Amendment,None,Agreed to,235,3,0,3,15,170,0,5,0,0,0,0,250,173,0,8
234,R,112,H R 5326,9-May-2012,6:57 PM,On Agreeing to the Amendment,None,Agreed to,229,8,0,4,17,166,0,7,0,0,0,0,246,174,0,11
235,R,112,H R 5326,9-May-2012,11:30 PM,On Agreeing to the Amendment,None,Agreed to,229,7,0,5,16,164,0,10,0,0,0,0,245,171,0,15
236,R,112,H R 5326,9-May-2012,11:33 PM,On Agreeing to the Amendment,None,Agreed to,208,28,0,5,10,173,0,7,0,0,0,0,218,201,0,12
237,R,112,H R 5326,9-May-2012,11:36 PM,On Agreeing to the Amendment,None,Agreed to,239,1,0,1,118,67,0,5,0,0,0,0,357,68,0,6
238,R,112,H R 5326,9-May-2012,11:41 PM,On Agreeing to the Amendment,None,Failed,28,212,0,1,135,50,0,5,0,0,0,0,163,262,0,6
239,R,112,H R 5326,9-May-2012,11:44 PM,On Agreeing to the Amendment,None,Failed,12,227,0,2,177,8,0,5,0,0,0,0,189,235,0,7
240,R,112,H R 5326,9-May-2012,11:47 PM,On Agreeing to the Amendment,None,Failed,16,224,0,1,177,8,0,5,0,0,0,0,193,232,0,6
241,R,112,H R 5326,9-May-2012,11:51 PM,On Agreeing to the Amendment,None,Agreed to,230,10,0,1,8,178,0,4,0,0,0,0,238,188,0,5
242,R,112,H R 5326,9-May-2012,11:54 PM,On Agreeing to the Amendment,None,Failed,206,34,0,1,3,183,0,4,0,0,0,0,209,217,0,5
243,R,112,H R 5326,9-May-2012,11:57 PM,On Agreeing to the Amendment,None,Agreed to,213,27,0,1,5,181,0,4,0,0,0,0,218,208,0,5
244,R,112,H RES 648,10-May-2012,10:46 AM,On Ordering the Previous Question,Providing for consideration of H.R. 5652 to provide for reconciliation pursuant to section 201 of the concurrent resolution on the budget for fiscal year 2013,Passed,232,0,0,9,5,177,0,8,0,0,0,0,237,177,0,17
245,R,112,H RES 648,10-May-2012,10:53 AM,On Agreeing to the Resolution,Providing for consideration of H.R. 5652 to provide for reconciliation pursuant to section 201 of the concurrent resolution on the budget for fiscal year 2013,Passed,232,0,0,9,1,183,0,6,0,0,0,0,233,183,0,15
246,R,112,H R 5652,10-May-2012,2:06 PM,On Motion to Recommit with Instructions,To provide for reconciliation pursuant to section 201 of the concurrent resolution on the budget for fiscal year 2013,Failed,2,228,2,9,168,4,9,9,0,0,0,0,170,232,11,18
247,R,112,H R 5652,10-May-2012,2:15 PM,On Passage,To provide for reconciliation pursuant to section 201 of the concurrent resolution on the budget for fiscal year 2013,Passed,218,16,1,6,0,183,0,7,0,0,0,0,218,199,1,13
248,R,112,H R 5326,10-May-2012,2:45 PM,On Motion to Recommit with Instructions,"Making appropriations for the Departments of Commerce and Justice, Science, and Related Agencies for the fiscal year ending September 30, 2013, and for other purposes",Failed,1,232,0,8,180,1,0,9,0,0,0,0,181,233,0,17
249,R,112,H R 5326,10-May-2012,2:51 PM,On Passage,"Making appropriations for the Departments of Commerce and Justice, Science, and Related Agencies for the fiscal year ending September 30, 2013, and for other purposes",Passed,224,8,0,9,23,155,0,12,0,0,0,0,247,163,0,21
250,R,112,H R 365,15-May-2012,6:55 PM,"On Motion to Suspend the Rules and Pass, as Amended","To encourage, enhance, and integrate Blue Alert plans throughout the United States in order to disseminate information when a law enforcement officer is seriously injured or killed in the line of duty",Passed,222,1,0,18,172,0,0,18,0,0,0,0,394,1,0,36
251,R,112,H R 3874,15-May-2012,7:02 PM,"On Motion to Suspend the Rules and Pass, as Amended","To provide for the conveyance of eight cemeteries that are located on National Forest System land in Black Hills National Forest, South Dakota",Passed,224,1,0,16,176,0,0,14,0,0,0,0,400,1,0,30
252,R,112,H R 205,15-May-2012,7:09 PM,"On Motion to Suspend the Rules and Pass, as Amended","To amend the Act titled “An Act to authorize the leasing of restricted Indian lands for public, religious, educational, recreational, residential, business, and other purposes requiring the grant of long-term leases”, to provide for Indian tribes to enter into leases without approval from the Secretary of the Interior",Passed,225,0,0,16,175,0,0,15,0,0,0,0,400,0,0,31
253,R,112,H RES 656,16-May-2012,1:18 PM,On Question of Consideration of the Resolution,"Providing for consideration of the bill (H.R. 4970) to reauthorize the Violence Against Women Act of 1994, and providing for consideration of the bill (H.R. 4310) National Defense Authorization Act for Fiscal Year 2013",Passed,236,0,0,5,3,183,0,4,0,0,0,0,239,183,0,9
254,R,112,H RES 656,16-May-2012,2:59 PM,On Ordering the Previous Question,"Providing for consideration of the bill (H.R. 4970) to reauthorize the Violence Against Women Act of 1994, and providing for consideration of the bill (H.R. 4310) National Defense Authorization Act for Fiscal Year 2013",Passed,234,1,0,6,1,186,0,3,0,0,0,0,235,187,0,9
255,R,112,H RES 656,16-May-2012,3:10 PM,On Agreeing to the Resolution,"Providing for consideration of the bill (H.R. 4970) to reauthorize the Violence Against Women Act of 1994, and providing for consideration of the bill (H.R. 4310) National Defense Authorization Act for Fiscal Year 2013",Passed,234,2,1,4,1,184,0,5,0,0,0,0,235,186,1,9
256,R,112,H R 4119,16-May-2012,3:18 PM,"On Motion to Suspend the Rules and Pass, as Amended",Border Tunnel Prevention Act of 2012,Passed,233,3,0,5,183,1,0,6,0,0,0,0,416,4,0,11
257,R,112,H R 4970,16-May-2012,5:20 PM,On Motion to Recommit with Instructions,To reauthorize the Violence Against Women Act of 1994,Failed,2,236,0,3,185,0,0,5,0,0,0,0,187,236,0,8
258,R,112,H R 4970,16-May-2012,5:29 PM,On Passage,To reauthorize the Violence Against Women Act of 1994,Passed,216,23,0,2,6,182,0,2,0,0,0,0,222,205,0,4
259,R,112,H RES 661,17-May-2012,2:27 PM,On Ordering the Previous Question,"Providing for further consideration of H.R. 4310, National Defense Authorization Act for Fiscal Year 2013",Passed,233,3,0,5,3,179,0,8,0,0,0,0,236,182,0,13
260,R,112,H RES 661,17-May-2012,2:36 PM,On Agreeing to the Resolution,"Providing for further consideration of H.R. 4310, National Defense Authorization Act for Fiscal Year 2013",Passed,236,4,0,1,8,174,0,8,0,0,0,0,244,178,0,9
261,R,112,H RES 568,17-May-2012,2:45 PM,"On Motion to Suspend the Rules and Agree, as Amended",Expressing the sense of the House of Representatives regarding the importance of preventing the Government of Iran from acquiring a nuclear weapons capability,Passed,235,4,0,2,166,7,9,8,0,0,0,0,401,11,9,10
262,R,112,H R 5740,17-May-2012,2:52 PM,On Motion to Suspend the Rules and Pass,"To extend the National Flood Insurance Program, and for other purposes",Passed,221,17,0,3,181,1,0,8,0,0,0,0,402,18,0,11
263,R,112,H R 4310,17-May-2012,6:51 PM,On Agreeing to the Amendment,None,Failed,69,169,0,3,15,166,0,9,0,0,0,0,84,335,0,12
264,R,112,H R 4310,17-May-2012,6:59 PM,On Agreeing to the Amendment,None,Failed,12,224,0,5,101,79,0,10,0,0,0,0,113,303,0,15
265,R,112,H R 4310,17-May-2012,7:03 PM,On Agreeing to the Amendment,None,Agreed to,232,0,0,9,180,1,0,9,0,0,0,0,412,1,0,18
266,R,112,H R 4310,17-May-2012,7:08 PM,On Agreeing to the Amendment,None,Agreed to,227,11,0,3,22,160,0,8,0,0,0,0,249,171,0,11
267,R,112,H R 4310,17-May-2012,7:12 PM,On Agreeing to the Amendment,None,Agreed to,210,28,0,3,1,181,0,8,0,0,0,0,211,209,0,11
268,R,112,H R 4310,17-May-2012,7:16 PM,On Agreeing to the Amendment,None,Failed,11,227,0,3,101,81,0,8,0,0,0,0,112,308,0,11
269,R,112,H R 4310,17-May-2012,7:19 PM,On Agreeing to the Amendment,None,Failed,13,223,0,5,152,29,0,9,0,0,0,0,165,252,0,14
270,R,112,H R 4310,18-May-2012,9:45 AM,On Agreeing to the Amendment,None,Failed,19,219,0,3,163,19,0,8,0,0,0,0,182,238,0,11
271,R,112,H R 4310,18-May-2012,9:48 AM,On Agreeing to the Amendment,None,Agreed to,230,7,0,4,13,166,0,11,0,0,0,0,243,173,0,15
272,R,112,H R 4310,18-May-2012,9:52 AM,On Agreeing to the Amendment,None,Failed,209,29,0,3,0,182,0,8,0,0,0,0,209,211,0,11
273,R,112,H R 4310,18-May-2012,9:56 AM,On Agreeing to the Amendment,None,Failed,25,214,0,2,167,15,0,8,0,0,0,0,192,229,0,10
274,R,112,H R 4310,18-May-2012,10:00 AM,On Agreeing to the Amendment,None,Failed,94,145,0,2,70,111,0,9,0,0,0,0,164,256,0,11
275,R,112,H R 4310,18-May-2012,10:04 AM,On Agreeing to the Amendment,None,Failed,12,227,0,2,168,14,0,8,0,0,0,0,180,241,0,10
276,R,112,H R 4310,18-May-2012,10:10 AM,On Agreeing to the Amendment,None,Agreed to,212,27,0,2,182,0,0,8,0,0,0,0,394,27,0,10
277,R,112,H R 4310,18-May-2012,10:13 AM,On Agreeing to the Amendment,None,Failed,30,209,0,2,88,94,0,8,0,0,0,0,118,303,0,10
278,R,112,H R 4310,18-May-2012,10:17 AM,On Agreeing to the Amendment,None,Failed,5,234,0,2,155,27,0,8,0,0,0,0,160,261,0,10
279,R,112,H R 4310,18-May-2012,10:20 AM,On Agreeing to the Amendment,None,Failed,4,234,0,3,171,11,0,8,0,0,0,0,175,245,0,11
280,R,112,H R 4310,18-May-2012,10:24 AM,On Agreeing to the Amendment,None,Agreed to,233,5,0,3,8,174,0,8,0,0,0,0,241,179,0,11
281,R,112,H R 4310,18-May-2012,10:27 AM,On Agreeing to the Amendment,None,Agreed to,218,21,0,2,2,180,0,8,0,0,0,0,220,201,0,10
282,R,112,H R 4310,18-May-2012,10:31 AM,On Agreeing to the Amendment,None,Failed,16,223,0,2,154,29,0,7,0,0,0,0,170,252,0,9
283,R,112,H R 4310,18-May-2012,10:34 AM,On Agreeing to the Amendment,None,Agreed to,228,11,0,2,1,182,0,7,0,0,0,0,229,193,0,9
284,R,112,H R 4310,18-May-2012,10:38 AM,On Agreeing to the Amendment,None,Agreed to,63,176,0,2,163,20,0,7,0,0,0,0,226,196,0,9
285,R,112,H R 4310,18-May-2012,10:43 AM,On Agreeing to the Amendment,None,Failed,2,236,0,3,75,108,0,7,0,0,0,0,77,344,0,10
286,R,112,H R 4310,18-May-2012,10:47 AM,On Agreeing to the Amendment,None,Agreed to,229,10,0,2,12,171,0,7,0,0,0,0,241,181,0,9
287,R,112,H R 4310,18-May-2012,10:51 AM,On Agreeing to the Amendment,None,Failed,45,194,0,2,76,106,0,8,0,0,0,0,121,300,0,10
288,R,112,H R 4310,18-May-2012,12:01 PM,On Agreeing to the Amendment,None,Agreed to,225,3,0,13,13,159,0,18,0,0,0,0,238,162,0,31
289,R,112,H R 4310,18-May-2012,12:07 PM,On Agreeing to the Amendment,None,Agreed to,234,2,0,5,145,36,0,9,0,0,0,0,379,38,0,14
290,R,112,H R 4310,18-May-2012,12:38 PM,On Motion to Recommit with Instructions,National Defense Authorization Act for Fiscal Year 2013,Failed,2,236,0,3,180,0,0,10,0,0,0,0,182,236,0,13
291,R,112,H R 4310,18-May-2012,12:46 PM,On Passage,National Defense Authorization Act for Fiscal Year 2013,Passed,222,16,0,3,77,104,0,9,0,0,0,0,299,120,0,12
292,R,112,H R 4348,18-May-2012,12:53 PM,On Barrow Motion to Instruct Conferees,"To provide an extension of Federal-aid highway, highway safety, motor carrier safety, transit, and other programs funded out of the Highway Trust Fund pending enactment of a multiyear law reauthorizing such programs, and for other purposes",Passed,235,1,0,5,26,151,0,13,0,0,0,0,261,152,0,18
293,R,112,H R 4348,18-May-2012,1:00 PM,On Rahall Motion to Instruct Conferees,"To provide an extension of Federal-aid highway, highway safety, motor carrier safety, transit, and other programs funded out of the Highway Trust Fund pending enactment of a multiyear law reauthorizing such programs, and for other purposes",Passed,69,166,0,6,176,3,0,11,0,0,0,0,245,169,0,17
294,R,112,H R 5651,30-May-2012,6:59 PM,"On Motion to Suspend the Rules and Pass, as Amended",Prescription Drug User Fee Amendments of 2012,Passed,219,4,0,18,168,1,0,21,0,0,0,0,387,5,0,39
295,R,112,H R 4201,30-May-2012,7:06 PM,On Motion to Suspend the Rules and Pass,Servicemember Family Protection Act,Passed,220,2,0,19,170,0,0,20,0,0,0,0,390,2,0,39
296,R,112,H R 915,30-May-2012,7:14 PM,"On Motion to Suspend the Rules and Pass, as Amended",Jamie Zapata Border Enforcement Security Task Force Act,Passed,220,2,0,19,171,0,0,19,0,0,0,0,391,2,0,38
297,R,112,H RES 667,31-May-2012,1:59 PM,On Ordering the Previous Question,"Providing for consideration of the bills (H.R. 5743) Intelligence Authorization Act for FY 2013; (H.R. 5854) Military construction, the Department of Veterans Affairs Appropriation; (H.R. 5855) Department of Homeland Security Appropriation; and (H.R. 5325) Energy and Water Development Appropriation",Passed,231,0,0,10,2,180,0,8,0,0,0,0,233,180,0,18
298,R,112,H RES 667,31-May-2012,2:06 PM,On Agreeing to the Resolution,"Providing for consideration of the bills (H.R. 5743) Intelligence Authorization Act for FY 2013; (H.R. 5854) Military construction, the Department of Veterans Affairs Appropriation; (H.R. 5855) Department of Homeland Security Appropriation; and (H.R. 5325) Energy and Water Development Appropriation",Passed,232,0,0,9,14,166,0,10,0,0,0,0,246,166,0,19
299,R,112,H R 3541,31-May-2012,2:14 PM,"On Motion to Suspend the Rules and Pass, as Amended",Prenatal Non-discrimination Act (PRENDA) of 2012,Failed,226,7,0,8,20,161,0,9,0,0,0,0,246,168,0,17
300,R,112,H R 5743,31-May-2012,4:20 PM,On Motion to Recommit with Instructions,Intelligence Authorization Act for Fiscal Year 2013,Failed,1,231,0,9,179,4,0,7,0,0,0,0,180,235,0,16
301,R,112,H R 5743,31-May-2012,4:28 PM,On Passage,Intelligence Authorization Act for Fiscal Year 2013,Passed,224,7,0,10,162,21,0,7,0,0,0,0,386,28,0,17
302,R,112,H R 5854,31-May-2012,9:26 PM,On Agreeing to the Amendment,None,Agreed to,34,197,0,10,184,1,0,5,0,0,0,0,218,198,0,15
303,R,112,H R 5854,31-May-2012,9:31 PM,On Agreeing to the Amendment,None,Failed,180,52,0,9,0,185,0,5,0,0,0,0,180,237,0,14
304,R,112,H R 5854,31-May-2012,9:59 PM,On Motion to Recommit with Instructions,"Making appropriations for military construction, the Department of Veterans Affairs, and related agencies for the fiscal year ending September 30, 2013, and for other purposes",Failed,3,230,0,8,185,0,0,5,0,0,0,0,188,230,0,13
305,R,112,H R 5854,31-May-2012,10:05 PM,On Passage,"Making appropriations for military construction, the Department of Veterans Affairs, and related agencies for the fiscal year ending September 30, 2013, and for other purposes",Passed,226,8,0,7,181,4,0,5,0,0,0,0,407,12,0,12
306,R,112,H R 5325,1-Jun-2012,12:09 PM,On Agreeing to the Amendment,None,Agreed to,139,85,0,17,77,92,0,21,0,0,0,0,216,177,0,38
307,R,112,H R 5325,1-Jun-2012,12:12 PM,On Agreeing to the Amendment,None,Agreed to,188,33,0,20,15,152,0,23,0,0,0,0,203,185,0,43
308,R,112,H R 5325,1-Jun-2012,12:16 PM,On Agreeing to the Amendment,None,Failed,6,214,0,21,146,23,0,21,0,0,0,0,152,237,0,42
309,R,112,H R 5325,1-Jun-2012,12:19 PM,On Agreeing to the Amendment,None,Failed,125,93,0,23,5,163,0,22,0,0,0,0,130,256,0,45
310,R,112,H R 5325,1-Jun-2012,12:23 PM,On Agreeing to the Amendment,None,Failed,139,81,0,21,1,164,0,25,0,0,0,0,140,245,0,46
311,R,112,H R 5325,1-Jun-2012,12:27 PM,On Agreeing to the Amendment,None,Failed,113,107,0,21,0,168,0,22,0,0,0,0,113,275,0,43
312,R,112,H R 5325,1-Jun-2012,12:30 PM,On Agreeing to the Amendment,None,Failed,26,191,0,24,157,9,0,24,0,0,0,0,183,200,0,48
313,R,112,H R 5325,1-Jun-2012,12:33 PM,On Agreeing to the Amendment,None,Failed,7,210,0,24,141,26,0,23,0,0,0,0,148,236,0,47
314,R,112,H R 5325,1-Jun-2012,12:37 PM,On Agreeing to the Amendment,None,Failed,6,210,0,25,133,35,0,22,0,0,0,0,139,245,0,47
315,R,112,H R 5325,5-Jun-2012,7:00 PM,On Agreeing to the Amendment,None,Failed,91,134,0,16,15,147,0,28,0,0,0,0,106,281,0,44
316,R,112,H R 5325,5-Jun-2012,7:06 PM,On Agreeing to the Amendment,None,Failed,5,221,0,15,126,36,0,28,0,0,0,0,131,257,0,43
317,R,112,H R 5325,5-Jun-2012,7:12 PM,On Agreeing to the Amendment,None,Failed,102,123,0,16,36,126,0,28,0,0,0,0,138,249,0,44
318,R,112,H R 5325,5-Jun-2012,7:17 PM,On Agreeing to the Amendment,None,Failed,6,219,0,16,146,16,0,28,0,0,0,0,152,235,0,44
319,R,112,H R 5325,6-Jun-2012,1:41 PM,On Agreeing to the Amendment,None,Failed,162,72,0,7,19,157,0,14,0,0,0,0,181,229,0,21
320,R,112,H R 5325,6-Jun-2012,1:46 PM,On Agreeing to the Amendment,None,Agreed to,234,0,0,7,114,60,0,16,0,0,0,0,348,60,0,23
321,R,112,H R 5325,6-Jun-2012,1:53 PM,On Agreeing to the Amendment,None,Agreed to,228,5,0,8,98,76,0,16,0,0,0,0,326,81,0,24
322,R,112,H R 5325,6-Jun-2012,1:57 PM,On Agreeing to the Amendment,None,Agreed to,232,0,0,9,123,51,0,16,0,0,0,0,355,51,0,25
323,R,112,H R 5325,6-Jun-2012,2:02 PM,On Agreeing to the Amendment,None,Agreed to,225,7,0,9,17,161,0,12,0,0,0,0,242,168,0,21
324,R,112,H R 5325,6-Jun-2012,2:05 PM,On Agreeing to the Amendment,None,Failed,7,226,0,8,143,34,0,13,0,0,0,0,150,260,0,21
325,R,112,H R 5325,6-Jun-2012,4:51 PM,On Agreeing to the Amendment,None,Agreed to,192,44,0,5,136,45,0,9,0,0,0,0,328,89,0,14
326,R,112,H R 5325,6-Jun-2012,4:56 PM,On Agreeing to the Amendment,None,Failed,4,231,0,6,153,29,0,8,0,0,0,0,157,260,0,14
327,R,112,,6-Jun-2012,,,"This vote was vacated by unanimous consent on June 6, 2012. The vote on Connolly of Virginia Amendment is roll call 340.",,0,0,0,0,0,0,0,0,0,0,0,0,0,0,0,0
328,R,112,H R 5325,6-Jun-2012,5:03 PM,On Agreeing to the Amendment,None,Failed,109,127,0,5,27,155,0,8,0,0,0,0,136,282,0,13
329,R,112,H R 5325,6-Jun-2012,5:07 PM,On Agreeing to the Amendment,None,Failed,60,175,0,6,108,74,0,8,0,0,0,0,168,249,0,14
330,R,112,H R 5325,6-Jun-2012,5:11 PM,On Agreeing to the Amendment,None,Agreed to,94,142,0,5,129,53,0,8,0,0,0,0,223,195,0,13
331,R,112,H R 5325,6-Jun-2012,5:14 PM,On Agreeing to the Amendment,None,Failed,8,228,0,5,174,9,0,7,0,0,0,0,182,237,0,12
332,R,112,H R 5325,6-Jun-2012,5:17 PM,On Agreeing to the Amendment,None,Failed,8,228,0,5,130,53,0,7,0,0,0,0,138,281,0,12
333,R,112,H R 5325,6-Jun-2012,5:21 PM,On Agreeing to the Amendment,None,Failed,23,212,0,6,151,32,0,7,0,0,0,0,174,244,0,13
334,R,112,H R 5325,6-Jun-2012,5:26 PM,On Agreeing to the Amendment,None,Failed,135,100,0,6,6,176,0,8,0,0,0,0,141,276,0,14
335,R,112,H R 5325,6-Jun-2012,5:28 PM,On Agreeing to the Amendment,None,Failed,152,84,0,5,5,177,0,8,0,0,0,0,157,261,0,13
336,R,112,H R 5325,6-Jun-2012,5:31 PM,On Agreeing to the Amendment,None,Failed,125,110,0,6,0,183,0,7,0,0,0,0,125,293,0,13
337,R,112,H R 5325,6-Jun-2012,5:35 PM,On Agreeing to the Amendment,None,Failed,140,95,0,6,4,179,0,7,0,0,0,0,144,274,0,13
338,R,112,H R 5325,6-Jun-2012,5:37 PM,On Agreeing to the Amendment,None,Failed,184,52,0,5,0,183,0,7,0,0,0,0,184,235,0,12
339,R,112,H R 5325,6-Jun-2012,5:40 PM,On Agreeing to the Amendment,None,Failed,70,164,0,7,44,138,0,8,0,0,0,0,114,302,0,15
340,R,112,H R 5325,6-Jun-2012,5:45 PM,On Agreeing to the Amendment,None,Agreed to,60,172,1,8,148,35,0,7,0,0,0,0,208,207,1,15
341,R,112,H R 5325,6-Jun-2012,6:15 PM,On Motion to Recommit with Instructions,"Making appropriations for energy and water development and related agencies for the fiscal year ending September 30, 2013, and for other purposes",Failed,2,233,0,6,183,0,0,7,0,0,0,0,185,233,0,13
342,R,112,H R 5325,6-Jun-2012,6:24 PM,On Passage,"Making appropriations for energy and water development and related agencies for the fiscal year ending September 30, 2013, and for other purposes",Passed,207,29,0,5,48,136,0,6,0,0,0,0,255,165,0,11
343,R,112,H R 4348,6-Jun-2012,6:30 PM,On Flake Motion to Instruct Conferees,"To provide an extension of Federal-aid highway, highway safety, motor carrier safety, transit, and other programs funded out of the Highway Trust Fund pending enactment of a multiyear law reauthorizing such programs, and for other purposes",Passed,192,43,0,6,67,111,0,12,0,0,0,0,259,154,0,18
344,R,112,H R 4348,6-Jun-2012,6:37 PM,On Doggett Motion to Instruct Conferees,"To provide an extension of Federal-aid highway, highway safety, motor carrier safety, transit, and other programs funded out of the Highway Trust Fund pending enactment of a multiyear law reauthorizing such programs, and for other purposes",Failed,14,222,0,5,178,4,0,8,0,0,0,0,192,226,0,13
345,R,112,H R 5855,6-Jun-2012,11:04 PM,On Agreeing to the Amendment,None,Failed,0,235,0,6,154,25,0,11,0,0,0,0,154,260,0,17
346,R,112,H R 5855,6-Jun-2012,11:08 PM,On Agreeing to the Amendment,None,Failed,135,101,0,5,5,172,0,13,0,0,0,0,140,273,0,18
347,R,112,H R 5855,6-Jun-2012,11:12 PM,On Agreeing to the Amendment,None,Failed,24,211,0,6,149,29,0,12,0,0,0,0,173,240,0,18
348,R,112,H R 5855,6-Jun-2012,11:15 PM,On Agreeing to the Amendment,None,Agreed to,51,185,0,5,160,17,0,13,0,0,0,0,211,202,0,18
349,R,112,H R 5855,6-Jun-2012,11:18 PM,On Agreeing to the Amendment,None,Failed,4,231,0,6,155,23,0,12,0,0,0,0,159,254,0,18
350,R,112,H R 5855,6-Jun-2012,11:21 PM,On Agreeing to the Amendment,None,Failed,8,228,0,5,148,33,0,9,0,0,0,0,156,261,0,14
351,R,112,H R 5855,6-Jun-2012,11:24 PM,On Agreeing to the Amendment,None,Failed,7,229,0,5,137,44,0,9,0,0,0,0,144,273,0,14
352,R,112,H R 5855,6-Jun-2012,11:27 PM,On Agreeing to the Amendment,None,Agreed to,221,14,0,6,81,99,0,10,0,0,0,0,302,113,0,16
353,R,112,H R 5855,6-Jun-2012,11:30 PM,On Agreeing to the Amendment,None,Agreed to,209,26,0,6,21,160,0,9,0,0,0,0,230,186,0,15
354,R,112,H R 5855,6-Jun-2012,11:33 PM,On Agreeing to the Amendment,None,Failed,1,235,0,5,166,14,0,10,0,0,0,0,167,249,0,15
355,R,112,H R 5855,6-Jun-2012,11:36 PM,On Agreeing to the Amendment,None,Failed,15,221,0,5,45,134,0,11,0,0,0,0,60,355,0,16
356,R,112,H R 5855,6-Jun-2012,11:41 PM,On Agreeing to the Amendment,None,Failed,18,218,0,5,132,48,0,10,0,0,0,0,150,266,0,15
357,R,112,H R 5855,6-Jun-2012,11:44 PM,On Agreeing to the Amendment,None,Failed,9,225,0,7,157,20,0,13,0,0,0,0,166,245,0,20
358,R,112,H RES 679,7-Jun-2012,2:04 PM,On Ordering the Previous Question,"Providing for consideration of the bill (H.R. 436) to amend the Internal Revenue Code of 1986 to repeal the excise tax on medical devices, and providing for consideration of the bill (H.R. 5882) making appropriations for the Legislative Branch for fiscal year ending September 30, 2013, and for other purposes",Passed,235,1,0,5,5,178,0,7,0,0,0,0,240,179,0,12
359,R,112,H RES 679,7-Jun-2012,2:27 PM,On Agreeing to the Resolution,"Providing for consideration of the bill (H.R. 436) to amend the Internal Revenue Code of 1986 to repeal the excise tax on medical devices, and providing for consideration of the bill (H.R. 5882) making appropriations for the Legislative Branch for fiscal year ending September 30, 2013, and for other purposes",Passed,233,0,0,8,8,173,0,9,0,0,0,0,241,173,0,17
360,R,112,H R 436,7-Jun-2012,4:56 PM,On Motion to Recommit with Instructions,Protect Medical Innovation Act of 2012,Failed,2,233,0,6,177,6,0,7,0,0,0,0,179,239,0,13
361,R,112,H R 436,7-Jun-2012,5:04 PM,On Passage,Protect Medical Innovation Act of 2012,Passed,233,0,0,8,37,146,0,7,0,0,0,0,270,146,0,15
362,R,112,H R 5855,7-Jun-2012,9:07 PM,On Agreeing to the Amendment,None,Agreed to,217,15,0,9,7,174,0,9,0,0,0,0,224,189,0,18
363,R,112,H R 5855,7-Jun-2012,9:12 PM,On Agreeing to the Amendment,None,Agreed to,228,4,0,9,10,171,0,9,0,0,0,0,238,175,0,18
364,R,112,H R 5855,7-Jun-2012,9:16 PM,On Agreeing to the Amendment,None,Failed,131,101,0,9,0,181,0,9,0,0,0,0,131,282,0,18
365,R,112,H R 5855,7-Jun-2012,9:22 PM,On Agreeing to the Amendment,None,Failed,187,46,0,8,17,164,0,9,0,0,0,0,204,210,0,17
366,R,112,H R 5855,7-Jun-2012,9:26 PM,On Agreeing to the Amendment,None,Agreed to,232,1,0,8,18,163,0,9,0,0,0,0,250,164,0,17
367,R,112,H R 5855,7-Jun-2012,9:30 PM,On Agreeing to the Amendment,None,Failed,99,134,0,8,2,180,0,8,0,0,0,0,101,314,0,16
368,R,112,H R 5855,7-Jun-2012,9:33 PM,On Agreeing to the Amendment,None,Failed,79,154,0,8,20,162,0,8,0,0,0,0,99,316,0,16
369,R,112,H R 5855,7-Jun-2012,9:59 PM,On Motion to Recommit with Instructions,"Making appropriations for the Department of Homeland Security for the fiscal year ending September 30, 2013, and for other purposes",Failed,0,233,0,8,165,18,0,7,0,0,0,0,165,251,0,15
370,R,112,H R 5855,7-Jun-2012,10:07 PM,On Passage,"Making appropriations for the Department of Homeland Security for the fiscal year ending September 30, 2013, and for other purposes",Passed,217,16,0,8,17,166,0,7,0,0,0,0,234,182,0,15
371,R,112,H R 5882,8-Jun-2012,11:12 AM,On Agreeing to the Amendment,None,Agreed to,188,41,0,12,25,152,0,13,0,0,0,0,213,193,0,25
372,R,112,H R 5882,8-Jun-2012,11:17 AM,On Agreeing to the Amendment,None,Agreed to,206,25,0,10,8,164,0,18,0,0,0,0,214,189,0,28
373,R,112,H R 5882,8-Jun-2012,11:21 AM,On Agreeing to the Amendment,None,Agreed to,190,41,0,10,14,162,0,14,0,0,0,0,204,203,0,24
374,R,112,H R 5882,8-Jun-2012,11:25 AM,On Agreeing to the Amendment,None,Failed,10,219,0,12,168,10,0,12,0,0,0,0,178,229,0,24
375,R,112,H R 5882,8-Jun-2012,11:29 AM,On Agreeing to the Amendment,None,Failed,94,137,0,10,54,124,0,12,0,0,0,0,148,261,0,22
376,R,112,H R 5882,8-Jun-2012,11:53 AM,On Motion to Recommit with Instructions,"Making appropriations for the Legislative Branch for the fiscal year ending September 30, 2013, and for other purposes",Failed,1,230,0,10,100,79,0,11,0,0,0,0,101,309,0,21
377,R,112,H R 5882,8-Jun-2012,12:00 PM,On Passage,"Making appropriations for the Legislative Branch for the fiscal year ending September 30, 2013, and for other purposes",Passed,211,19,0,11,96,83,0,11,0,0,0,0,307,102,0,22
378,R,112,H R 4348,8-Jun-2012,12:06 PM,On Broun of Georgia Motion to Instruct Conferees,"To provide an extension of Federal-aid highway, highway safety, motor carrier safety, transit, and other programs funded out of the Highway Trust Fund pending enactment of a multiyear law reauthorizing such programs, and for other purposes",Failed,82,145,0,14,0,178,0,12,0,0,0,0,82,323,0,26
379,R,112,S 684,18-Jun-2012,6:54 PM,On Motion to Suspend the Rules and Pass,"To provide for the conveyance of certain parcels of land to the town of Alta, Utah",Passed,216,3,0,22,167,0,0,23,0,0,0,0,383,3,0,45
380,R,112,S 404,18-Jun-2012,7:00 PM,On Motion to Suspend the Rules and Pass,To modify a land grant patent issued by the Secretary of the Interior,Passed,217,0,0,24,163,0,0,27,0,0,0,0,380,0,0,51
381,R,112,H RES 688,19-Jun-2012,1:50 PM,On Ordering the Previous Question,"Providing for consideration of the bill (H.R. 2578) to amend the Wild and Scenic Rivers Act related to a segment of the Lower Merced River in California, and for other purposes",Passed,233,1,0,7,5,177,0,8,0,0,0,0,238,178,0,15
382,R,112,H RES 688,19-Jun-2012,2:11 PM,On Agreeing to the Resolution,"Providing for consideration of the bill (H.R. 2578) to amend the Wild and Scenic Rivers Act related to a segment of the Lower Merced River in California, and for other purposes",Passed,235,1,0,5,5,174,0,12,0,0,0,0,240,175,0,17
383,R,112,H R 2578,19-Jun-2012,4:55 PM,On Agreeing to the Amendment,None,Failed,8,226,0,7,176,10,0,5,0,0,0,0,184,236,0,12
384,R,112,H R 2578,19-Jun-2012,5:02 PM,On Agreeing to the Amendment,None,Failed,1,236,0,4,155,32,0,4,0,0,0,0,156,268,0,8
385,R,112,H R 2578,19-Jun-2012,5:07 PM,On Agreeing to the Amendment,None,Failed,4,233,0,4,173,14,0,4,0,0,0,0,177,247,0,8
386,R,112,H R 2578,19-Jun-2012,5:35 PM,On Motion to Recommit with Instructions,"To amend the Wild and Scenic Rivers Act related to a segment of the Lower Merced River in California, and for other purposes",Failed,2,234,0,5,186,0,0,5,0,0,0,0,188,234,0,10
387,R,112,H R 2578,19-Jun-2012,5:42 PM,On Passage,"To amend the Wild and Scenic Rivers Act related to a segment of the Lower Merced River in California, and for other purposes",Passed,216,19,0,6,16,169,0,6,0,0,0,0,232,188,0,12
388,R,112,H R 2938,19-Jun-2012,5:49 PM,"On Motion to Suspend the Rules and Pass, as Amended",Gila Bend Indian Reservation Lands Replacement Clarification Act,Passed,232,4,1,4,111,74,1,5,0,0,0,0,343,78,2,9
389,R,112,H RES 691,20-Jun-2012,2:08 PM,On Ordering the Previous Question,"Providing for consideration of the bill (H.R. 4480), the Strategic Energy Production Act",Passed,236,0,0,5,6,183,0,2,0,0,0,0,242,183,0,7
390,R,112,H RES 691,20-Jun-2012,2:15 PM,On Agreeing to the Resolution,"Providing for consideration of the bill (H.R. 4480), the Strategic Energy Production Act",Passed,235,0,0,6,10,178,0,3,0,0,0,0,245,178,0,9
391,R,112,H R 4348,20-Jun-2012,2:22 PM,On Walz of Minnesota Motion to Instruct Conferees,"To provide an extension of Federal-aid highway, highway safety, motor carrier safety, transit, and other programs funded out of the Highway Trust Fund pending enactment of a multiyear law reauthorizing such programs, and for other purposes",Passed,198,34,1,8,188,0,0,3,0,0,0,0,386,34,1,11
392,R,112,H R 4480,21-Jun-2012,11:27 AM,On Agreeing to the Amendment,None,Agreed to,234,0,0,7,19,163,0,9,0,0,0,0,253,163,0,16
393,R,112,H R 4480,21-Jun-2012,11:35 AM,On Agreeing to the Amendment,None,Failed,2,231,0,8,162,18,0,11,0,0,0,0,164,249,0,19
394,R,112,H R 4480,21-Jun-2012,11:40 AM,On Agreeing to the Amendment,None,Failed,4,231,0,6,173,11,0,7,0,0,0,0,177,242,0,13
395,R,112,H R 4480,21-Jun-2012,11:43 AM,On Agreeing to the Amendment,None,Failed,7,229,0,5,167,15,0,9,0,0,0,0,174,244,0,14
396,R,112,H R 4480,21-Jun-2012,11:48 AM,On Agreeing to the Amendment,None,Failed,0,235,0,6,164,20,0,7,0,0,0,0,164,255,0,13
397,R,112,H R 4480,21-Jun-2012,11:52 AM,On Agreeing to the Amendment,None,Failed,7,229,0,5,157,27,0,7,0,0,0,0,164,256,0,12
398,R,112,H R 4480,21-Jun-2012,11:55 AM,On Agreeing to the Amendment,None,Failed,8,228,0,5,182,2,0,7,0,0,0,0,190,230,0,12
399,R,112,H R 4480,21-Jun-2012,11:58 AM,On Agreeing to the Amendment,None,Agreed to,231,4,0,6,26,158,0,7,0,0,0,0,257,162,0,13
400,R,112,H R 4480,21-Jun-2012,12:01 PM,On Agreeing to the Amendment,None,Failed,9,225,0,7,152,31,0,8,0,0,0,0,161,256,0,15
401,R,112,H R 4480,21-Jun-2012,12:05 PM,On Agreeing to the Amendment,None,Agreed to,221,13,0,7,23,160,0,8,0,0,0,0,244,173,0,15
402,R,112,H R 4480,21-Jun-2012,12:08 PM,On Agreeing to the Amendment,None,Agreed to,230,1,0,10,33,145,0,13,0,0,0,0,263,146,0,23
403,R,112,H R 4480,21-Jun-2012,12:12 PM,On Agreeing to the Amendment,None,Failed,7,228,0,6,161,22,0,8,0,0,0,0,168,250,0,14
404,R,112,H R 4480,21-Jun-2012,12:15 PM,On Agreeing to the Amendment,None,Agreed to,232,4,0,5,24,157,0,10,0,0,0,0,256,161,0,15
405,R,112,H R 4480,21-Jun-2012,12:19 PM,On Agreeing to the Amendment,None,Failed,8,228,0,5,178,5,0,8,0,0,0,0,186,233,0,13
406,R,112,H R 4480,21-Jun-2012,12:22 PM,On Agreeing to the Amendment,None,Failed,1,234,0,6,161,20,0,10,0,0,0,0,162,254,0,16
407,R,112,H R 4480,21-Jun-2012,12:25 PM,On Agreeing to the Amendment,None,Failed,1,234,0,6,161,21,0,9,0,0,0,0,162,255,0,15
408,R,112,H R 4480,21-Jun-2012,12:30 PM,On Agreeing to the Amendment,None,Failed,3,231,0,7,177,4,0,10,0,0,0,0,180,235,0,17
409,R,112,H R 4480,21-Jun-2012,12:58 PM,On Motion to Recommit with Instructions,Strategic Energy Production Act of 2012,Failed,1,230,0,10,165,13,0,13,0,0,0,0,166,243,0,23
410,R,112,H R 4480,21-Jun-2012,1:05 PM,On Passage,Strategic Energy Production Act of 2012,Passed,229,5,0,7,19,158,0,14,0,0,0,0,248,163,0,21
411,R,112,H R 4348,21-Jun-2012,1:12 PM,On McKinley of West Virginia Motion to Instruct Conferees,"To provide an extension of Federal-aid highway, highway safety, motor carrier safety, transit, and other programs funded out of the Highway Trust Fund pending enactment of a multiyear law reauthorizing such programs, and for other purposes",Passed,221,9,0,11,39,129,0,23,0,0,0,0,260,138,0,34
412,R,112,H RES 697,26-Jun-2012,6:56 PM,On Ordering the Previous Question,"Providing for consideration of H.R. 5973, Agriculture Appropriations 2013, and providing for consideration of H.R. 5972, Transportation, and Housing and Urban Development Appropriations 2013",Passed,225,0,0,16,1,168,0,22,0,0,0,0,226,168,0,38
413,R,112,H RES 697,26-Jun-2012,7:03 PM,On Agreeing to the Resolution,"Providing for consideration of H.R. 5973, Agriculture Appropriations 2013, and providing for consideration of H.R. 5972, Transportation, and Housing and Urban Development Appropriations 2013",Passed,225,0,0,16,4,166,0,21,0,0,0,0,229,166,0,37
414,R,112,H R 4348,26-Jun-2012,7:09 PM,On Hoyer of Maryland Motion to Instruct Conferees,"To provide an extension of Federal-aid highway, highway safety, motor carrier safety, transit, and other programs funded out of the Highway Trust Fund pending enactment of a multiyear law reauthorizing such programs, and for other purposes",Failed,6,222,0,13,166,3,1,21,0,0,0,0,172,225,1,34
415,R,112,H R 4348,26-Jun-2012,7:16 PM,On Black of Tennessee Motion to Instruct Conferees,"To provide an extension of Federal-aid highway, highway safety, motor carrier safety, transit, and other programs funded out of the Highway Trust Fund pending enactment of a multiyear law reauthorizing such programs, and for other purposes",Passed,201,25,0,15,0,169,0,22,0,0,0,0,201,194,0,37
416,R,112,H R 5972,26-Jun-2012,10:46 PM,On Agreeing to the Amendment,None,Failed,10,219,0,12,165,3,0,23,0,0,0,0,175,222,0,35
417,R,112,H R 5972,26-Jun-2012,10:51 PM,On Agreeing to the Amendment,None,Failed,154,77,0,10,10,161,0,20,0,0,0,0,164,238,0,30
418,R,112,H R 5972,26-Jun-2012,10:55 PM,On Agreeing to the Amendment,None,Failed,156,76,0,9,4,167,0,20,0,0,0,0,160,243,0,29
419,R,112,H R 5972,26-Jun-2012,10:59 PM,On Agreeing to the Amendment,None,Failed,14,217,0,10,170,1,0,20,0,0,0,0,184,218,0,30
420,R,112,H R 5972,26-Jun-2012,11:03 PM,On Agreeing to the Amendment,None,Failed,174,58,0,9,5,166,0,20,0,0,0,0,179,224,0,29
421,R,112,H R 5972,26-Jun-2012,11:07 PM,On Agreeing to the Amendment,None,Failed,170,62,0,9,3,168,0,20,0,0,0,0,173,230,0,29
422,R,112,H R 5972,26-Jun-2012,11:10 PM,On Agreeing to the Amendment,None,Failed,183,49,0,9,5,166,0,20,0,0,0,0,188,215,0,29
423,R,112,H R 5972,26-Jun-2012,11:15 PM,On Agreeing to the Amendment,None,Failed,137,95,0,9,1,170,0,20,0,0,0,0,138,265,0,29
424,R,112,H R 5972,27-Jun-2012,4:36 PM,On Agreeing to the Amendment,None,Failed,166,71,0,4,2,185,0,4,0,0,0,0,168,256,0,8
425,R,112,H R 5972,27-Jun-2012,4:40 PM,On Agreeing to the Amendment,None,Failed,175,59,0,7,3,181,0,7,0,0,0,0,178,240,0,14
426,R,112,H R 5972,27-Jun-2012,4:44 PM,On Agreeing to the Amendment,None,Failed,171,65,0,5,3,183,0,5,0,0,0,0,174,248,0,10
427,R,112,H R 5972,27-Jun-2012,4:48 PM,On Agreeing to the Amendment,None,Failed,184,50,0,7,9,179,0,3,0,0,0,0,193,229,0,10
428,R,112,H R 5972,27-Jun-2012,4:52 PM,On Agreeing to the Amendment,None,Failed,174,63,0,4,4,184,0,3,0,0,0,0,178,247,0,7
429,R,112,H R 5972,27-Jun-2012,4:55 PM,On Agreeing to the Amendment,None,Failed,167,70,0,4,2,180,0,9,0,0,0,0,169,250,0,13
430,R,112,H R 5972,27-Jun-2012,4:58 PM,On Agreeing to the Amendment,None,Failed,157,79,0,5,3,185,0,3,0,0,0,0,160,264,0,8
431,R,112,H R 5972,27-Jun-2012,5:02 PM,On Agreeing to the Amendment,None,Failed,168,68,0,5,4,181,0,6,0,0,0,0,172,249,0,11
432,R,112,H R 5972,27-Jun-2012,5:05 PM,On Agreeing to the Amendment,None,Failed,170,65,0,6,2,185,0,4,0,0,0,0,172,250,0,10
433,R,112,H R 5972,27-Jun-2012,5:10 PM,On Agreeing to the Amendment,None,Failed,157,80,0,4,0,187,0,4,0,0,0,0,157,267,0,8
434,R,112,H R 5972,27-Jun-2012,5:13 PM,On Agreeing to the Amendment,None,Failed,80,156,0,5,0,186,0,5,0,0,0,0,80,342,0,10
435,R,112,H R 5972,27-Jun-2012,5:17 PM,On Agreeing to the Amendment,None,Failed,123,114,0,4,0,186,0,5,0,0,0,0,123,300,0,9
436,R,112,H R 5972,27-Jun-2012,5:20 PM,On Agreeing to the Amendment,None,Failed,174,59,0,8,4,183,0,4,0,0,0,0,178,242,0,12
437,R,112,H RES 708,28-Jun-2012,2:07 PM,On Agreeing to the Resolution,"Relating to the consideration of House Report 112-546 and an accompanying resolution, and providing for consideration of the resolution (H. Res. 706) authorizing the Committee on Oversight and Government Reform to initiate or intervene in judicial proceedings to enforce certain subpoenas.",Passed,239,0,0,2,15,173,0,3,0,0,0,0,254,173,0,5
438,R,112,H R 4251,28-Jun-2012,2:15 PM,"On Motion to Suspend the Rules and Pass, as Amended",Securing Maritime Activites through Risk-based Targeting (SMART) for Port Security Act,Passed,220,18,0,3,182,3,0,6,0,0,0,0,402,21,0,9
439,R,112,H R 4005,28-Jun-2012,2:23 PM,"On Motion to Suspend the Rules and Pass, as Amended",Gauging American Port Security (GAPS) Act,Passed,228,8,0,5,183,1,0,7,0,0,0,0,411,9,0,12
440,R,112,H RES 711,28-Jun-2012,4:30 PM,On Motion to Refer the Resolution to Oversight and Government Reform,"Recommending that the House of Representatives find Eric H. Holder Jr., Attorney General, U.S. Department of Justice, in contempt of Congress for refusal to comply with a subpoena duly issued by the Committee on Oversight and Government Reform",Failed,0,237,0,4,172,14,0,5,0,0,0,0,172,251,0,9
441,R,112,H RES 711,28-Jun-2012,4:39 PM,On Agreeing to the Resolution,"Recommending that the House of Representatives find Eric H. Holder Jr., Attorney General, U.S. Department of Justice, in contempt of Congress for refusal to comply with a subpoena duly issued by the Committee on Oversight and Government Reform",Passed,238,2,0,1,17,65,1,108,0,0,0,0,255,67,1,109
442,R,112,H RES 706,28-Jun-2012,5:34 PM,On Agreeing to the Resolution,Authorizing the Committee on Oversight and Government Reform to initiate or intervene in judicial proceedings to enforce certain subpoenas,Passed,237,0,0,4,21,95,5,70,0,0,0,0,258,95,5,74
443,R,112,H RES 718,29-Jun-2012,10:35 AM,On Motion to Table,Raising a question of the privileges of the House,Passed,235,0,0,6,24,161,0,6,0,0,0,0,259,161,0,12
444,R,112,H RES 717,29-Jun-2012,10:43 AM,On Agreeing to the Resolution,"Providing for consideration of H.R. 5856, Defense Appropriations for FY 2013; consideration of H.R. 6020, Financial Services and General Government Appropriations for FY 2013; consideration of the conference report to accompany H.R. 4348, the Surface Transportation Extension Act of 2012, Part II",Passed,232,2,0,7,12,174,0,5,0,0,0,0,244,176,0,12
445,R,112,H R 5972,29-Jun-2012,12:17 PM,On Agreeing to the Amendment,None,Failed,160,75,0,6,6,179,0,6,0,0,0,0,166,254,0,12
446,R,112,H R 5972,29-Jun-2012,12:21 PM,On Agreeing to the Amendment,None,Agreed to,230,6,0,5,5,180,0,6,0,0,0,0,235,186,0,11
447,R,112,H R 5972,29-Jun-2012,12:31 PM,On Agreeing to the Amendment,None,Agreed to,222,16,0,3,12,175,0,4,0,0,0,0,234,191,0,7
448,R,112,H R 5972,29-Jun-2012,12:35 PM,On Agreeing to the Amendment,None,Agreed to,235,2,0,4,4,183,0,4,0,0,0,0,239,185,0,8
449,R,112,H R 5972,29-Jun-2012,1:01 PM,On Motion to Recommit with Instructions,"Making appropriations for the Departments of Transportation, and Housing and Urban Development, and related agencies for the fiscal year ending September 30, 2013, and for other purposes",Failed,3,233,0,5,185,0,0,6,0,0,0,0,188,233,0,11
450,R,112,H R 5972,29-Jun-2012,1:09 PM,On Passage,"Making appropriations for the Departments of Transportation, and Housing and Urban Development, and related agencies for the fiscal year ending September 30, 2013, and for other purposes",Passed,182,55,0,4,79,108,0,4,0,0,0,0,261,163,0,8
451,R,112,H R 4348,29-Jun-2012,1:22 PM,On Agreeing to the Conference Report,"To provide an extension of Federal-aid highway, highway safety, motor carrier safety, transit, and other programs funded out of the Highway Trust Fund pending enactment of a multiyear law reauthorizing such programs, and for other purposes",Passed,186,52,0,3,187,0,0,4,0,0,0,0,373,52,0,7
452,R,112,H R 4155,9-Jul-2012,6:55 PM,"On Motion to Suspend the Rules and Pass, as Amended",To direct the head of each Federal department and agency to treat relevant military training as sufficient to satisfy training or certification requirements for Federal licenses,Passed,206,0,0,34,163,0,0,28,0,0,0,0,369,0,0,62
453,R,112,H R 4367,9-Jul-2012,7:02 PM,On Motion to Suspend the Rules and Pass,To amend the Electronic Fund Transfer Act to limit the fee disclosure requirement for an automatic teller machine to the screen of that machine,Passed,211,0,0,29,160,0,0,31,0,0,0,0,371,0,0,60
454,R,112,H R 5892,9-Jul-2012,7:09 PM,On Motion to Suspend the Rules and Pass,Hydropower Regulatory Efficiency Act of 2012,Passed,208,0,0,32,164,0,0,27,0,0,0,0,372,0,0,59
455,R,112,ADJOURN,10-Jul-2012,12:59 PM,On Motion to Adjourn,None,Failed,0,227,1,12,75,91,0,25,0,0,0,0,75,318,1,37
456,R,112,H RES 724,10-Jul-2012,2:40 PM,On Ordering the Previous Question,Providing for consideration of the bill (H.R. 6079) to repeal the Patient Protection and Affordable Care Act and health care-related provisions in the Health Care and Education Reconciliation Act of 2010,Passed,235,0,0,5,3,184,0,4,0,0,0,0,238,184,0,9
457,R,112,H RES 724,10-Jul-2012,2:46 PM,On Agreeing to the Resolution,Providing for consideration of the bill (H.R. 6079) to repeal the Patient Protection and Affordable Care Act and health care-related provisions in the Health Care and Education Reconciliation Act of 2010,Passed,236,0,0,4,4,182,0,5,0,0,0,0,240,182,0,9
458,R,112,JOURNAL,10-Jul-2012,2:53 PM,On Approving the Journal,None,Passed,185,49,2,4,127,56,1,7,0,0,0,0,312,105,3,11
459,R,112,H R 6079,11-Jul-2012,3:45 PM,On Motion to Recommit with Instructions,To repeal the Patient Protection and Affordable Care Act and health care-related provisions in the Health Care and Education Reconciliation Act 2010,Failed,0,239,0,1,180,9,0,2,0,0,0,0,180,248,0,3
460,R,112,H R 6079,11-Jul-2012,3:53 PM,On Passage,To repeal the Patient Protection and Affordable Care Act and health care-related provisions in the Health Care and Education Reconciliation Act 2010,Passed,239,0,0,1,5,185,0,1,0,0,0,0,244,185,0,2
461,R,112,H RES 726,11-Jul-2012,4:06 PM,On Agreeing to the Resolution,"Providing for consideration of H.R. 4402, to require the Secretary of the Interior and the Secretary of Agriculture to more efficiently develop domestic sources of the minerals and mineral materials of strategic and critical importance to United States economic and national security and manufacturing competitiveness",Passed,235,0,0,5,10,180,0,1,0,0,0,0,245,180,0,6
462,R,112,H R 4402,12-Jul-2012,11:58 AM,On Agreeing to the Amendment,None,Failed,0,233,0,7,162,18,0,11,0,0,0,0,162,251,0,18
463,R,112,H R 4402,12-Jul-2012,12:03 PM,On Agreeing to the Amendment,None,Failed,0,233,0,7,162,19,0,10,0,0,0,0,162,252,0,17
464,R,112,H R 4402,12-Jul-2012,12:07 PM,On Agreeing to the Amendment,None,Failed,3,230,0,7,160,23,0,8,0,0,0,0,163,253,0,15
465,R,112,H R 4402,12-Jul-2012,12:11 PM,On Agreeing to the Amendment,None,Agreed to,225,8,0,7,13,170,0,8,0,0,0,0,238,178,0,15
466,R,112,H R 4402,12-Jul-2012,12:14 PM,On Agreeing to the Amendment,None,Failed,2,232,0,6,165,16,0,10,0,0,0,0,167,248,0,16
467,R,112,H R 4402,12-Jul-2012,12:43 PM,On Motion to Recommit with Instructions,National Strategic and Critical Minerals Production Act,Failed,1,228,0,11,180,3,0,8,0,0,0,0,181,231,0,19
468,R,112,H R 4402,12-Jul-2012,12:50 PM,On Passage,National Strategic and Critical Minerals Production Act,Passed,234,0,0,6,22,160,0,9,0,0,0,0,256,160,0,15
469,R,112,H R 6018,17-Jul-2012,6:54 PM,"On Motion to Suspend the Rules and Pass, as Amended","Foreign Relations Authorization Act, Fiscal Year 2013",Passed,166,60,0,14,167,1,0,23,0,0,0,0,333,61,0,37
470,R,112,S 2009,17-Jul-2012,7:04 PM,On Motion to Suspend the Rules and Pass,Insular Areas Act of 2011,Passed,212,11,0,17,166,0,0,25,0,0,0,0,378,11,0,42
471,R,112,H R 5872,18-Jul-2012,1:54 PM,"On Motion to Suspend the Rules and Pass, as Amended",Sequestration Transparency Act of 2012,Passed,237,0,0,3,177,2,0,12,0,0,0,0,414,2,0,15
472,R,112,H R 5856,18-Jul-2012,9:35 PM,On Agreeing to the Amendment,None,Failed,84,154,0,2,82,96,0,13,0,0,0,0,166,250,0,15
473,R,112,H R 5856,18-Jul-2012,9:40 PM,On Agreeing to the Amendment,None,Failed,81,156,0,3,121,60,0,10,0,0,0,0,202,216,0,13
474,R,112,H R 5856,18-Jul-2012,9:45 PM,On Agreeing to the Amendment,None,Failed,24,214,0,2,36,145,0,10,0,0,0,0,60,359,0,12
475,R,112,H R 5856,18-Jul-2012,9:49 PM,On Agreeing to the Amendment,None,Failed,16,221,0,3,129,52,0,10,0,0,0,0,145,273,0,13
476,R,112,H R 5856,18-Jul-2012,9:54 PM,On Agreeing to the Amendment,None,Failed,120,118,0,2,17,164,0,10,0,0,0,0,137,282,0,12
477,R,112,H R 5856,18-Jul-2012,9:58 PM,On Agreeing to the Amendment,None,Failed,12,226,0,2,138,42,0,11,0,0,0,0,150,268,0,13
478,R,112,H R 5856,18-Jul-2012,10:01 PM,On Agreeing to the Amendment,None,Failed,185,53,0,2,1,180,0,10,0,0,0,0,186,233,0,12
479,R,112,H R 5856,18-Jul-2012,10:06 PM,On Agreeing to the Amendment,None,Agreed to,68,170,0,2,160,21,0,10,0,0,0,0,228,191,0,12
480,R,112,H R 5856,18-Jul-2012,10:09 PM,On Agreeing to the Amendment,None,Failed,48,190,0,2,101,80,0,10,0,0,0,0,149,270,0,12
481,R,112,H R 5856,18-Jul-2012,10:13 PM,On Agreeing to the Amendment,None,Failed,28,209,0,3,86,93,0,12,0,0,0,0,114,302,0,15
482,R,112,H R 5856,18-Jul-2012,10:16 PM,On Agreeing to the Amendment,None,Failed,3,235,0,2,133,48,0,10,0,0,0,0,136,283,0,12
483,R,112,H R 5856,18-Jul-2012,10:19 PM,On Agreeing to the Amendment,None,Failed,19,217,0,4,87,94,0,10,0,0,0,0,106,311,0,14
484,R,112,H R 5856,18-Jul-2012,10:22 PM,On Agreeing to the Amendment,None,Failed,14,224,0,2,77,104,0,10,0,0,0,0,91,328,0,12
485,R,112,H R 5856,18-Jul-2012,10:25 PM,On Agreeing to the Amendment,None,Failed,8,230,0,2,99,82,0,10,0,0,0,0,107,312,0,12
486,R,112,H R 5856,18-Jul-2012,10:29 PM,On Agreeing to the Amendment,None,Failed,182,54,0,4,0,181,0,10,0,0,0,0,182,235,0,14
487,R,112,H R 5856,19-Jul-2012,6:15 PM,On Agreeing to the Amendment,None,Agreed to,230,5,0,5,17,161,0,13,0,0,0,0,247,166,0,18
488,R,112,H R 5856,19-Jul-2012,6:19 PM,On Agreeing to the Amendment,None,Failed,7,228,0,5,80,98,0,13,0,0,0,0,87,326,0,18
489,R,112,H R 5856,19-Jul-2012,6:22 PM,On Agreeing to the Amendment,None,Failed,24,212,0,4,147,31,0,13,0,0,0,0,171,243,0,17
490,R,112,H R 5856,19-Jul-2012,6:26 PM,On Agreeing to the Amendment,None,Agreed to,231,4,0,5,176,1,0,14,0,0,0,0,407,5,0,19
491,R,112,H R 5856,19-Jul-2012,6:29 PM,On Agreeing to the Amendment,None,Agreed to,227,8,0,5,8,170,0,13,0,0,0,0,235,178,0,18
492,R,112,H R 5856,19-Jul-2012,6:32 PM,On Agreeing to the Amendment,None,Failed,46,190,0,4,77,102,0,12,0,0,0,0,123,292,0,16
493,R,112,H R 5856,19-Jul-2012,6:35 PM,On Agreeing to the Amendment,None,Agreed to,220,16,0,4,12,167,0,12,0,0,0,0,232,183,0,16
494,R,112,H R 5856,19-Jul-2012,6:40 PM,On Agreeing to the Amendment,None,Failed,8,228,0,4,129,50,0,12,0,0,0,0,137,278,0,16
495,R,112,H R 5856,19-Jul-2012,6:43 PM,On Agreeing to the Amendment,None,Agreed to,89,146,0,5,158,21,0,12,0,0,0,0,247,167,0,17
496,R,112,H R 5856,19-Jul-2012,6:48 PM,On Agreeing to the Amendment,None,Agreed to,154,82,0,4,84,96,0,11,0,0,0,0,238,178,0,15
497,R,112,H R 5856,19-Jul-2012,6:52 PM,On Agreeing to the Amendment,None,Agreed to,236,0,0,4,163,17,0,11,0,0,0,0,399,17,0,15
498,R,112,H R 5856,19-Jul-2012,7:11 PM,On Passage,"Making appropriations for the Department of Defense for the fiscal year ending September 30, 2013, and for other purposes",Passed,225,11,0,4,101,79,0,11,0,0,0,0,326,90,0,15
499,R,112,H R 2362,23-Jul-2012,6:56 PM,"On Motion to Suspend the Rules and Pass, as Amended",Indian Tribal Trade and Investment Demonstration Project Act of 2011,Failed,179,42,0,19,43,118,0,30,0,0,0,0,222,160,0,49
500,R,112,S 2039,23-Jul-2012,7:03 PM,On Motion to Suspend the Rules and Pass,To allow a State or local government to construct levees on certain properties otherwise designated as open space lands,Failed,117,103,0,20,9,151,0,31,0,0,0,0,126,254,0,51
501,R,112,H R 3477,23-Jul-2012,7:09 PM,On Motion to Suspend the Rules and Pass,"To designate the facility of the United States Postal Service located at 133 Hare Road in Crosby, Texas, as the Army First Sergeant David McNerney Post Office Building",Passed,219,0,0,21,160,0,0,31,0,0,0,0,379,0,0,52
502,R,112,H RES 738,24-Jul-2012,2:56 PM,On Ordering the Previous Question,"Providing for consideration of the bill (H.R. 4078), Regulatory Freeze for Jobs Act of 2012, and providing for the bill (H.R. 6082), Congressional Replacement of President Obama’s Energy-Restricting and Job-Limiting Offshore Drilling Plan, and for other purposes",Passed,235,0,0,5,3,177,0,11,0,0,0,0,238,177,0,16
503,R,112,H RES 738,24-Jul-2012,3:06 PM,On Agreeing to the Resolution,"Providing for consideration of the bill (H.R. 4078), Regulatory Freeze for Jobs Act of 2012, and providing for the bill (H.R. 6082), Congressional Replacement of President Obama’s Energy-Restricting and Job-Limiting Offshore Drilling Plan, and for other purposes",Passed,235,0,0,5,9,170,0,12,0,0,0,0,244,170,0,17
504,R,112,H R 6082,25-Jul-2012,1:47 PM,On Agreeing to the Amendment,None,Failed,8,230,0,2,155,23,0,13,0,0,0,0,163,253,0,15
505,R,112,H R 6082,25-Jul-2012,1:52 PM,On Agreeing to the Amendment,None,Failed,6,232,0,2,152,30,0,9,0,0,0,0,158,262,0,11
506,R,112,H R 6082,25-Jul-2012,1:55 PM,On Agreeing to the Amendment,None,Failed,15,224,0,1,174,8,0,9,0,0,0,0,189,232,0,10
507,R,112,H R 6082,25-Jul-2012,1:59 PM,On Agreeing to the Amendment,None,Failed,10,229,0,1,167,18,0,6,0,0,0,0,177,247,0,7
508,R,112,H R 6082,25-Jul-2012,2:03 PM,On Agreeing to the Amendment,None,Failed,1,237,0,2,157,29,0,5,0,0,0,0,158,266,0,7
509,R,112,H R 6082,25-Jul-2012,2:07 PM,On Agreeing to the Amendment,None,Failed,1,238,0,1,149,37,0,5,0,0,0,0,150,275,0,6
510,R,112,H R 6082,25-Jul-2012,2:36 PM,On Motion to Recommit with Instructions,Congressional Replacement of President Obama’s Energy-Restricting and Job-Limiting Offshore Drilling Plan,Failed,0,239,0,1,179,1,0,11,0,0,0,0,179,240,0,12
511,R,112,H R 6082,25-Jul-2012,2:42 PM,On Passage,Congressional Replacement of President Obama’s Energy-Restricting and Job-Limiting Offshore Drilling Plan,Passed,228,9,0,3,25,161,0,5,0,0,0,0,253,170,0,8
512,R,112,H R 6168,25-Jul-2012,2:50 PM,On Motion to Suspend the Rules and Pass,President Obama’s Proposed 2010-2017 Offshore Drilling Lease Sale Plan Act,Failed,1,238,0,1,163,23,0,5,0,0,0,0,164,261,0,6
513,R,112,H R 459,25-Jul-2012,2:58 PM,"On Motion to Suspend the Rules and Pass, as Amended","To require a full audit of the Board of Governors of the Federal Reserve System and the Federal reserve banks by the Comptroller General of the United States before the end of 2012, and for other purposes",Passed,238,1,0,1,89,97,0,5,0,0,0,0,327,98,0,6
514,R,112,H R 4078,25-Jul-2012,6:39 PM,On Agreeing to the Amendment,None,Failed,14,222,0,4,174,9,0,8,0,0,0,0,188,231,0,12
515,R,112,H R 4078,25-Jul-2012,6:43 PM,On Agreeing to the Amendment,None,Failed,2,234,0,4,157,25,0,9,0,0,0,0,159,259,0,13
516,R,112,H R 4078,25-Jul-2012,6:47 PM,On Agreeing to the Amendment,None,Failed,6,231,0,3,167,14,0,10,0,0,0,0,173,245,0,13
517,R,112,H R 4078,25-Jul-2012,6:51 PM,On Agreeing to the Amendment,None,Failed,3,232,0,5,171,10,0,10,0,0,0,0,174,242,0,15
518,R,112,H R 4078,25-Jul-2012,6:55 PM,On Agreeing to the Amendment,None,Failed,7,230,0,3,170,10,0,11,0,0,0,0,177,240,0,14
519,R,112,H RES 741,26-Jul-2012,11:04 AM,On Ordering the Previous Question,Providing for further consideration of the bill (H.R. 4078) to provide that no agency may take any significant regulatory action until the unemployment rate is equal to or less than 6.0 percent,Passed,232,2,0,6,3,181,0,7,0,0,0,0,235,183,0,13
520,R,112,H R 4078,26-Jul-2012,11:23 AM,On Agreeing to the Amendment,None,Failed,0,237,0,3,177,7,0,7,0,0,0,0,177,244,0,10
521,R,112,H R 4078,26-Jul-2012,11:26 AM,On Agreeing to the Amendment,None,Failed,3,232,0,5,174,6,0,11,0,0,0,0,177,238,0,16
522,R,112,H R 4078,26-Jul-2012,11:30 AM,On Agreeing to the Amendment,None,Failed,1,234,0,5,169,13,0,9,0,0,0,0,170,247,0,14
523,R,112,H R 4078,26-Jul-2012,11:33 AM,On Agreeing to the Amendment,None,Failed,0,237,0,3,173,9,0,9,0,0,0,0,173,246,0,12
524,R,112,H R 4078,26-Jul-2012,11:36 AM,On Agreeing to the Amendment,None,Failed,3,230,0,7,176,4,0,11,0,0,0,0,179,234,0,18
525,R,112,H R 4078,26-Jul-2012,11:41 AM,On Agreeing to the Amendment,None,Agreed to,230,6,0,4,18,165,0,8,0,0,0,0,248,171,0,12
526,R,112,H R 4078,26-Jul-2012,11:45 AM,On Agreeing to the Amendment,None,Failed,9,227,0,4,167,16,0,8,0,0,0,0,176,243,0,12
527,R,112,H R 4078,26-Jul-2012,11:48 AM,On Agreeing to the Amendment,None,Agreed to,226,10,0,4,14,168,0,9,0,0,0,0,240,178,0,13
528,R,112,H R 4078,26-Jul-2012,11:51 AM,On Agreeing to the Amendment,None,Failed,2,231,0,7,172,8,0,11,0,0,0,0,174,239,0,18
529,R,112,H R 4078,26-Jul-2012,11:55 AM,On Agreeing to the Amendment,None,Failed,5,229,0,6,173,7,0,11,0,0,0,0,178,236,0,17
530,R,112,H R 4078,26-Jul-2012,11:58 AM,On Agreeing to the Amendment,None,Failed,1,235,0,4,170,12,0,9,0,0,0,0,171,247,0,13
531,R,112,H R 4078,26-Jul-2012,12:01 PM,On Agreeing to the Amendment,None,Agreed to,233,3,0,4,18,163,0,10,0,0,0,0,251,166,0,14
532,R,112,H R 4078,26-Jul-2012,12:04 PM,On Agreeing to the Amendment,None,Agreed to,231,5,0,4,14,166,0,11,0,0,0,0,245,171,0,15
533,R,112,H R 4078,26-Jul-2012,12:08 PM,On Agreeing to the Amendment,None,Failed,2,234,0,4,171,9,0,11,0,0,0,0,173,243,0,15
534,R,112,H R 4078,26-Jul-2012,12:12 PM,On Agreeing to the Amendment,None,Agreed to,233,3,0,4,18,162,0,11,0,0,0,0,251,165,0,15
535,R,112,H R 4078,26-Jul-2012,12:42 PM,On Motion to Recommit with Instructions,To provide that no agency may take any significant regulatory action until the unemployment rate is equal to or less than 6.0 percent,Failed,1,233,0,6,180,1,0,10,0,0,0,0,181,234,0,16
536,R,112,H R 4078,26-Jul-2012,12:50 PM,On Passage,To provide that no agency may take any significant regulatory action until the unemployment rate is equal to or less than 6.0 percent,Passed,232,2,0,6,13,170,0,8,0,0,0,0,245,172,0,14
537,R,112,S 679,31-Jul-2012,7:06 PM,On Motion to Suspend the Rules and Pass,To reduce the number of executive positions subject to Senate confirmation,Passed,95,115,0,30,166,1,0,24,0,0,0,0,261,116,0,54
538,R,112,H R 828,31-Jul-2012,7:13 PM,"On Motion to Suspend the Rules and Pass, as Amended",Federal Employee Tax Accountability Act of 2012,Passed,204,6,0,30,59,108,0,24,0,0,0,0,263,114,0,54
539,R,112,H R 3803,31-Jul-2012,7:20 PM,"On Motion to Suspend the Rules and Pass, as Amended",District of Columbia Pain-Capable Unborn Child Protection Act,Failed,203,6,2,29,17,148,0,26,0,0,0,0,220,154,2,55
540,R,112,H RES 747,1-Aug-2012,2:04 PM,On Ordering the Previous Question,"Providing for consideration of the bill (H.R. 6169) Pathway to Job Creation through a Simpler, Fairer Tax Code Act of 2012; providing for consideration of the bill (H.R. 8) Job Protection and Recession Prevention Act and providing for consideration of motions to suspend the rules",Passed,236,0,0,3,4,183,0,4,0,0,0,0,240,183,0,7
541,R,112,H RES 747,1-Aug-2012,2:11 PM,On Agreeing to the Amendment,None,Agreed to,237,0,0,2,1,186,0,4,0,0,0,0,238,186,0,6
542,R,112,H RES 747,1-Aug-2012,2:20 PM,"On Agreeing to the Resolution, as Amended","Providing for consideration of the bill (H.R. 6169) Pathway to Job Creation through a Simpler, Fairer Tax Code Act of 2012; providing for consideration of the bill (H.R. 8) Job Protection and Recession Prevention Act and providing for consideration of motions to suspend the rules",Passed,237,0,0,2,3,184,0,4,0,0,0,0,240,184,0,6
543,R,112,H R 8,1-Aug-2012,5:37 PM,On Agreeing to the Amendment,"To amend title 5, United States Code, to make clear that accounts in the Thrift Savings Fund are subject to certain Federal tax levies",Failed,0,238,0,1,170,19,0,2,0,0,0,0,170,257,0,3
544,R,112,H R 8,1-Aug-2012,6:11 PM,On Motion to Recommit with Instructions,"To extend certain tax relief provisions enacted in 2001 and 2003, and for other purposes",Failed,2,236,0,1,179,10,0,2,0,0,0,0,181,246,0,3
545,R,112,H R 8,1-Aug-2012,6:19 PM,On Passage,"To extend certain tax relief provisions enacted in 2001 and 2003, and for other purposes",Passed,237,1,0,1,19,170,0,2,0,0,0,0,256,171,0,3
546,R,112,H RES 750,1-Aug-2012,6:26 PM,On Motion to Suspend the Rules and Agree,"Providing for the concurrence by the House in the Senate amendment to H.R. 1905, with an amendment",Passed,233,5,0,1,188,1,0,2,0,0,0,0,421,6,0,3
547,R,112,H R 4365,1-Aug-2012,6:33 PM,"On Motion to Suspend the Rules and Pass, as Amended","To amend title 5, United States Code, to make clear that accounts in the Thrift Savings Fund are subject to certain Federal tax levies",Passed,232,3,1,3,182,3,0,6,0,0,0,0,414,6,1,9
548,R,112,H RES 752,2-Aug-2012,11:32 AM,On Ordering the Previous Question,"Providing for consideration of the bill (H.R. 6233) to make supplemental agricultural disaster assistance available for fiscal year 2012 with the costs of such assistance offset by changes to certain conservation programs, and for other purposes",Passed,233,0,0,6,3,182,0,6,0,0,0,0,236,182,0,12
549,R,112,H RES 752,2-Aug-2012,11:40 AM,On Agreeing to the Resolution,"Providing for consideration of the bill (H.R. 6233) to make supplemental agricultural disaster assistance available for fiscal year 2012 with the costs of such assistance offset by changes to certain conservation programs, and for other purposes",Passed,233,0,0,6,2,181,0,8,0,0,0,0,235,181,0,14
550,R,112,H R 6169,2-Aug-2012,3:46 PM,On Agreeing to the Amendment,None,Failed,0,236,0,3,176,10,0,5,0,0,0,0,176,246,0,8
551,R,112,H R 6169,2-Aug-2012,4:12 PM,On Motion to Recommit with Instructions,To provide for expedited consideration of a bill providing for comprehensive tax reform,Failed,3,233,0,3,185,2,0,4,0,0,0,0,188,235,0,7
552,R,112,H R 6169,2-Aug-2012,4:20 PM,On Passage,To provide for expedited consideration of a bill providing for comprehensive tax reform,Passed,232,3,0,4,0,186,0,5,0,0,0,0,232,189,0,9
553,R,112,H R 6233,2-Aug-2012,4:49 PM,On Motion to Recommit with Instructions,Agricultural Disaster Assistance Act of 2012,Failed,2,232,0,5,187,0,0,4,0,0,0,0,189,232,0,9
554,R,112,H R 6233,2-Aug-2012,4:57 PM,On Passage,Agricultural Disaster Assistance Act of 2012,Passed,188,46,0,5,35,151,0,5,0,0,0,0,223,197,0,10
555,R,112,H CON RES 127,2-Aug-2012,5:06 PM,On Motion to Suspend the Rules and Agree,Expressing the sense of Congress regarding actions to preserve and advance the multistakeholder governance model under which the Internet has thrived,Passed,229,0,0,10,185,0,0,6,0,0,0,0,414,0,0,16
556,R,112,S CON RES 56,2-Aug-2012,5:24 PM,On Agreeing to the Resolution,Providing for a conditional adjournment or recess of the Senate and an adjournment of the House of Representatives,Failed,150,78,0,11,0,187,0,4,0,0,0,0,150,265,0,15
557,R,112,H R 6122,10-Sep-2012,6:53 PM,On Motion to Suspend the Rules and Pass,"To revise the authority of the Librarian of Congress to accept gifts and bequests on behalf of the Library, and for other purposes",Passed,214,0,0,25,163,0,0,27,0,0,0,0,377,0,0,52
558,R,112,H R 2139,10-Sep-2012,7:00 PM,"On Motion to Suspend the Rules and Pass, as Amended",Lions Clubs International Century of Service Commemorative Coin Act,Passed,213,2,1,23,163,0,0,27,0,0,0,0,376,2,1,50
559,R,112,H R 6186,10-Sep-2012,7:06 PM,On Motion to Suspend the Rules and Pass,To require a study of voluntary community-based flood insurance options and how such options could be incorporated into the national flood insurance program,Passed,204,11,0,24,160,0,0,30,0,0,0,0,364,11,0,54
560,R,112,H RES 773,11-Sep-2012,2:26 PM,On Ordering the Previous Question,"Providing for consideration of H.R. 5544, to authorize and expedite a land exchange involving National Forest System land in the State of Minnesota for the public school system, and for consideration of H.R. 5949, to extend the FISA Amendments Act of 2008 for 5 years",Passed,227,2,0,10,5,175,0,10,0,0,0,0,232,177,0,20
561,R,112,H RES 773,11-Sep-2012,2:34 PM,On Agreeing to the Resolution,"Providing for consideration of H.R. 5544, to authorize and expedite a land exchange involving National Forest System land in the State of Minnesota for the public school system, and for consideration of H.R. 5949, to extend the FISA Amendments Act of 2008 for 5 years",Passed,227,3,0,9,6,176,0,8,0,0,0,0,233,179,0,17
562,R,112,H R 4264,11-Sep-2012,2:41 PM,"On Motion to Suspend the Rules and Pass, as Amended",FHA Emergency Fiscal Solvency Act,Passed,223,7,0,9,179,0,0,11,0,0,0,0,402,7,0,20
563,R,112,H R 5544,12-Sep-2012,2:18 PM,On Agreeing to the Amendment,None,Failed,19,213,0,7,182,0,0,8,0,0,0,0,201,213,0,15
564,R,112,H R 5544,12-Sep-2012,2:27 PM,On Agreeing to the Amendment,None,Failed,2,227,0,10,175,9,0,6,0,0,0,0,177,236,0,16
565,R,112,H R 5544,12-Sep-2012,2:31 PM,On Agreeing to the Amendment,None,Failed,7,223,0,9,183,2,0,5,0,0,0,0,190,225,0,14
566,R,112,H R 5544,12-Sep-2012,2:35 PM,On Agreeing to the Amendment,None,Failed,7,222,0,10,184,1,0,5,0,0,0,0,191,223,0,15
567,R,112,H R 5544,12-Sep-2012,3:05 PM,On Motion to Recommit with Instructions,Minnesota Education Investment and Employment Act,Failed,0,232,0,7,183,1,0,6,0,0,0,0,183,233,0,13
568,R,112,H R 5544,12-Sep-2012,3:12 PM,On Passage,Minnesota Education Investment and Employment Act,Passed,223,8,0,8,2,181,0,7,0,0,0,0,225,189,0,15
569,R,112,H R 5949,12-Sep-2012,5:12 PM,On Passage,To extend the FISA Amendments Act of 2008 for five years,Passed,227,7,0,5,74,111,0,5,0,0,0,0,301,118,0,10
570,R,112,H R 3857,12-Sep-2012,5:19 PM,"On Motion to Suspend the Rules and Pass, as Amended",Public Transit Security and Local Law Enforcement Support Act,Passed,176,57,0,6,179,5,0,6,0,0,0,0,355,62,0,12
571,R,112,H R 5865,12-Sep-2012,5:27 PM,"On Motion to Suspend the Rules and Pass, as Amended",American Manufacturing Competitiveness Act of 2012,Passed,157,76,0,6,182,1,0,7,0,0,0,0,339,77,0,13
572,R,112,H RES 778,13-Sep-2012,2:36 PM,On Ordering the Previous Question,"Providing for consideration of H.J. Res. 117, making continuing appropriations for fiscal year 2013, and for other purposes; H.R. 6365, the National Security and Job Protection Act",Passed,229,2,0,8,6,176,0,8,0,0,0,0,235,178,0,16
573,R,112,H RES 778,13-Sep-2012,2:43 PM,On Agreeing to the Resolution,"Providing for consideration of H.J. Res. 117, making continuing appropriations for fiscal year 2013, and for other purposes; H.R. 6365, the National Security and Job Protection Act",Passed,230,2,0,7,2,180,0,8,0,0,0,0,232,182,0,15
574,R,112,H RES 779,13-Sep-2012,2:51 PM,On Agreeing to the Resolution,"Providing for consideration of H.R. 6213, the No More Solyndras Act",Passed,228,2,0,9,4,180,0,6,0,0,0,0,232,182,0,15
575,R,112,H R 1775,13-Sep-2012,2:59 PM,"On Motion to Suspend the Rules and Pass, as Amended",Stolen Valor Act,Passed,229,2,0,8,181,1,0,8,0,0,0,0,410,3,0,16
576,R,112,H R 6365,13-Sep-2012,5:33 PM,On Motion to Recommit with Instructions,National Security and Job Protection Act,Failed,0,234,0,5,170,13,0,7,0,0,0,0,170,247,0,12
577,R,112,H R 6365,13-Sep-2012,5:42 PM,On Passage,National Security and Job Protection Act,Passed,222,12,0,5,1,184,0,5,0,0,0,0,223,196,0,10
578,R,112,H J RES 117,13-Sep-2012,6:13 PM,On Motion to Recommit with Instructions,"Making continuing appropriations for fiscal year 2013, and for other purposes",Failed,3,232,0,4,186,0,0,4,0,0,0,0,189,232,0,8
579,R,112,H J RES 117,13-Sep-2012,6:20 PM,On Passage,"Making continuing appropriations for fiscal year 2013, and for other purposes",Passed,165,70,0,4,164,21,0,5,0,0,0,0,329,91,0,9
580,R,112,S 3245,13-Sep-2012,6:27 PM,On Motion to Suspend the Rules and Pass,"To extend by 3 years the authorization of the EB-5 Regional Center Program, the E-Verify Program, the Special Immigrant Nonminister Religious Worker Program, and the Conrad State 30 J-1 Visa Waiver Program",Passed,228,3,0,8,184,0,0,6,0,0,0,0,412,3,0,14
581,R,112,H R 6213,14-Sep-2012,11:39 AM,On Agreeing to the Amendment,None,Failed,0,228,0,11,169,10,0,11,0,0,0,0,169,238,0,22
582,R,112,H R 6213,14-Sep-2012,11:43 AM,On Agreeing to the Amendment,None,Failed,5,219,0,15,165,12,0,13,0,0,0,0,170,231,0,28
583,R,112,H R 6213,14-Sep-2012,12:12 PM,On Motion to Recommit with Instructions,No More Solyndras Act,Failed,0,228,0,11,175,6,0,9,0,0,0,0,175,234,0,20
584,R,112,H R 6213,14-Sep-2012,12:19 PM,On Passage,No More Solyndras Act,Passed,223,4,0,12,22,157,0,11,0,0,0,0,245,161,0,23
585,R,112,H R 5044,19-Sep-2012,6:49 PM,"On Motion to Suspend the Rules and Pass, as Amended",To amend the Internal Revenue Code of 1986 to exclude from gross income any discharge of indebtedness income on education loans of deceased veterans,Passed,226,0,0,13,174,0,0,16,0,0,0,0,400,0,0,29
586,R,112,H R 5912,19-Sep-2012,6:56 PM,"On Motion to Suspend the Rules and Pass, as Amended","To amend the Internal Revenue Code of 1986 to prohibit the use of public funds for political party conventions, and to provide for the return of previously distributed funds for deficit reduction",Passed,225,0,0,14,85,95,0,10,0,0,0,0,310,95,0,24
587,R,112,H RES 788,20-Sep-2012,2:06 PM,On Ordering the Previous Question,Providing for consideration of (H.J.Res. 118) and (H.R. 3409),Passed,231,0,0,8,7,179,0,4,0,0,0,0,238,179,0,12
588,R,112,H RES 788,20-Sep-2012,2:20 PM,On Agreeing to the Resolution,Providing for consideration of (H.J.Res. 118) and (H.R. 3409),Passed,229,1,0,9,4,181,0,5,0,0,0,0,233,182,0,14
589,R,112,H J RES 118,20-Sep-2012,4:56 PM,On Passage,Providing for congressional disapproval of the rule submitted by the Office of Family Assistance of the Administration for Children and Families of the Department of HHS relating to waiver and expenditure authority under the Social Security Act with respect to the Temporary Assistance for Needy Families program,Passed,231,0,0,8,19,164,0,7,0,0,0,0,250,164,0,15
590,R,112,H R 6429,20-Sep-2012,5:03 PM,On Motion to Suspend the Rules and Pass,"To amend the Immigration and Nationality Act to promote innovation, investment, and research in the United States, to eliminate the diversity immigrant program, and for other purposes",Failed,227,5,0,7,30,153,0,7,0,0,0,0,257,158,0,14
591,R,112,H R 5987,20-Sep-2012,5:11 PM,"On Motion to Suspend the Rules and Pass, as Amended","To establish the Manhattan Project National Historical Park in Oak Ridge, Tennessee, Los Alamos, New Mexico, and Hanford, Washington, and for other purposes",Failed,121,112,0,6,116,68,0,6,0,0,0,0,237,180,0,12
592,R,112,H R 3409,21-Sep-2012,10:49 AM,On Agreeing to the Amendment,None,Failed,9,216,0,14,165,13,0,12,0,0,0,0,174,229,0,26
593,R,112,H R 3409,21-Sep-2012,10:55 AM,On Agreeing to the Amendment,None,Failed,5,221,0,13,173,8,0,9,0,0,0,0,178,229,0,22
594,R,112,H R 3409,21-Sep-2012,11:00 AM,On Agreeing to the Amendment,None,Agreed to,222,6,0,11,20,162,0,8,0,0,0,0,242,168,0,19
595,R,112,H R 3409,21-Sep-2012,11:04 AM,On Agreeing to the Amendment,None,Failed,0,228,0,11,164,18,0,8,0,0,0,0,164,246,0,19
596,R,112,H R 3409,21-Sep-2012,11:10 AM,On Agreeing to the Amendment,None,Failed,2,227,0,10,162,20,0,8,0,0,0,0,164,247,0,18
597,R,112,H R 3409,21-Sep-2012,11:13 AM,On Agreeing to the Amendment,None,Agreed to,224,4,0,11,23,159,0,8,0,0,0,0,247,163,0,19
598,R,112,H R 3409,21-Sep-2012,11:19 AM,On Agreeing to the Amendment,None,Failed,3,225,0,11,157,25,0,8,0,0,0,0,160,250,0,19
599,R,112,H R 3409,21-Sep-2012,11:23 AM,On Agreeing to the Amendment,None,Failed,7,222,0,10,161,21,0,8,0,0,0,0,168,243,0,18
600,R,112,H R 3409,21-Sep-2012,11:27 AM,On Agreeing to the Amendment,None,Agreed to,218,11,0,10,10,172,0,8,0,0,0,0,228,183,0,18
601,R,112,H R 3409,21-Sep-2012,11:31 AM,On Agreeing to the Amendment,None,Agreed to,215,10,0,14,11,171,0,8,0,0,0,0,226,181,0,22
602,R,112,H R 3409,21-Sep-2012,11:59 AM,On Motion to Recommit with Instructions,"To limit the authority of the Secretary of the Interior to issue regulations before December 31, 2013, under the Surface Mining Control and Reclamation Act of 1977",Failed,0,227,0,12,173,6,0,11,0,0,0,0,173,233,0,23
603,R,112,H R 3409,21-Sep-2012,12:08 PM,On Passage,"To limit the authority of the Secretary of the Interior to issue regulations before December 31, 2013, under the Surface Mining Control and Reclamation Act of 1977",Passed,214,13,0,12,19,162,0,9,0,0,0,0,233,175,0,21
604,R,112,H R 6371,13-Nov-2012,6:49 PM,On Motion to Suspend the Rules and Pass,Streamlining Claims Processing for Federal Contractor Employees Act,Passed,212,3,0,24,149,0,0,41,0,0,0,0,361,3,0,65
605,R,112,H RES 808,15-Nov-2012,5:29 PM,On Ordering the Previous Question,"Providing for consideration of H.R. 6156, to authorize the extension of nondiscriminatory treatment (normal trade relations treatment) to products of the Russian Federation and Moldova and to require reports on the compliance of the Russian Federation with its obligations as a member of the World Trade Organization",Passed,230,2,0,8,13,162,0,17,0,0,0,0,243,164,0,25
606,R,112,H RES 808,15-Nov-2012,5:50 PM,On Agreeing to the Resolution,"Providing for consideration of H.R. 6156, to authorize the extension of nondiscriminatory treatment (normal trade relations treatment) to products of the Russian Federation and Moldova and to require reports on the compliance of the Russian Federation with its obligations as a member of the World Trade Organization",Passed,229,2,0,9,24,148,0,21,0,0,0,0,253,150,0,30
607,R,112,H R 2453,15-Nov-2012,6:02 PM,On Motion to Suspend the Rules and Concur in the Senate Amendments,Mark Twain Commemorative Coin Act,Passed,207,18,0,15,163,1,0,29,0,0,0,0,370,19,0,44
608,R,112,H R 6156,16-Nov-2012,11:59 AM,On Passage,Russia and Moldova Jackson-Vanik Repeal Act of 2012,Passed,227,6,0,7,138,37,0,18,0,0,0,0,365,43,0,25
609,R,112,H R 5997,27-Nov-2012,6:53 PM,"On Motion to Suspend the Rules and Pass, as Amended",Medical Preparedness Allowable Use Act,Passed,223,1,0,16,174,0,0,18,0,0,0,0,397,1,0,34
610,R,112,H R 915,27-Nov-2012,7:03 PM,On motion to Suspend the Rules and Concur in the Senate Amendment,Jamie Zapata Border Enforcement Security Task Force Act,Passed,222,3,0,15,175,1,0,16,0,0,0,0,397,4,0,31
611,R,112,H RES 821,29-Nov-2012,1:42 PM,On Agreeing to the Resolution,"Providing for consideration of H.R. 6429, STEM Jobs Act of 2012",Passed,233,0,0,7,10,170,0,12,0,0,0,0,243,170,0,19
612,R,112,H R 6429,30-Nov-2012,11:31 AM,On Motion to Recommit with Instructions,"To amend the Immigration and Nationality Act to promote innovation, investment, and research in the United States, to eliminate the diversity immigrant program, and for other purposes",Failed,0,226,0,14,157,5,0,30,0,0,0,0,157,231,0,44
613,R,112,H R 6429,30-Nov-2012,11:39 AM,On Passage,"To amend the Immigration and Nationality Act to promote innovation, investment, and research in the United States, to eliminate the diversity immigrant program, and for other purposes",Passed,218,5,0,17,27,134,0,31,0,0,0,0,245,139,0,48
614,R,112,H R 6582,4-Dec-2012,2:07 PM,"On Motion to Suspend the Rules and Pass, as Amended",American Energy Manufacturing Technical Corrections Act,Passed,218,2,1,19,180,0,0,11,0,0,0,0,398,2,1,30
615,R,112,JOURNAL,4-Dec-2012,2:14 PM,On Approving the Journal,None,Passed,164,53,1,22,126,53,1,11,0,0,0,0,290,106,2,33
616,R,112,ADJOURN,4-Dec-2012,2:31 PM,On Motion to Adjourn,None,Failed,1,217,0,22,2,176,0,13,0,0,0,0,3,393,0,35
617,R,112,S CON RES 50,5-Dec-2012,11:40 AM,On Motion to Suspend the Rules and Agree,Expressing the sense of Congress regarding actions to preserve and advance the multistakeholder governance model under which the Internet has thrived,Passed,218,0,0,22,179,0,0,12,0,0,0,0,397,0,0,34
618,R,112,H R 6602,5-Dec-2012,11:47 AM,On Motion to Suspend the Rules and Pass,"To make revisions in title 36, United States Code, as necessary to keep the title current and make technical corrections and improvements",Passed,216,0,0,24,176,0,0,15,0,0,0,0,392,0,0,39
619,R,112,S 2367,5-Dec-2012,11:55 AM,On Motion to Suspend the Rules and Pass,"To strike the word “lunatic” from Federal law, and for other purposes",Passed,217,1,0,22,181,0,0,10,0,0,0,0,398,1,0,32
620,R,112,JOURNAL,11-Dec-2012,6:48 PM,On Approving the Journal,None,Passed,162,50,2,26,110,52,1,28,0,0,0,0,272,102,3,54
621,R,112,H RES 827,12-Dec-2012,4:59 PM,On Ordering the Previous Question,Providing for consideration of motions to suspend the rules,Passed,224,0,0,16,0,183,0,8,0,0,0,0,224,183,0,24
622,R,112,H RES 827,12-Dec-2012,5:09 PM,On Agreeing to the Resolution,Providing for consideration of motions to suspend the rules,Passed,222,3,0,15,4,175,0,12,0,0,0,0,226,178,0,27
623,R,112,H R 6190,12-Dec-2012,5:16 PM,On Motion to Suspend the Rules and Pass,Asthma Inhalers Relief Act,Failed,198,29,0,13,31,153,0,7,0,0,0,0,229,182,0,20
624,R,112,H R 4310,13-Dec-2012,11:23 AM,On Motion to Instruct Conferees,National Defense Authorization Act for Fiscal Year 2013,Passed,218,4,0,18,181,0,0,10,0,0,0,0,399,4,0,28
625,R,112,H R 4310,13-Dec-2012,11:32 AM,On Motion to Permit Closed Conference Meetings,National Defense Authorization Act for Fiscal Year 2013,Passed,185,37,0,18,166,16,0,9,0,0,0,0,351,53,0,27
626,R,112,H R 4053,13-Dec-2012,11:42 AM,"On Motion to Suspend the Rules and Pass, as Amended","To intensify efforts to identify, prevent, and recover payment error, waste, fraud, and abuse within Federal spending",Passed,222,0,0,18,180,0,0,11,0,0,0,0,402,0,0,29
627,R,112,H R 4606,17-Dec-2012,6:57 PM,"On Motion to Suspend the Rules and Pass, as Amended","To authorize the issuance of right-of-way permits for natural gas pipelines in Glacier National Park, and for other purposes",Passed,177,0,0,63,109,10,0,72,0,0,0,0,286,10,0,135
628,R,112,S 3193,17-Dec-2012,7:08 PM,On Motion to Suspend the Rules and Pass,"To make technical corrections to the legal description of certain land to be held in trust for the Barona Band of Mission Indians, and for other purposes",Passed,178,0,0,62,128,0,0,63,0,0,0,0,306,0,0,125
629,R,112,H R 6504,18-Dec-2012,6:50 PM,On Motion to Suspend the Rules and Pass,Small Business Investment Company Modernization Act,Passed,187,36,1,16,172,0,0,19,0,0,0,0,359,36,1,35
630,R,112,H R 3783,18-Dec-2012,6:57 PM,On Motion to Suspend the Rules and Agree to the Senate Amendment,"An act to provide for a comprehensive strategy to counter Iran’s growing hostile presence and activity in the Western Hemisphere, and for other purposes",Passed,217,5,0,18,169,1,0,21,0,0,0,0,386,6,0,39
631,R,112,H R 6621,18-Dec-2012,7:09 PM,"On Motion to Suspend the Rules and Pass, as Amended","To correct and improve certain provisions of the Leahy-Smith America Invents Act and title 35, United States Code",Passed,157,70,0,13,151,19,0,21,0,0,0,0,308,89,0,34
632,R,112,S 3642,18-Dec-2012,7:16 PM,On Motion to Suspend the Rules and Pass,Theft of Trade Secrets Clarification Act,Passed,221,4,0,15,167,0,0,24,0,0,0,0,388,4,0,39
633,R,112,H R 6672,19-Dec-2012,2:21 PM,On Motion to Suspend the Rules and Pass,"To reauthorize certain programs under the Public Health Service Act and the Federal Food, Drug, and Cosmetic Act with respect to public health security and all-hazards preparedness and response, and for other purposes",Passed,205,16,0,19,178,0,0,13,0,0,0,0,383,16,0,32
634,R,112,H R 1845,19-Dec-2012,2:28 PM,"On Motion to Suspend the Rules and Pass, as Amended",To provide for a study on issues relating to access to intravenous immune globulin (IVIG) for Medicare beneficiaries in all care settings and a demonstration project to examine the benefits of providing coverage and payment for items and services necessary to administer IVIG in the home,Passed,223,3,0,14,178,0,0,13,0,0,0,0,401,3,0,27
635,R,112,H RES 668,19-Dec-2012,2:36 PM,"On Motion to Suspend the Rules and Agree, as Amended","To refer H.R. 5862, a bill making congressional reference to the United States Court of Federal Claims pursuant to sections 1492 and 2509 of title 28, United States Code, the Indian trust-related claims of the Quapaw Tribe of Oklahoma (O-Gah-Pah) as well as its individual members",Passed,222,4,0,14,176,1,0,14,0,0,0,0,398,5,0,28
636,R,112,H R 6655,19-Dec-2012,4:59 PM,On Motion to Suspend the Rules and Pass,Protect our Kids Act,Passed,151,77,0,12,179,0,0,12,0,0,0,0,330,77,0,24
637,R,112,S 3564,19-Dec-2012,5:06 PM,On Motion to Suspend the Rules and Pass,Public Interest Declassification Board Reauthorization Act,Passed,227,1,0,12,182,0,0,9,0,0,0,0,409,1,0,21
638,R,112,H R 6016,19-Dec-2012,5:13 PM,"On Motion to Suspend the Rules and Pass, as Amended",Government Employee Accountability Act,Passed,224,0,0,16,178,2,0,11,0,0,0,0,402,2,0,27
639,R,112,H RES 841,20-Dec-2012,2:57 PM,On Ordering the Previous Question,"Providing for consideration of the Senate amendment to H.J. Res. 66, approving the renewal of impact restrictions contained in the Burmese Freedom and Democracy Act of 2003; and providing for consideration of H.R. 6684, Spending Reduction Act of 2012",Passed,233,1,0,6,0,183,0,8,0,0,0,0,233,184,0,14
640,R,112,H RES 841,20-Dec-2012,3:05 PM,On Agreeing to the Resolution,"Providing for consideration of the Senate amendment to H.J. Res. 66, approving the renewal of impact restrictions contained in the Burmese Freedom and Democracy Act of 2003; and providing for consideration of H.R. 6684, Spending Reduction Act of 2012",Passed,219,13,0,8,0,184,0,7,0,0,0,0,219,197,0,15
641,R,112,H RES 840,20-Dec-2012,3:12 PM,On Ordering the Previous Question,"Providing for consideration of the conference report to accompany H.R. 4310, National Defense Authorization Act for Fiscal Year 2013",Passed,233,1,0,6,0,185,0,6,0,0,0,0,233,186,0,12
642,R,112,H RES 840,20-Dec-2012,3:18 PM,On Agreeing to the Resolution,"Providing for consideration of the conference report to accompany H.R. 4310, National Defense Authorization Act for Fiscal Year 2013",Passed,232,2,0,6,11,175,0,5,0,0,0,0,243,177,0,11
643,R,112,H R 6684,20-Dec-2012,6:28 PM,On Motion to Recommit with Instructions,Spending Reduction Act of 2012,Failed,1,234,0,5,178,9,0,4,0,0,0,0,179,243,0,9
644,R,112,H R 6684,20-Dec-2012,6:36 PM,On Passage,Spending Reduction Act of 2012,Passed,215,21,1,3,0,188,0,3,0,0,0,0,215,209,1,6
645,R,112,H R 4310,20-Dec-2012,6:43 PM,On Agreeing to the Conference Report,National Defense Authorization Act for Fiscal Year 2013,Passed,205,30,0,5,110,77,0,4,0,0,0,0,315,107,0,9
646,R,112,H R 3197,20-Dec-2012,6:50 PM,On Motion to Suspend the Rules and Pass,"To name the Department of Veterans Affairs medical center in Spokane, Washington as the “Mann-Grandstaff Department of Veteran’s Affairs Medical Center”",Passed,234,1,0,5,187,0,0,4,0,0,0,0,421,1,0,9
647,R,112,H R 6443,20-Dec-2012,6:57 PM,On Motion to Suspend the Rules and Pass,"To designate the facility of the Department of Veterans Affairs located at 9800 West Commercial Boulevard in Sunrise, Florida as the “William ’Bill’ Kling VA Clinic”",Passed,236,0,0,4,186,0,0,5,0,0,0,0,422,0,0,9
648,R,112,S 925,20-Dec-2012,7:03 PM,On Motion to Suspend the Rules and Pass,Mt. Andrea Lawrence Designation Act,Passed,228,6,0,6,180,1,0,10,0,0,0,0,408,7,0,16
649,R,112,H R 3159,30-Dec-2012,6:54 PM,"On Motion to Suspend the Rules and Pass, as Amended",Foreign Aid Transparency and Accountability Act,Passed,221,0,0,19,169,0,0,22,0,0,0,0,390,0,0,41
650,R,112,H R 4057,30-Dec-2012,7:01 PM,On Motion to Suspend the Rules and Concur in the Senate Amendment,"To amend title 38, United States Code, to direct the Secretary of Veterans Affairs to develop a comprehensive policy to improve outreach and transparency to veterans and members of the Armed Forces through the provision of information on institutions of higher learning",Passed,220,3,0,17,172,0,0,19,0,0,0,0,392,3,0,36
651,R,112,S 3202,30-Dec-2012,7:10 PM,On Motion to Suspend the Rules and Pass,Dignified Burial and Other Veterans’ Benefits Improvement Act,Passed,220,0,0,20,173,0,0,18,0,0,0,0,393,0,0,38
652,R,112,S 3454,31-Dec-2012,6:05 PM,On Motion to Suspend the Rules and Pass,Intelligence Authorization Act for Fiscal Year 2013,Passed,222,5,0,13,151,24,0,16,0,0,0,0,373,29,0,29
653,R,112,H R 6612,31-Dec-2012,6:12 PM,On Motion to Suspend the Rules and Pass,To redesignate the Dryden Flight Research Center as the Neil A. Armstrong Flight Research Center and the Western Aeronautical Test Range as the Hugh L. Dryden Aeronautical Test Range,Passed,227,0,0,13,177,0,0,14,0,0,0,0,404,0,0,27
654,R,112,H R 6364,31-Dec-2012,6:22 PM,On Motion to Suspend the Rules and Concur in the Senate Amendment,World War I Centennial Commission Act,Passed,223,5,0,12,178,0,0,13,0,0,0,0,401,5,0,25
655,R,112,H R 6726,1-Jan-2013,6:54 PM,On Motion to Suspend the Rules and Pass,To prevent the 2013 pay adjustment for Members of Congress and persons holding other offices or positions in the Federal Government from being made,Passed,232,2,0,6,55,127,0,9,0,0,0,0,287,129,0,15
656,R,112,H R 443,1-Jan-2013,7:02 PM,On Motion to Suspend the Rules and Concur in the Senate Amendment,"An Act to provide for the conveyance of certain property from the United States to the Maniilaq Association located in Kotzebue, Alaska",Passed,229,3,0,8,181,2,0,8,0,0,0,0,410,5,0,16
657,R,112,H R 4212,1-Jan-2013,7:10 PM,On Motion to Suspend the Rules and Concur in the Senate Amendment,Drywall Safety Act,Passed,195,37,0,8,183,0,0,8,0,0,0,0,378,37,0,16
658,R,112,H RES 844,1-Jan-2013,9:39 PM,On Agreeing to the Resolution,"Providing for consideration of the Senate amendments to the bill (H.R. 8) to extend certain tax relief provisions enacted in 2001 and 2003, and to provide for expedited consideration of a bill providing for comprehensive tax reform, and for other purposes",Passed,232,2,0,7,176,8,0,7,0,0,0,0,408,10,0,14
659,R,112,H R 8,1-Jan-2013,10:57 PM,On Motion to Concur in the Senate Amendments,"To extend certain tax relief provisions enacted in 2001 and 2003, and to provide for expedited consideration of a bill providing for comprehensive tax reform, and for other purposes",Passed,85,151,0,5,172,16,0,3,0,0,0,0,257,167,0,8
