Roll Call,Majority,Congress Num,Legislation Number,Date,Time,Question,Description,Result,Republican Yes,Republican No,Republican Present,Republican Not Voting,Democrat Yes,Democrat No,Democrat Present,Democrat Not Voting,Independent Yes,Independent No,Independent Present,Independent Not Voting,Total Yes,Total No,Total Present,Total Not Voting
1,R,113,QUORUM,3-Jan-2013,12:24 PM,Call of the House,None,Passed,0,0,233,0,0,0,196,4,0,0,0,0,0,0,429,4
2
3,R,113,H RES 5,3-Jan-2013,2:57 PM,On Motion to Table the Motion to Refer,Adopting rules for the One Hundred Thirteenth Congress,Passed,224,0,0,8,0,187,0,10,0,0,0,0,224,187,0,18
4,R,113,H RES 5,3-Jan-2013,4:21 PM,On Ordering the Previous Question,Adopting rules for the One Hundred Thirteenth Congress,Passed,227,1,0,4,0,190,0,7,0,0,0,0,227,191,0,11
5,R,113,H RES 5,3-Jan-2013,4:39 PM,On Motion to Commit,Adopting rules for the One Hundred Thirteenth Congress,Failed,1,229,0,2,193,0,0,4,0,0,0,0,194,229,0,6
6,R,113,H RES 5,3-Jan-2013,4:56 PM,On Agreeing to the Resolution,Adopting rules for the One Hundred Thirteenth Congress,Passed,228,1,0,3,0,195,0,2,0,0,0,0,228,196,0,5
7,R,113,H R 41,4-Jan-2013,11:22 AM,On Motion to Suspend the Rules and Pass,To temporarily increase the borrowing authority of the Federal Emergency Management Agency for carrying out the National Flood Insurance Program,Passed,161,67,0,4,193,0,0,4,0,0,0,0,354,67,0,8
8,R,113,H R 219,14-Jan-2013,6:51 PM,On Motion to Suspend the Rules and Pass,"To improve and streamline disaster assistance for Hurricane Sandy, and for other purposes",Passed,222,0,0,10,181,0,0,16,0,0,0,0,403,0,0,26
9,R,113,JOURNAL,14-Jan-2013,7:00 PM,On Approving the Journal,None,Passed,166,53,1,12,134,42,1,20,0,0,0,0,300,95,2,32
10,R,113,ADJOURN,14-Jan-2013,7:18 PM,On Motion to Adjourn,None,Failed,1,221,0,10,3,176,0,21,0,0,0,0,4,397,0,31
11,R,113,H RES 23,15-Jan-2013,1:59 PM,On Ordering the Previous Question,"Providing for consideration of the bill (H.R. 152) making supplemental appropriations for the fiscal year ending September 30, 2013, and for other purposes",Passed,228,0,0,4,65,127,0,8,0,0,0,0,293,127,0,12
12,R,113,H RES 23,15-Jan-2013,2:08 PM,On Agreeing to the Resolution,"Providing for consideration of the bill (H.R. 152) making supplemental appropriations for the fiscal year ending September 30, 2013, and for other purposes",Passed,225,1,0,6,142,51,0,7,0,0,0,0,367,52,0,13
13,R,113,ADJOURN,15-Jan-2013,2:24 PM,On Motion to Adjourn,None,Failed,0,229,0,3,0,190,0,10,0,0,0,0,0,419,0,13
14,R,113,H R 152,15-Jan-2013,4:10 PM,On Agreeing to the Amendment,None,Failed,157,71,0,4,5,187,0,8,0,0,0,0,162,258,0,12
15,R,113,H R 152,15-Jan-2013,4:18 PM,On Agreeing to the Amendment,None,Agreed to,135,91,0,6,192,0,0,8,0,0,0,0,327,91,0,14
16,R,113,H R 152,15-Jan-2013,6:39 PM,On Agreeing to the Amendment,None,Agreed to,214,14,0,4,7,183,0,10,0,0,0,0,221,197,0,14
17,R,113,H R 152,15-Jan-2013,6:43 PM,On Agreeing to the Amendment,None,Failed,203,25,0,4,3,189,0,8,0,0,0,0,206,214,0,12
18,R,113,H R 152,15-Jan-2013,6:47 PM,On Agreeing to the Amendment,None,Failed,201,26,0,5,1,191,0,8,0,0,0,0,202,217,0,13
19,R,113,H R 152,15-Jan-2013,6:51 PM,On Agreeing to the Amendment,None,Agreed to,213,15,0,4,3,190,0,7,0,0,0,0,216,205,0,11
20,R,113,H R 152,15-Jan-2013,6:55 PM,On Agreeing to the Amendment,None,Failed,202,26,0,4,6,186,0,8,0,0,0,0,208,212,0,12
21,R,113,H R 152,15-Jan-2013,7:00 PM,On Agreeing to the Amendment,None,Agreed to,219,9,0,4,4,189,0,7,0,0,0,0,223,198,0,11
22,R,113,H R 152,15-Jan-2013,7:07 PM,On Agreeing to the Amendment,None,Agreed to,38,190,0,4,190,2,0,8,0,0,0,0,228,192,0,12
23,R,113,H R 152,15-Jan-2013,7:25 PM,On Passage,"Making supplemental appropriations for the fiscal year ending September 30, 2013, and for other purposes",Passed,49,179,0,4,192,1,0,7,0,0,0,0,241,180,0,11
24,R,113,H R 307,22-Jan-2013,2:27 PM,On Motion to Suspend the Rules and Pass,"To reauthorize certain programs under the Public Health Service Act and the Federal Food, Drug, and Cosmetic Act with respect to public health security and all-hazards preparedness and response, and for other purposes",Passed,199,29,0,4,196,0,0,4,0,0,0,0,395,29,0,8
25,R,113,ADJOURN,22-Jan-2013,2:45 PM,On Motion to Adjourn,None,Failed,0,229,0,3,0,187,1,12,0,0,0,0,0,416,1,15
26,R,113,H RES 39,23-Jan-2013,10:50 AM,On Ordering the Previous Question,"Providing for consideration of the bill (H.R. 325) to ensure the complete and timely payment of the obligations of the United States Government until May 19, 2013, and for other purposes",Passed,229,0,0,2,3,193,0,4,0,0,0,0,232,193,0,6
27,R,113,H RES 39,23-Jan-2013,10:59 AM,On Agreeing to the Resolution,"Providing for consideration of the bill (H.R. 325) to ensure the complete and timely payment of the obligations of the United States Government until May 19, 2013, and for other purposes",Passed,228,1,0,2,6,189,0,5,0,0,0,0,234,190,0,7
28,R,113,JOURNAL,23-Jan-2013,11:07 AM,On Approving the Journal,None,Passed,171,56,1,3,120,73,1,6,0,0,0,0,291,129,2,9
29,R,113,H R 325,23-Jan-2013,1:10 PM,On Motion to Recommit with Instructions,"To ensure the complete and timely payment of the obligations of the United States Government until May 19, 2013, and for other purposes",Failed,1,230,0,0,150,47,0,3,0,0,0,0,151,277,0,3
30,R,113,H R 325,23-Jan-2013,1:20 PM,On Passage,"To ensure the complete and timely payment of the obligations of the United States Government until May 19, 2013, and for other purposes",Passed,199,33,0,0,86,111,0,3,0,0,0,0,285,144,0,3
31,R,113,H R 225,4-Feb-2013,6:53 PM,On Motion to Suspend the Rules and Pass,"To amend title IV of the Public Health Service Act to provide for a National Pediatric Research Network, including with respect to pediatric rare diseases or conditions",Passed,193,27,0,11,182,0,0,18,0,0,0,0,375,27,0,29
32,R,113,H R 297,4-Feb-2013,7:02 PM,On Motion to Suspend the Rules and Pass,To amend the Public Health Service Act to reauthorize support for graduate medical education programs in children’s hospitals,Passed,171,49,0,11,181,1,0,18,0,0,0,0,352,50,0,29
33,R,113,H RES 48,5-Feb-2013,2:30 PM,On Ordering the Previous Question,"Providing for consideration of the bill (H.R. 444) to require that, if the President’s fiscal year 2014 budget does not achieve balance in a fiscal year covered by such budget, the President shall submit a supplemental unified budget by April 1, 2013, which identifies a fiscal year in which balance is achieved",Passed,225,0,0,6,4,188,0,8,0,0,0,0,229,188,0,14
34,R,113,H RES 48,5-Feb-2013,2:40 PM,On Agreeing to the Resolution,"Providing for consideration of the bill (H.R. 444) to require that, if the President’s fiscal year 2014 budget does not achieve balance in a fiscal year covered by such budget, the President shall submit a supplemental unified budget by April 1, 2013, which identifies a fiscal year in which balance is achieved",Passed,225,0,0,6,3,189,0,8,0,0,0,0,228,189,0,14
35,R,113,H R 444,6-Feb-2013,11:22 AM,On Agreeing to the Amendment,None,Failed,1,226,0,4,193,2,0,5,0,0,0,0,194,228,0,9
36,R,113,H R 444,6-Feb-2013,11:27 AM,On Agreeing to the Amendment,None,Failed,21,207,0,3,54,141,0,5,0,0,0,0,75,348,0,8
37,R,113,H R 444,6-Feb-2013,11:52 AM,On Motion to Recommit with Instructions,"To require that, if the President’s fiscal year 2014 budget does not achieve balance in a fiscal year covered by such budget, the President shall submit a supplemental unified budget by April 1, 2013, which identifies a fiscal year in which balance is achieved, and for other purposes",Failed,0,228,0,3,194,1,0,5,0,0,0,0,194,229,0,8
38,R,113,H R 444,6-Feb-2013,11:58 AM,On Passage,"To require that, if the President’s fiscal year 2014 budget does not achieve balance in a fiscal year covered by such budget, the President shall submit a supplemental unified budget by April 1, 2013, which identifies a fiscal year in which balance is achieved, and for other purposes",Passed,227,1,0,3,26,166,0,8,0,0,0,0,253,167,0,11
39,R,113,H R 592,13-Feb-2013,1:34 PM,On Motion to Suspend the Rules and Pass,"To amend the Robert T. Stafford Disaster Relief and Emergency Assistance Act to clarify that houses of worship are eligible for certain disaster relief and emergency assistance on terms equal to other eligible private nonprofit facilities, and for other purposes",Passed,224,6,0,1,130,66,0,4,0,0,0,0,354,72,0,5
40,R,113,H R 267,13-Feb-2013,1:48 PM,On Motion to Suspend the Rules and Pass,Hydropower Regulatory Efficiency Act of 2013,Passed,228,0,0,3,194,0,0,6,0,0,0,0,422,0,0,9
41,R,113,H RES 66,14-Feb-2013,3:22 PM,On Ordering the Previous Question,"Providing for consideration of the bill (H.R. 273) to eliminate the 2013 statutory pay adjustment for Federal employees, and for other purposes",Passed,227,0,0,4,2,194,0,4,0,0,0,0,229,194,0,8
42,R,113,H RES 66,14-Feb-2013,3:29 PM,On Agreeing to the Resolution,"Providing for consideration of the bill (H.R. 273) to eliminate the 2013 statutory pay adjustment for Federal employees, and for other purposes",Passed,225,1,0,5,2,191,0,7,0,0,0,0,227,192,0,12
43,R,113,H CON RES 15,15-Feb-2013,11:07 AM,On Agreeing to the Resolution,Providing for the conditional adjournment of the House and Senate,Passed,222,4,0,5,0,186,0,14,0,0,0,0,222,190,0,19
44,R,113,H R 273,15-Feb-2013,11:18 AM,On Passage,To eliminate the 2013 statutory pay adjustment for Federal employees,Passed,218,10,0,3,43,144,0,13,0,0,0,0,261,154,0,16
45,R,113,H RES 65,15-Feb-2013,11:26 AM,"On Motion to Suspend the Rules and Agree, as Amended","Condemning the Government of North Korea for its flagrant and repeated violations of multiple United Nations Security Council resolutions, for its repeated provocations that threaten international peace and stabilitiy, and for its February 12, 2013, test of a nuclear device",Passed,225,2,0,4,187,0,0,13,0,0,0,0,412,2,0,17
46,R,113,JOURNAL,25-Feb-2013,6:52 PM,On Approving the Journal,None,Passed,168,45,0,18,135,46,1,18,0,0,0,0,303,91,1,36
47,R,113,H R 667,25-Feb-2013,7:00 PM,On Motion to Suspend the Rules and Pass,To redesignate the Dryden Flight Research Center as the Neil A. Armstrong Flight Research Center and the Western Aeronautical Test Range as the Hugh L. Dryden Aeronautical Test Range,Passed,213,0,0,18,181,0,1,18,0,0,0,0,394,0,1,36
48,R,113,ADJOURN,26-Feb-2013,3:24 PM,On Motion to Adjourn,None,Failed,1,221,0,9,0,194,0,6,0,0,0,0,1,415,0,15
49,R,113,H RES 77,26-Feb-2013,3:38 PM,On Motion to Suspend the Rules and Agree,Academic Competition Resolution of 2013,Passed,216,3,0,12,195,0,0,5,0,0,0,0,411,3,0,17
50,R,113,JOURNAL,26-Feb-2013,3:45 PM,On Approving the Journal,None,Passed,161,55,0,15,129,63,1,7,0,0,0,0,290,118,1,22
51,R,113,H RES 83,27-Feb-2013,3:43 PM,On Ordering the Previous Question,"Providing for consideration of S. 47, the Violence Against Women Reauthorization Act of 2013",Passed,227,0,0,4,2,196,0,2,0,0,0,0,229,196,0,6
52,R,113,H RES 83,27-Feb-2013,3:50 PM,On Agreeing to the Resolution,"Providing for consideration of S. 47, the Violence Against Women Reauthorization Act of 2013",Passed,214,9,0,8,200,0,0,0,0,0,0,0,414,9,0,8
53,R,113,JOURNAL,27-Feb-2013,3:58 PM,On Approving the Journal,None,Passed,156,63,0,12,137,56,1,6,0,0,0,0,293,119,1,18
54,R,113,S 47,28-Feb-2013,11:39 AM,On Agreeing to the Amendment,None,Failed,164,60,0,7,2,197,0,1,0,0,0,0,166,257,0,8
55,R,113,S 47,28-Feb-2013,11:56 AM,On Passage,Violence Against Women Reauthorization Act of 2013,Passed,87,138,0,6,199,0,0,1,0,0,0,0,286,138,0,7
56,R,113,H R 307,4-Mar-2013,6:53 PM,On Motion to Suspend the Rules and Concur in the Senate Amendment,Pandemic and All-Hazards Preparedness Reauthorization Act of 2013,Passed,192,28,0,11,178,0,0,22,0,0,0,0,370,28,0,33
57,R,113,H R 668,5-Mar-2013,2:28 PM,On Motion to Suspend the Rules and Pass,"To amend section 1105(a) of title 31, United States Code, to require that annual budget submissions of the President to Congress provide an estimate of the cost per taxpayer of the deficit, and for other purposes",Passed,229,0,0,2,163,28,1,8,0,0,0,0,392,28,1,10
58,R,113,H R 338,5-Mar-2013,2:36 PM,On Motion to Suspend the Rules and Pass,Stop Tobacco Smuggling in the Territories Act of 2013,Passed,224,5,0,2,197,0,0,3,0,0,0,0,421,5,0,5
59,R,113,H RES 99,6-Mar-2013,11:48 AM,On Ordering the Previous Question,"Providing for consideration of the bill (H.R. 933) making appropriations for the Department of Defense, the Department of Veterans Affairs, and other departments and agencies for the fiscal year ending September 30, 2013, and for other purposes",Passed,225,1,0,5,2,187,0,11,0,0,0,0,227,188,0,16
60,R,113,H RES 99,6-Mar-2013,11:57 AM,On Agreeing to the Resolution,"Providing for consideration of the bill (H.R. 933) making appropriations for the Department of Defense, the Department of Veterans Affairs, and other departments and agencies for the fiscal year ending September 30, 2013, and for other purposes",Passed,210,16,0,5,2,181,0,17,0,0,0,0,212,197,0,22
61,R,113,H R 933,6-Mar-2013,1:54 PM,On Motion to Recommit with Instructions,"Department of Defense, Military Construction and Veterans Affairs, and Full-Year Continuing Appropriations Act, 2013",Failed,0,228,0,3,188,3,0,9,0,0,0,0,188,231,0,12
62,R,113,H R 933,6-Mar-2013,2:03 PM,On Passage,"Department of Defense, Military Construction and Veterans Affairs, and Full-Year Continuing Appropriations Act, 2013",Passed,214,14,0,3,53,137,0,10,0,0,0,0,267,151,0,13
63,R,113,H R 1035,12-Mar-2013,6:56 PM,On Motion to Suspend the Rules and Pass,"To require a study of voluntary community-based flood insurance options and how such options could be incorporated into the national flood insurance programs, and for other purposes",Passed,208,17,0,6,189,0,0,11,0,0,0,0,397,17,0,17
64,R,113,H RES 107,13-Mar-2013,3:27 PM,On Ordering the Previous Question,"Providing for consideration of the bill (H.R. 890) to prohibit waivers relating to compliance with the work requirements for the program of block grants to States for temporary assistance for needy families, and for other purposes",Passed,231,0,0,0,2,195,0,3,0,0,0,0,233,195,0,3
65,R,113,H RES 107,13-Mar-2013,3:35 PM,On Agreeing to the Resolution,"Providing for consideration of the bill (H.R. 890) to prohibit waivers relating to compliance with the work requirements for the program of block grants to States for temporary assistance for needy families, and for other purposes",Passed,229,0,0,2,4,194,0,2,0,0,0,0,233,194,0,4
66,R,113,JOURNAL,13-Mar-2013,3:42 PM,On Approving the Journal,None,Passed,162,61,0,8,133,59,1,7,0,0,0,0,295,120,1,15
67,R,113,H R 890,13-Mar-2013,5:35 PM,On Motion to Recommit with Instructions,"To prohibit waivers relating to compliance with the work requirements for the program of block grants to States for temporary assistance for needy families, and for other purposes",Failed,1,230,0,0,198,0,0,2,0,0,0,0,199,230,0,2
68,R,113,H R 890,13-Mar-2013,5:42 PM,On Passage,"To prohibit waivers relating to compliance with the work requirements for the program of block grants to States for temporary assistance for needy families, and for other purposes",Passed,228,3,0,0,18,178,0,4,0,0,0,0,246,181,0,4
69,R,113,ADJOURN,13-Mar-2013,5:59 PM,On Motion to Adjourn,None,Failed,0,228,0,3,1,193,0,6,0,0,0,0,1,421,0,9
70,R,113,H RES 113,14-Mar-2013,5:12 PM,On Ordering the Previous Question,"Providing for consideration of H.R. 803, the Supporting Knowledge and Investing in Lifelong Skills Act",Passed,224,0,0,7,1,191,0,8,0,0,0,0,225,191,0,15
71,R,113,H RES 113,14-Mar-2013,5:19 PM,On Agreeing to the Resolution,"Providing for consideration of H.R. 803, the Supporting Knowledge and Investing in Lifelong Skills Act",Passed,225,0,0,6,1,191,0,8,0,0,0,0,226,191,0,14
72,R,113,JOURNAL,14-Mar-2013,5:26 PM,On Approving the Journal,None,Passed,165,57,0,9,124,68,1,7,0,0,0,0,289,125,1,16
73,R,113,H R 803,15-Mar-2013,11:53 AM,On Agreeing to the Amendment,None,Failed,1,227,0,3,191,0,0,9,0,0,0,0,192,227,0,12
74,R,113,H R 803,15-Mar-2013,12:16 PM,On Motion to Recommit with Instructions,Supporting Knowledge and Investing in Lifelong Skills Act,Failed,0,227,0,4,184,6,0,10,0,0,0,0,184,233,0,14
75,R,113,H R 803,15-Mar-2013,12:24 PM,On Passage,Supporting Knowledge and Investing in Lifelong Skills Act,Passed,213,14,0,5,2,188,0,10,0,0,0,0,215,202,0,15
76,R,113,JOURNAL,18-Mar-2013,6:55 PM,On Approving the Journal,None,Passed,155,62,0,14,129,41,1,29,0,0,0,0,284,103,1,43
77,R,113,H CON RES 18,18-Mar-2013,7:02 PM,On Motion to Suspend the Rules and Agree,Authorizing the use of the Capitol Grounds for the National Peace Officers’ Memorial Service,Passed,219,0,0,12,169,0,0,31,0,0,0,0,388,0,0,43
78,R,113,H CON RES 19,18-Mar-2013,7:10 PM,On Motion to Suspend the Rules and Agree,Authorizing the use of the Capitol Grounds for the Greater Washington Soap Box Derby,Passed,216,0,0,15,170,0,0,30,0,0,0,0,386,0,0,45
79,R,113,H RES 122,19-Mar-2013,2:44 PM,On Ordering the Previous Question,"Providing for consideration of the concurrent resolution (H. Con. Res. 25) Congressional Budget, 2014; providing for consideration of the resolution (H. Res. 115) providing for the expenses of certain committees of the House Representatives in the One Hundred Thirteenth Congress; and for other purposes",Passed,223,0,0,8,0,189,0,11,0,0,0,0,223,189,0,19
80,R,113,H RES 122,19-Mar-2013,2:53 PM,On Agreeing to the Resolution,"Providing for consideration of the concurrent resolution (H. Con. Res. 25) Congressional Budget, 2014; providing for consideration of the resolution (H. Res. 115) providing for the expenses of certain committees of the House Representatives in the One Hundred Thirteenth Congress; and for other purposes",Passed,224,0,0,7,0,189,0,11,0,0,0,0,224,189,0,18
81,R,113,JOURNAL,19-Mar-2013,3:01 PM,On Approving the Journal,None,Passed,155,66,0,10,117,67,1,15,0,0,0,0,272,133,1,25
82,R,113,H RES 115,19-Mar-2013,4:13 PM,On Agreeing to the Resolution,Providing for the expenses of certain committees of the House of Representatives in the One Hundred Thirteenth Congress,Passed,211,10,0,10,61,126,0,13,0,0,0,0,272,136,0,23
83,R,113,H CON RES 25,20-Mar-2013,2:46 PM,On Agreeing to the Amendment,None,Failed,0,226,0,5,154,35,0,11,0,0,0,0,154,261,0,16
84,R,113,H CON RES 25,20-Mar-2013,2:56 PM,On Agreeing to the Amendment,None,Failed,0,225,0,6,105,80,1,14,0,0,0,0,105,305,1,20
85,R,113,H CON RES 25,20-Mar-2013,3:03 PM,On Agreeing to the Amendment,None,Failed,0,225,0,6,84,102,1,13,0,0,0,0,84,327,1,19
86,R,113,H CON RES 25,20-Mar-2013,4:06 PM,On Agreeing to the Amendment,None,Failed,104,118,0,9,0,14,171,15,0,0,0,0,104,132,171,24
87,R,113,H CON RES 25,20-Mar-2013,5:18 PM,On Agreeing to the Amendment,None,Failed,0,225,0,6,165,28,0,7,0,0,0,0,165,253,0,13
88,R,113,H CON RES 25,21-Mar-2013,10:44 AM,On Agreeing to the Concurrent Resolution,Establishing the budget for the United States Government for fiscal year 2014 and setting forth appropriate budgetary levels for fiscal years 2015 through 2023,Passed,221,10,0,1,0,197,0,3,0,0,0,0,221,207,0,4
89,R,113,H R 933,21-Mar-2013,10:54 AM,On Motion to Concur in the Senate Amendments,"Department of Defense, Military Construction and Veterans Affairs, and Full-Year Continuing Appropriations Act, 2013",Passed,203,27,0,1,115,82,0,3,0,0,0,0,318,109,0,4
90,R,113,H R 254,9-Apr-2013,6:56 PM,On Motion to Suspend the Rules and Pass,To authorize the Secretary of the Interior to facilitate the development of hydroelectric power on the Diamond Fork System of the Central Utah Project,Passed,219,1,0,11,181,3,0,16,0,0,0,0,400,4,0,27
91,R,113,H R 1033,9-Apr-2013,7:07 PM,On Motion to Suspend the Rules and Pass,To authorize the acquisition and protection of nationally significant battlefields and associated sites of the Revolutionary War and the War of 1812 under the American Battlefield Protection Program,Passed,101,122,0,8,182,0,0,18,0,0,0,0,283,122,0,26
92,R,113,JOURNAL,9-Apr-2013,7:16 PM,On Approving the Journal,None,Passed,155,64,0,12,139,40,1,20,0,0,0,0,294,104,1,32
93,R,113,H RES 140,10-Apr-2013,1:34 PM,On Ordering the Previous Question,"Providing for consideration of H.R. 678, Bureau of Reclamation Small Conduit Hydropower Development and Rural Jobs Act",Passed,230,0,0,1,6,190,0,4,0,0,0,0,236,190,0,5
94,R,113,H R 678,10-Apr-2013,3:14 PM,On Agreeing to the Amendment,None,Failed,0,227,0,4,189,5,0,6,0,0,0,0,189,232,0,10
95,R,113,H R 678,10-Apr-2013,3:36 PM,On Motion to Recommit with Instructions,"To authorize all Bureau of Reclamation conduit facilities for hydropower development under Federal Reclamation law, and for other purposes",Failed,2,224,0,5,192,2,0,6,0,0,0,0,194,226,0,11
96,R,113,H R 678,10-Apr-2013,3:46 PM,On Passage,"To authorize all Bureau of Reclamation conduit facilities for hydropower development under Federal Reclamation law, and for other purposes",Passed,228,0,0,3,188,7,0,5,0,0,0,0,416,7,0,8
97,R,113,H RES 146,11-Apr-2013,1:51 PM,On Ordering the Previous Question,Providing for consideration of the bill (H.R. 1120) Preventing Greater Uncertainty in Labor-Management Relations Act,Passed,226,0,0,5,0,192,0,8,0,0,0,0,226,192,0,13
98,R,113,H RES 146,11-Apr-2013,2:08 PM,On Agreeing to the Resolution,Providing for consideration of the bill (H.R. 1120) Preventing Greater Uncertainty in Labor-Management Relations Act,Passed,226,0,0,5,0,194,0,7,0,0,0,0,226,194,0,12
99,R,113,JOURNAL,11-Apr-2013,2:16 PM,On Approving the Journal,None,Passed,148,73,0,10,124,63,1,13,0,0,0,0,272,136,1,23
100,R,113,H R 1120,12-Apr-2013,12:00 PM,On Motion to Recommit with Instructions,Preventing Greater Uncertainty in Labor-Management Relations Act,Failed,0,228,0,3,197,1,0,3,0,0,0,0,197,229,0,6
101,R,113,H R 1120,12-Apr-2013,12:10 PM,On Passage,Preventing Greater Uncertainty in Labor-Management Relations Act,Passed,219,10,0,2,0,199,0,2,0,0,0,0,219,209,0,4
102,R,113,JOURNAL,12-Apr-2013,12:17 PM,On Approving the Journal,None,Passed,151,64,0,16,126,67,1,7,0,0,0,0,277,131,1,23
103,R,113,H R 1162,15-Apr-2013,6:57 PM,"On Motion to Suspend the Rules and Pass, as Amended","To amend title 31, United States Code, to make improvements in the Government Accountability Office",Passed,222,0,0,9,186,0,0,15,0,0,0,0,408,0,0,24
104,R,113,H R 882,15-Apr-2013,7:08 PM,"On Motion to Suspend the Rules and Pass, as Amended","To prohibit the awarding of a contract or grant in excess of the simplified acquisition threshold unless the prospective contractor or grantee certifies in writing to the agency awarding the contract or grant that the contractor or grantee has no seriously delinquent tax debts, and for other purposes",Passed,220,0,0,11,187,0,0,14,0,0,0,0,407,0,0,25
105,R,113,H R 249,15-Apr-2013,7:16 PM,On Motion to Suspend the Rules and Pass,"To amend title 5, United States Code, to provide that persons having seriously delinquent tax debts shall be ineligible for Federal employment",Failed,215,7,0,9,35,152,0,14,0,0,0,0,250,159,0,23
106,R,113,H R 1163,16-Apr-2013,2:05 PM,On Motion to Suspend the Rules and Pass,Federal Information Security Amendments Act of 2013,Passed,222,0,0,9,194,0,0,7,0,0,0,0,416,0,0,16
107,R,113,H R 756,16-Apr-2013,2:13 PM,"On Motion to Suspend the Rules and Pass, as Amended",Cybersecurity Enhancement Act of 2013,Passed,207,16,0,8,195,0,0,6,0,0,0,0,402,16,0,14
108,R,113,H R 967,16-Apr-2013,2:20 PM,"On Motion to Suspend the Rules and Pass, as Amended",Advancing America’s Networking and Information Technology Research and Development Act of 2013,Passed,210,11,0,10,196,0,0,5,0,0,0,0,406,11,0,15
109,R,113,H RES 164,17-Apr-2013,2:18 PM,On Agreeing to the Resolution,"Providing for consideration of H.R. 624, the Cyber Intelligence Sharing and Protection Act",Passed,219,4,0,8,8,188,0,5,0,0,0,0,227,192,0,13
110,R,113,H R 624,17-Apr-2013,4:56 PM,On Agreeing to the Amendment,None,Agreed to,225,0,0,6,193,0,0,8,0,0,0,0,418,0,0,14
111,R,113,H R 624,17-Apr-2013,5:01 PM,On Agreeing to the Amendment,None,Agreed to,223,0,0,8,195,0,0,6,0,0,0,0,418,0,0,14
112,R,113,H R 624,17-Apr-2013,5:07 PM,On Agreeing to the Amendment,None,Agreed to,219,3,0,9,192,0,0,9,0,0,0,0,411,3,0,18
113,R,113,H R 624,18-Apr-2013,12:13 PM,On Agreeing to the Amendment,None,Agreed to,221,0,0,10,190,0,0,11,0,0,0,0,411,0,0,21
114,R,113,H R 624,18-Apr-2013,12:21 PM,On Agreeing to the Amendment,None,Agreed to,225,0,0,6,188,0,0,13,0,0,0,0,413,0,0,19
115,R,113,H R 624,18-Apr-2013,12:27 PM,On Agreeing to the Amendment,None,Agreed to,219,5,0,7,190,0,0,11,0,0,0,0,409,5,0,18
116,R,113,H R 624,18-Apr-2013,12:50 PM,On Motion to Recommit with Instructions,Cyber Intelligence Sharing and Protection Act,Failed,1,224,0,6,188,0,0,13,0,0,0,0,189,224,0,19
117,R,113,H R 624,18-Apr-2013,12:59 PM,On Passage,Cyber Intelligence Sharing and Protection Act,Passed,196,29,0,6,92,98,0,11,0,0,0,0,288,127,0,17
118,R,113,H R 1067,23-Apr-2013,7:00 PM,On Motion to Suspend the Rules and Pass,"To make revisions in title 36, United States Code, as necessary to keep the title current and make technical corrections and improvements",Passed,221,0,0,10,188,0,0,13,0,0,0,0,409,0,0,23
119,R,113,H R 1068,23-Apr-2013,7:08 PM,"On Motion to Suspend the Rules and Pass, as Amended","To enact title 54, United States Code, “National Park Service and Related Programs”, as positive law",Passed,221,0,0,10,188,0,0,13,0,0,0,0,409,0,0,23
120,R,113,JOURNAL,23-Apr-2013,7:16 PM,On Approving the Journal,None,Passed,153,67,0,11,132,51,1,17,0,0,0,0,285,118,1,28
121,R,113,H RES 175,24-Apr-2013,2:58 PM,On Ordering the Previous Question,"Providing for consideration of H.R. 1549, Helping Sick Americans Now Act",Passed,227,0,0,4,1,192,0,8,0,0,0,0,228,192,0,12
122,R,113,H RES 175,24-Apr-2013,3:05 PM,On Agreeing to the Resolution,"Providing for consideration of H.R. 1549, Helping Sick Americans Now Act",Passed,225,1,0,5,0,188,0,13,0,0,0,0,225,189,0,18
123,R,113,H R 360,24-Apr-2013,3:14 PM,"On Motion to Suspend the Rules and Pass, as Amended","To award posthumously a Congressional Gold Medal to Addie Mae Collins, Denise McNair, Carole Robertson, and Cynthia Wesley to commemorate the lives they lost 50 years ago in the bombing of the 16th Street Baptist Church, where these 4 Black girls’ ultimate sacrifice served as a catalyst for the Civil Rights Movement",Passed,227,0,0,4,193,0,0,8,0,0,0,0,420,0,0,12
124,R,113,H RES 178,25-Apr-2013,1:56 PM,On Agreeing to the Resolution,"Providing for consideration of the bill (H.R. 527) to amend the Helium Act to complete the privatization of the Federal helium reserve in a competitive market fashion that ensures stability in the helium markets while protecting the interests of American taxpayers, and for other purposes",Passed,216,0,0,15,15,177,0,9,0,0,0,0,231,177,0,24
125,R,113,H R 1765,26-Apr-2013,12:13 PM,On Motion to Suspend the Rules and Pass,Reducing Flight Delays Act,Passed,202,12,0,17,159,29,0,13,0,0,0,0,361,41,0,30
126,R,113,H R 527,26-Apr-2013,12:20 PM,On Agreeing to the Amendment,None,Failed,47,164,0,20,40,148,0,13,0,0,0,0,87,312,0,33
127,R,113,H R 527,26-Apr-2013,12:43 PM,On Motion to Recommit with Instructions,"To amend the Helium Act to complete the privatization of the Federal helium reserve in a competitive market fashion that ensures stability in the helium markets while protecting the interests of American taxpayers, and for other purposes",Failed,0,209,0,22,186,2,0,13,0,0,0,0,186,211,0,35
128,R,113,H R 527,26-Apr-2013,12:49 PM,On Passage,"To amend the Helium Act to complete the privatization of the Federal helium reserve in a competitive market fashion that ensures stability in the helium markets while protecting the interests of American taxpayers, and for other purposes",Passed,208,0,0,23,186,1,0,14,0,0,0,0,394,1,0,37
129,R,113,H R 588,6-May-2013,6:56 PM,On Motion to Suspend the Rules and Pass,Vietnam Veterans Donor Acknowledgment Act,Passed,213,2,0,16,185,0,0,16,0,0,0,0,398,2,0,32
130,R,113,H R 291,6-May-2013,7:05 PM,On Motion to Suspend the Rules and Pass,Black Hills Cemetery Act,Passed,212,2,0,17,178,0,0,23,0,0,0,0,390,2,0,40
131,R,113,H R 507,6-May-2013,7:12 PM,On Motion to Suspend the Rules and Pass,Pascua Yaqui Tribe Trust Land Act,Passed,216,2,0,13,185,0,0,16,0,0,0,0,401,2,0,29
132,R,113,H RES 198,7-May-2013,2:35 PM,On Ordering the Previous Question,"Providing for consideration of H.R. 1406, the Working Families Flexibility Act",Passed,229,0,0,2,1,198,0,2,0,0,0,0,230,198,0,4
133,R,113,H RES 198,7-May-2013,2:44 PM,On Agreeing to the Resolution,"Providing for consideration of H.R. 1406, the Working Families Flexibility Act",Passed,228,0,0,3,0,199,0,2,0,0,0,0,228,199,0,5
134,R,113,JOURNAL,7-May-2013,2:52 PM,On Approving the Journal,None,Passed,165,62,0,4,128,69,1,3,0,0,0,0,293,131,1,7
135,R,113,H R 1406,8-May-2013,5:28 PM,On Agreeing to the Amendment,None,Agreed to,221,5,0,5,163,37,0,1,0,0,0,0,384,42,0,6
136,R,113,H R 1406,8-May-2013,5:46 PM,On Motion to Recommit with Instructions,To amend the Fair Labor Standards Act of 1938 to provide compensatory time for employees in the private sector,Failed,1,227,0,3,199,0,0,2,0,0,0,0,200,227,0,5
137,R,113,H R 1406,8-May-2013,5:53 PM,On Passage,To amend the Fair Labor Standards Act of 1938 to provide compensatory time for employees in the private sector,Passed,220,8,0,3,3,196,0,2,0,0,0,0,223,204,0,5
138,R,113,H RES 202,8-May-2013,6:00 PM,On Ordering the Previous Question,Providing for consideration of the bill (H.R. 807) to require that the Government prioritize all obligations on the debt held by the public in the event that the debt limit is reached,Passed,227,0,0,4,0,199,0,2,0,0,0,0,227,199,0,6
139,R,113,H RES 202,8-May-2013,6:12 PM,On Agreeing to the Resolution,Providing for consideration of the bill (H.R. 807) to require that the Government prioritize all obligations on the debt held by the public in the event that the debt limit is reached,Passed,226,0,0,5,0,199,0,2,0,0,0,0,226,199,0,7
140,R,113,H R 807,9-May-2013,11:11 AM,On Agreeing to the Amendment,None,Agreed to,229,0,0,2,111,84,0,6,0,0,0,0,340,84,0,8
141,R,113,H R 807,9-May-2013,11:32 AM,On Motion to Recommit with Instructions,To require that the Government prioritize all obligations on the debt held by the public in the event that the debt limit is reached,Failed,2,227,0,2,198,0,0,3,0,0,0,0,200,227,0,5
142,R,113,H R 807,9-May-2013,11:39 AM,On Passage,To require that the Government prioritize all obligations on the debt held by the public in the event that the debt limit is reached,Passed,221,8,0,2,0,199,0,2,0,0,0,0,221,207,0,4
143,R,113,JOURNAL,9-May-2013,11:47 AM,On Approving the Journal,None,Passed,147,70,0,14,117,70,1,13,0,0,0,0,264,140,1,27
144,R,113,H R 180,14-May-2013,6:52 PM,"On Motion to Suspend the Rules and Pass, as Amended",National Blue Alert Act,Passed,222,2,0,7,184,0,0,17,0,0,0,0,406,2,0,24
145,R,113,H R 1580,14-May-2013,7:00 PM,On Motion to Suspend the Rules and Pass,To affirm the policy of the United States regarding Internet governance,Passed,223,0,0,8,190,0,0,11,0,0,0,0,413,0,0,19
146,R,113,S CON RES 10,14-May-2013,7:07 PM,On Motion to Suspend the Rules and Agree,Authorizing the use of Emancipation Hall in the Capitol Visitor Center for an event to celebrate the birthday of King Kamehameha,Passed,225,0,0,6,186,0,0,15,0,0,0,0,411,0,0,21
147,R,113,H R 767,15-May-2013,5:29 PM,"On Motion to Suspend the Rules and Pass, as Amended",To amend the Energy Policy Act of 2005 to modify the Pilot Project offices of the Federal Permit Streamlining Pilot Project,Passed,225,1,0,5,190,0,0,11,0,0,0,0,415,1,0,16
148,R,113,H R 701,15-May-2013,5:46 PM,"On Motion to Suspend the Rules and Pass, as Amended",To amend a provision of the Securities Act of 1933 directing the Securities and Exchange Commission to add a particular class of securities to those exempted under such Act to provide a deadline for such action,Passed,229,0,0,3,187,6,0,8,0,0,0,0,416,6,0,11
149,R,113,H R 384,15-May-2013,5:53 PM,"On Motion to Suspend the Rules and Pass, as Amended",Home for Heroes Act,Passed,227,3,0,2,193,0,0,8,0,0,0,0,420,3,0,10
150,R,113,H RES 215,16-May-2013,2:30 PM,On Ordering the Previous Question,Providing for consideration of the bill (H.R. 45) to repeal the Patient Protection and Affordable Care Act and health care-related provisions in the Health Care and Education Reconciliation Act of 2010,Passed,227,0,0,5,1,193,0,7,0,0,0,0,228,193,0,12
151,R,113,H RES 215,16-May-2013,2:40 PM,On Agreeing to the Resolution,Providing for consideration of the bill (H.R. 45) to repeal the Patient Protection and Affordable Care Act and health care-related provisions in the Health Care and Education Reconciliation Act of 2010,Passed,224,0,0,8,2,192,0,7,0,0,0,0,226,192,0,15
152,R,113,JOURNAL,16-May-2013,2:50 PM,On Approving the Journal,None,Passed,154,66,0,12,123,66,1,11,0,0,0,0,277,132,1,23
153,R,113,H R 45,16-May-2013,6:18 PM,On Motion to Recommit with Instructions,To repeal the Patient Protection and Affordable Care Act and health care-related provisions in the Health Care and Education Reconciliation Act of 2010,Failed,0,226,0,6,190,4,0,7,0,0,0,0,190,230,0,13
154,R,113,H R 45,16-May-2013,6:26 PM,On Passage,To repeal the Patient Protection and Affordable Care Act and health care-related provisions in the Health Care and Education Reconciliation Act of 2010,Passed,227,0,0,5,2,195,0,4,0,0,0,0,229,195,0,9
155,R,113,H RES 216,17-May-2013,10:47 AM,On Ordering the Previous Question,"Providing for consideration of H.R. 1062, the SEC Regulatory Accountability Act",Passed,221,0,0,11,1,181,0,19,0,0,0,0,222,181,0,30
156,R,113,H RES 216,17-May-2013,10:55 AM,On Agreeing to the Resolution,"Providing for consideration of H.R. 1062, the SEC Regulatory Accountability Act",Passed,221,0,0,11,2,180,0,19,0,0,0,0,223,180,0,30
157,R,113,H R 1062,17-May-2013,12:58 PM,On Agreeing to the Amendment,None,Agreed to,219,0,0,13,14,163,0,24,0,0,0,0,233,163,0,37
158,R,113,H R 1062,17-May-2013,1:05 PM,On Agreeing to the Amendment,None,Failed,1,218,0,13,164,15,0,22,0,0,0,0,165,233,0,35
159,R,113,H R 1062,17-May-2013,1:22 PM,On Motion to Recommit with Instructions,To improve the consideration by the Securities and Exchange Commission of the costs and benefits of its regulations and orders,Failed,1,216,0,15,178,1,0,22,0,0,0,0,179,217,0,37
160,R,113,H R 1062,17-May-2013,1:30 PM,On Passage,To improve the consideration by the Securities and Exchange Commission of the costs and benefits of its regulations and orders,Passed,218,0,0,14,17,161,0,23,0,0,0,0,235,161,0,37
161,R,113,H R 258,20-May-2013,6:57 PM,On Motion to Suspend the Rules and Pass,Stolen Valor Act,Passed,207,3,0,22,183,0,0,18,0,0,0,0,390,3,0,40
162,R,113,H R 1073,20-May-2013,7:05 PM,On Motion to Suspend the Rules and Pass,Nuclear Terrorism Conventions Implementation and Safety of Maritime Navigation Act,Passed,206,3,0,23,184,0,0,17,0,0,0,0,390,3,0,40
163,R,113,JOURNAL,20-May-2013,7:14 PM,On Approving the Journal,None,Passed,136,74,0,22,126,51,1,23,0,0,0,0,262,125,1,45
164,R,113,H R 1412,21-May-2013,2:58 PM,"On Motion to Suspend the Rules and Pass, as Amended",Improving Job Opportunities for Veterans Act,Passed,222,0,0,10,194,0,0,7,0,0,0,0,416,0,0,17
165,R,113,H R 324,21-May-2013,3:06 PM,"On Motion to Suspend the Rules and Pass, as Amended","To grant the Congressional Gold Medal, collectively, to the First Special Service Force, in recognition of its superior service during World War II",Passed,220,0,0,12,195,0,0,6,0,0,0,0,415,0,0,18
166,R,113,H R 1344,21-May-2013,3:13 PM,"On Motion to Suspend the Rules and Pass, as Amended",Helping Heroes Fly Act,Passed,219,0,0,13,194,0,0,7,0,0,0,0,413,0,0,20
167,R,113,H RES 228,22-May-2013,2:00 PM,On Ordering the Previous Question,"Providing for consideration of the bill (H.R. 3) to approve the construction, operation, and maintenance of the Keystone XL pipeline, and for other purposes",Passed,222,0,0,10,1,194,0,6,0,0,0,0,223,194,0,16
168,R,113,H RES 228,22-May-2013,2:13 PM,On Agreeing to the Resolution,"Providing for consideration of the bill (H.R. 3) to approve the construction, operation, and maintenance of the Keystone XL pipeline, and for other purposes",Passed,219,0,0,13,9,185,0,7,0,0,0,0,228,185,0,20
169,R,113,H R 3,22-May-2013,5:57 PM,On Agreeing to the Amendment,None,Agreed to,221,0,0,11,25,168,0,8,0,0,0,0,246,168,0,19
170,R,113,H R 3,22-May-2013,6:02 PM,On Agreeing to the Amendment,None,Failed,0,222,0,10,146,47,0,8,0,0,0,0,146,269,0,18
171,R,113,H R 3,22-May-2013,6:07 PM,On Agreeing to the Amendment,None,Failed,3,219,0,10,174,20,0,7,0,0,0,0,177,239,0,17
172,R,113,H R 3,22-May-2013,6:11 PM,On Agreeing to the Amendment,None,Failed,0,222,0,10,176,17,0,8,0,0,0,0,176,239,0,18
173,R,113,H R 3,22-May-2013,6:15 PM,On Agreeing to the Amendment,None,Failed,0,221,0,11,177,17,0,7,0,0,0,0,177,238,0,18
174,R,113,H R 3,22-May-2013,6:19 PM,On Agreeing to the Amendment,None,Failed,0,222,0,10,182,12,0,7,0,0,0,0,182,234,0,17
175,R,113,H R 3,22-May-2013,6:23 PM,On Agreeing to the Amendment,None,Failed,0,222,0,10,182,12,0,7,0,0,0,0,182,234,0,17
176,R,113,H R 3,22-May-2013,6:27 PM,On Agreeing to the Amendment,None,Failed,2,220,0,10,183,11,0,7,0,0,0,0,185,231,0,17
177,R,113,H R 3,22-May-2013,6:32 PM,On Agreeing to the Amendment,None,Failed,3,219,0,10,159,36,0,6,0,0,0,0,162,255,0,16
178,R,113,H R 3,22-May-2013,6:50 PM,On Motion to Recommit with Instructions,"To approve the construction, operation, and maintenance of the Keystone XL pipeline, and for other purposes",Failed,0,223,0,9,194,0,0,7,0,0,0,0,194,223,0,16
179,R,113,H R 3,22-May-2013,6:59 PM,On Passage,"To approve the construction, operation, and maintenance of the Keystone XL pipeline, and for other purposes",Passed,222,0,1,9,19,175,0,7,0,0,0,0,241,175,1,16
180,R,113,H RES 232,23-May-2013,10:46 AM,On Ordering the Previous Question,"Providing for consideration of the bill (H.R. 1911) to amend the Higher Education Act of 1965 to establish interest rates for new loans made on or after July 1, 2013, and for other purposes",Passed,224,0,0,8,0,195,0,6,0,0,0,0,224,195,0,14
181,R,113,H RES 232,23-May-2013,10:58 AM,On Agreeing to the Resolution,"Providing for consideration of the bill (H.R. 1911) to amend the Higher Education Act of 1965 to establish interest rates for new loans made on or after July 1, 2013, and for other purposes",Passed,224,0,0,8,0,193,0,8,0,0,0,0,224,193,0,16
182,R,113,H R 1911,23-May-2013,12:30 PM,On Motion to Recommit with Instructions,Smarter Solutions for Students Act,Failed,0,222,0,10,194,1,0,6,0,0,0,0,194,223,0,16
183,R,113,H R 1911,23-May-2013,12:39 PM,On Passage,Smarter Solutions for Students Act,Passed,217,8,0,8,4,190,0,7,0,0,0,0,221,198,0,15
184,R,113,H R 1206,3-Jun-2013,6:54 PM,On Motion to Suspend the Rules and Pass,Permanent Electronic Duck Stamp Act of 2013,Passed,222,0,0,10,179,0,0,22,0,0,0,0,401,0,0,32
185,R,113,S 622,3-Jun-2013,7:02 PM,On Motion to Suspend the Rules and Pass,Animal Drug and Animal Generic Drug User Fee Reauthorization Act of 2013,Passed,222,0,0,10,168,12,0,21,0,0,0,0,390,12,0,31
186,R,113,H RES 243,4-Jun-2013,2:30 PM,On Ordering the Previous Question,"Providing for consideration of H.R. 2216, the Military Construction and Veterans Affairs, and Related Agencies Appropriations Act, 2014; and providing for consideration of H.R. 2217, the Department of Homeland Security Appropriations Act, 2014",Passed,229,0,0,3,0,193,0,8,0,0,0,0,229,193,0,11
187,R,113,H RES 243,4-Jun-2013,2:37 PM,On Agreeing to the Resolution,"Providing for consideration of H.R. 2216, the Military Construction and Veterans Affairs, and Related Agencies Appropriations Act, 2014; and providing for consideration of H.R. 2217, the Department of Homeland Security Appropriations Act, 2014",Passed,227,1,0,4,0,193,0,8,0,0,0,0,227,194,0,12
188,R,113,H R 2216,4-Jun-2013,7:17 PM,On Agreeing to the Amendment,None,Failed,139,89,0,4,12,180,0,9,0,0,0,0,151,269,0,13
189,R,113,H R 2216,4-Jun-2013,7:23 PM,On Agreeing to the Amendment,None,Agreed to,181,47,0,4,67,125,0,9,0,0,0,0,248,172,0,13
190,R,113,H R 2216,4-Jun-2013,7:28 PM,On Agreeing to the Amendment,None,Failed,1,229,0,2,169,25,0,7,0,0,0,0,170,254,0,9
191,R,113,H R 2216,4-Jun-2013,7:33 PM,On Agreeing to the Amendment,None,Failed,192,36,0,4,0,195,0,6,0,0,0,0,192,231,0,10
192,R,113,H R 2216,4-Jun-2013,7:55 PM,On Motion to Recommit with Instructions,"Making appropriations for military construction, the Department of Veterans Affairs, and related agencies for the fiscal year ending September 30, 2014, and for other purposes",Failed,2,227,0,3,196,0,0,5,0,0,0,0,198,227,0,8
193,R,113,H R 2216,4-Jun-2013,8:04 PM,On Passage,"Making appropriations for military construction, the Department of Veterans Affairs, and related agencies for the fiscal year ending September 30, 2014, and for other purposes",Passed,229,0,0,3,192,4,0,5,0,0,0,0,421,4,0,8
194,R,113,H R 2217,5-Jun-2013,5:03 PM,On Agreeing to the Amendment,None,Failed,0,230,0,2,167,27,0,7,0,0,0,0,167,257,0,9
195,R,113,H R 2217,5-Jun-2013,5:11 PM,On Agreeing to the Amendment,None,Failed,1,229,0,2,179,16,0,6,0,0,0,0,180,245,0,8
196,R,113,H R 2217,5-Jun-2013,5:16 PM,On Agreeing to the Amendment,None,Failed,56,173,0,3,100,95,0,6,0,0,0,0,156,268,0,9
197,R,113,H R 2217,5-Jun-2013,5:21 PM,On Agreeing to the Amendment,None,Failed,6,223,0,3,180,13,0,8,0,0,0,0,186,236,0,11
198,R,113,H R 2217,5-Jun-2013,5:36 PM,On Agreeing to the Amendment,None,Failed,8,221,0,4,182,11,0,8,0,0,0,0,190,232,0,12
199,R,113,H R 2217,5-Jun-2013,10:28 PM,On Agreeing to the Amendment,None,Failed,11,218,0,4,69,127,0,5,0,0,0,0,80,345,0,9
200,R,113,H R 2217,5-Jun-2013,10:34 PM,On Agreeing to the Amendment,None,Failed,1,228,0,4,164,33,0,4,0,0,0,0,165,261,0,8
201,R,113,H R 2217,5-Jun-2013,10:39 PM,On Agreeing to the Amendment,None,Failed,161,68,0,4,19,179,0,3,0,0,0,0,180,247,0,7
202,R,113,H R 2217,5-Jun-2013,10:42 PM,On Agreeing to the Amendment,None,Failed,29,199,0,5,21,174,1,5,0,0,0,0,50,373,1,10
203,R,113,H R 2217,5-Jun-2013,10:47 PM,On Agreeing to the Amendment,None,Agreed to,94,135,0,4,187,11,0,3,0,0,0,0,281,146,0,7
204,R,113,H R 2217,5-Jun-2013,10:51 PM,On Agreeing to the Amendment,None,Agreed to,216,13,0,4,18,179,0,4,0,0,0,0,234,192,0,8
205,R,113,H R 2217,5-Jun-2013,10:55 PM,On Agreeing to the Amendment,None,Failed,33,196,0,4,113,84,0,4,0,0,0,0,146,280,0,8
206,R,113,H R 2217,5-Jun-2013,11:00 PM,On Agreeing to the Amendment,None,Failed,36,193,0,4,112,85,0,4,0,0,0,0,148,278,0,8
207,R,113,H R 2217,6-Jun-2013,10:33 AM,On Agreeing to the Amendment,None,Agreed to,91,136,0,6,196,0,0,5,0,0,0,0,287,136,0,11
208,R,113,H R 2217,6-Jun-2013,10:41 AM,On Agreeing to the Amendment,None,Agreed to,221,6,0,6,3,195,0,3,0,0,0,0,224,201,0,9
209,R,113,H R 2217,6-Jun-2013,10:45 AM,On Agreeing to the Amendment,None,Failed,189,36,0,8,7,189,0,5,0,0,0,0,196,225,0,13
210,R,113,H R 2217,6-Jun-2013,11:02 AM,On Motion to Recommit with Instructions,"Making appropriations for the Department of Homeland Security for the fiscal year ending September 30, 2014, and for other purposes",Failed,1,226,0,6,195,0,0,6,0,0,0,0,196,226,0,12
211,R,113,H R 2217,6-Jun-2013,11:12 AM,On Passage,"Making appropriations for the Department of Homeland Security for the fiscal year ending September 30, 2014, and for other purposes",Passed,220,10,0,3,25,172,0,4,0,0,0,0,245,182,0,7
212,R,113,H R 251,11-Jun-2013,6:52 PM,On Motion to Suspend the Rules and Pass,South Utah Valley Electric Conveyance Act,Passed,222,0,0,11,182,0,0,19,0,0,0,0,404,0,0,30
213,R,113,H R 1157,11-Jun-2013,7:01 PM,On Motion to Suspend the Rules and Pass,Rattlesnake Mountain Public Access Act,Passed,224,0,0,9,185,0,0,16,0,0,0,0,409,0,0,25
214,R,113,H RES 256,12-Jun-2013,3:10 PM,On Agreeing to the Resolution,"Providing for consideration of H.R. 1960, the National Defense Authorization Act for FY 2014; and providing for consideration of H.R. 1256, the Swap Jurisdiction Certainty Act",Passed,229,0,0,4,10,184,0,7,0,0,0,0,239,184,0,11
215,R,113,H R 634,12-Jun-2013,3:17 PM,"On Motion to Suspend the Rules and Pass, as Amended","To provide end user exemptions from certain provisions of the Commodity Exchange Act and the Securities Exchange Act of 1934, and for other purposes",Passed,230,0,0,3,181,12,0,8,0,0,0,0,411,12,0,11
216,R,113,H R 742,12-Jun-2013,3:26 PM,On Motion to Suspend the Rules and Pass,To amend the Securities Exchange Act of 1934 and the Commodity Exchange Act to repeal the indemnification requirements for regulatory authorities to obtain access to swap data required to be provided by swaps entities under such Acts,Passed,229,0,0,4,191,2,0,8,0,0,0,0,420,2,0,12
217,R,113,H R 1256,12-Jun-2013,5:16 PM,On Motion to Recommit with Instructions,Swap Jurisdiction Certainty Act,Failed,2,228,0,3,192,2,0,7,0,0,0,0,194,230,0,10
218,R,113,H R 1256,12-Jun-2013,5:23 PM,On Passage,Swap Jurisdiction Certainty Act,Passed,228,2,0,3,73,122,0,6,0,0,0,0,301,124,0,9
219,R,113,H R 1038,12-Jun-2013,5:31 PM,On Motion to Suspend the Rules and Pass,"To provide equal treatment for utility special entities using utility operations-related swaps, and for other purposes",Passed,230,0,0,3,193,0,0,8,0,0,0,0,423,0,0,11
220,R,113,H RES 260,13-Jun-2013,2:22 PM,On Ordering the Previous Question,"Providing for further consideration of the bill (H.R. 1960) to authorize appropriations for fiscal year 2014 for military activities of the Department of Defense and for military construction, to prescribe military personnel strengths for such fiscal year, and for other purposes",Passed,231,0,0,2,2,195,0,4,0,0,0,0,233,195,0,6
221,R,113,H RES 260,13-Jun-2013,2:31 PM,On Agreeing to the Resolution,"Providing for further consideration of the bill (H.R. 1960) to authorize appropriations for fiscal year 2014 for military activities of the Department of Defense and for military construction, to prescribe military personnel strengths for such fiscal year, and for other purposes",Passed,230,1,0,2,8,188,0,5,0,0,0,0,238,189,0,7
222,R,113,H R 1960,13-Jun-2013,5:34 PM,On Agreeing to the Amendment,None,Failed,15,217,0,1,91,101,0,9,0,0,0,0,106,318,0,10
223,R,113,H R 1960,13-Jun-2013,5:39 PM,On Agreeing to the Amendment,None,Agreed to,228,4,0,1,7,185,0,9,0,0,0,0,235,189,0,10
224,R,113,H R 1960,13-Jun-2013,5:47 PM,On Agreeing to the Amendment,None,Failed,196,36,0,1,10,184,0,7,0,0,0,0,206,220,0,8
225,R,113,H R 1960,13-Jun-2013,5:50 PM,On Agreeing to the Amendment,None,Failed,177,55,0,1,1,193,0,7,0,0,0,0,178,248,0,8
226,R,113,H R 1960,13-Jun-2013,5:54 PM,On Agreeing to the Amendment,None,Agreed to,120,112,0,1,185,9,0,7,0,0,0,0,305,121,0,8
227,R,113,H R 1960,13-Jun-2013,5:58 PM,On Agreeing to the Amendment,None,Agreed to,211,21,0,1,3,190,0,8,0,0,0,0,214,211,0,9
228,R,113,H R 1960,13-Jun-2013,6:03 PM,On Agreeing to the Amendment,None,Failed,19,213,0,1,181,13,0,7,0,0,0,0,200,226,0,8
229,R,113,H R 1960,14-Jun-2013,11:42 AM,On Agreeing to the Amendment,None,Agreed to,227,2,0,4,12,180,0,9,0,0,0,0,239,182,0,13
230,R,113,H R 1960,14-Jun-2013,11:52 AM,On Agreeing to the Amendment,None,Failed,0,230,0,3,61,132,0,8,0,0,0,0,61,362,0,11
231,R,113,H R 1960,14-Jun-2013,11:56 AM,On Agreeing to the Amendment,None,Failed,23,207,0,3,111,83,0,7,0,0,0,0,134,290,0,10
232,R,113,H R 1960,14-Jun-2013,12:00 PM,On Agreeing to the Amendment,None,Failed,6,224,0,3,65,129,0,7,0,0,0,0,71,353,0,10
233,R,113,H R 1960,14-Jun-2013,12:04 PM,On Agreeing to the Amendment,None,Failed,5,225,0,3,190,4,0,7,0,0,0,0,195,229,0,10
234,R,113,H R 1960,14-Jun-2013,12:09 PM,On Agreeing to the Amendment,None,Failed,62,168,0,3,61,133,0,7,0,0,0,0,123,301,0,10
235,R,113,H R 1960,14-Jun-2013,12:13 PM,On Agreeing to the Amendment,None,Failed,30,200,0,3,80,113,0,8,0,0,0,0,110,313,0,11
236,R,113,H R 1960,14-Jun-2013,12:17 PM,On Agreeing to the Amendment,None,Agreed to,225,5,0,3,11,183,0,7,0,0,0,0,236,188,0,10
237,R,113,H R 1960,14-Jun-2013,12:20 PM,On Agreeing to the Amendment,None,Failed,2,228,0,3,172,21,0,8,0,0,0,0,174,249,0,11
238,R,113,H R 1960,14-Jun-2013,12:23 PM,On Agreeing to the Amendment,None,Failed,0,230,0,3,150,44,0,7,0,0,0,0,150,274,0,10
239,R,113,H R 1960,14-Jun-2013,12:27 PM,On Agreeing to the Amendment,None,Failed,5,225,0,3,141,53,0,7,0,0,0,0,146,278,0,10
240,R,113,H R 1960,14-Jun-2013,12:30 PM,On Agreeing to the Amendment,None,Failed,20,210,0,3,171,22,0,8,0,0,0,0,191,232,0,11
241,R,113,H R 1960,14-Jun-2013,12:34 PM,On Agreeing to the Amendment,None,Agreed to,227,2,0,4,193,1,0,7,0,0,0,0,420,3,0,11
242,R,113,H R 1960,14-Jun-2013,12:37 PM,On Agreeing to the Amendment,None,Agreed to,229,0,0,4,194,0,0,7,0,0,0,0,423,0,0,11
243,R,113,H R 1960,14-Jun-2013,12:54 PM,On Motion to Recommit with Instructions,National Defense Authorization Act for Fiscal Year 2014,Failed,2,225,0,6,192,0,1,8,0,0,0,0,194,225,1,14
244,R,113,H R 1960,14-Jun-2013,1:07 PM,On Passage,National Defense Authorization Act for Fiscal Year 2014,Passed,212,18,0,3,103,90,0,8,0,0,0,0,315,108,0,11
245,R,113,H R 876,17-Jun-2013,6:55 PM,On Motion to Suspend the Rules and Pass,Idaho Wilderness Water Resources Protection Act,Passed,211,0,0,22,187,0,0,14,0,0,0,0,398,0,0,36
246,R,113,H R 253,17-Jun-2013,7:02 PM,"On Motion to Suspend the Rules and Pass, as Amended",Y Mountain Access Enhancement Act,Passed,210,1,0,22,187,0,0,14,0,0,0,0,397,1,0,36
247,R,113,H R 862,17-Jun-2013,7:11 PM,On Motion to Suspend the Rules and Pass,To authorize the conveyance of two small parcels of land within the boundaries of the Coconino National Forest containing private improvements that were developed based upon the reliance of the landowners in an erroneous survey conducted in May 1960,Passed,209,1,0,23,186,0,0,15,0,0,0,0,395,1,0,38
248,R,113,H RES 266,18-Jun-2013,3:07 PM,On Ordering the Previous Question,"Providing for consideration of H.R. 1947, to provide for the reform and continuation of agricultural and other programs of the Department of Agriculture through FY 2018; and providing for consideration of H.R. 1797, to amend title 18, U.S. Code, to protect pain-capable unborn children in the District of Columbia",Passed,229,0,0,4,0,196,0,5,0,0,0,0,229,196,0,9
249,R,113,H RES 266,18-Jun-2013,3:16 PM,On Agreeing to the Resolution,"Providing for consideration of H.R. 1947, to provide for the reform and continuation of agricultural and other programs of the Department of Agriculture through FY 2018; and providing for consideration of H.R. 1797, to amend title 18, U.S. Code, to protect pain-capable unborn children in the District of Columbia",Passed,227,2,0,4,5,191,0,5,0,0,0,0,232,193,0,9
250,R,113,H R 1151,18-Jun-2013,3:24 PM,On Motion to Suspend the Rules and Pass,"To direct the Secretary of State to develop a strategy to obtain observer status for Taiwan at the triennial International Civil Aviation Organization Assembly, and for other purposes",Passed,229,0,0,4,195,0,0,6,0,0,0,0,424,0,0,10
251,R,113,H R 1797,18-Jun-2013,6:44 PM,On Passage,District of Columbia Pain-Capable Unborn Child Protection Act,Passed,222,6,0,5,6,190,0,5,0,0,0,0,228,196,0,10
252,R,113,H R 1896,18-Jun-2013,6:52 PM,On Motion to Suspend the Rules and Pass,"To amend part D of title IV of the Social Security Act to ensure that the United States can comply fully with the obligations of the Hague Convention of 23 November 2007 on the International Recovery of Child Support and Other Forms of Family Maintenance, and for other purposes",Passed,200,27,0,6,194,0,0,7,0,0,0,0,394,27,0,13
253,R,113,H RES 271,19-Jun-2013,2:35 PM,On Ordering the Previous Question,"Providing for consideration of the bill (H.R. 1947) to provide for the reform and continuation of agricultural and other programs of the Department of Agriculture through fiscal years 2018, and for other purposes",Passed,229,0,0,4,4,187,0,10,0,0,0,0,233,187,0,14
254,R,113,H RES 271,19-Jun-2013,2:43 PM,On Agreeing to the Resolution,"Providing for consideration of the bill (H.R. 1947) to provide for the reform and continuation of agricultural and other programs of the Department of Agriculture through fiscal years 2018, and for other purposes",Passed,224,4,0,5,15,173,0,13,0,0,0,0,239,177,0,18
255,R,113,JOURNAL,19-Jun-2013,2:50 PM,On Approving the Journal,None,Passed,156,70,0,7,119,69,1,12,0,0,0,0,275,139,1,19
256,R,113,H R 1947,19-Jun-2013,6:18 PM,On Agreeing to the Amendment,None,Failed,5,226,0,2,183,8,0,10,0,0,0,0,188,234,0,12
257,R,113,H R 1947,19-Jun-2013,6:23 PM,On Agreeing to the Amendment,None,Agreed to,183,48,0,2,84,108,0,9,0,0,0,0,267,156,0,11
258,R,113,H R 1947,19-Jun-2013,6:28 PM,On Agreeing to the Amendment,None,Failed,109,122,0,2,3,187,0,11,0,0,0,0,112,309,0,13
259,R,113,H R 1947,19-Jun-2013,6:32 PM,On Agreeing to the Amendment,None,Failed,9,222,0,2,170,20,0,11,0,0,0,0,179,242,0,13
260,R,113,H R 1947,19-Jun-2013,6:36 PM,On Agreeing to the Amendment,None,Failed,4,227,0,2,153,39,0,9,0,0,0,0,157,266,0,11
261,R,113,H R 1947,19-Jun-2013,6:40 PM,On Agreeing to the Amendment,None,Agreed to,81,149,0,3,192,0,0,9,0,0,0,0,273,149,0,12
262,R,113,H R 1947,19-Jun-2013,6:45 PM,On Agreeing to the Amendment,None,Failed,105,126,0,2,98,94,0,9,0,0,0,0,203,220,0,11
263,R,113,H R 1947,19-Jun-2013,6:51 PM,On Agreeing to the Amendment,None,Failed,89,142,0,2,9,180,0,12,0,0,0,0,98,322,0,14
264,R,113,H R 1947,20-Jun-2013,10:22 AM,On Agreeing to the Amendment,None,Failed,101,129,0,3,2,193,0,6,0,0,0,0,103,322,0,9
265,R,113,H R 1947,20-Jun-2013,10:26 AM,On Agreeing to the Amendment,None,Failed,6,223,0,4,117,74,0,10,0,0,0,0,123,297,0,14
266,R,113,H R 1947,20-Jun-2013,10:31 AM,On Agreeing to the Amendment,None,Failed,74,156,0,3,5,190,0,6,0,0,0,0,79,346,0,9
267,R,113,H R 1947,20-Jun-2013,10:36 AM,On Agreeing to the Amendment,None,Failed,194,37,0,2,0,195,0,6,0,0,0,0,194,232,0,8
268,R,113,H R 1947,20-Jun-2013,10:41 AM,On Agreeing to the Amendment,None,Failed,23,208,0,2,188,7,0,6,0,0,0,0,211,215,0,8
269,R,113,H R 1947,20-Jun-2013,10:45 AM,On Agreeing to the Amendment,None,Agreed to,63,168,0,2,162,32,0,7,0,0,0,0,225,200,0,9
270,R,113,H R 1947,20-Jun-2013,10:50 AM,On Agreeing to the Amendment,None,Failed,29,202,0,2,177,17,0,7,0,0,0,0,206,219,0,9
271,R,113,H R 1947,20-Jun-2013,10:54 AM,On Agreeing to the Amendment,None,Failed,186,44,0,3,8,186,0,7,0,0,0,0,194,230,0,10
272,R,113,H R 1947,20-Jun-2013,10:58 AM,On Agreeing to the Amendment,None,Failed,155,76,0,2,1,193,0,7,0,0,0,0,156,269,0,9
273,R,113,H R 1947,20-Jun-2013,11:01 AM,On Agreeing to the Amendment,None,Agreed to,210,20,0,3,133,61,1,6,0,0,0,0,343,81,1,9
274,R,113,H R 1947,20-Jun-2013,11:05 AM,On Agreeing to the Amendment,None,Failed,184,47,0,2,13,180,0,8,0,0,0,0,197,227,0,10
275,R,113,H R 1947,20-Jun-2013,11:09 AM,On Agreeing to the Amendment,None,Failed,38,193,0,2,170,25,0,6,0,0,0,0,208,218,0,8
276,R,113,H R 1947,20-Jun-2013,11:14 AM,On Agreeing to the Amendment,None,Failed,74,157,0,2,134,60,0,7,0,0,0,0,208,217,0,9
277,R,113,H R 1947,20-Jun-2013,11:18 AM,On Agreeing to the Amendment,None,Failed,68,163,0,2,106,89,0,6,0,0,0,0,174,252,0,8
278,R,113,H R 1947,20-Jun-2013,12:54 PM,On Agreeing to the Amendment,None,Agreed to,196,35,1,2,95,100,0,6,0,0,0,0,291,135,1,8
279,R,113,H R 1947,20-Jun-2013,1:03 PM,On Agreeing to the Amendment,None,Agreed to,168,64,0,1,67,128,0,6,0,0,0,0,235,192,0,7
280,R,113,H R 1947,20-Jun-2013,1:07 PM,On Agreeing to the Amendment,None,Agreed to,175,56,0,2,40,155,0,6,0,0,0,0,215,211,0,8
281,R,113,H R 1947,20-Jun-2013,1:11 PM,On Agreeing to the Amendment,None,Failed,137,95,0,1,69,126,0,6,0,0,0,0,206,221,0,7
282,R,113,H R 1947,20-Jun-2013,1:14 PM,On Agreeing to the Amendment,None,Agreed to,97,134,0,2,133,60,0,8,0,0,0,0,230,194,0,10
283,R,113,H R 1947,20-Jun-2013,1:17 PM,On Agreeing to the Amendment,None,Failed,175,57,0,1,0,193,0,8,0,0,0,0,175,250,0,9
284,R,113,H R 1947,20-Jun-2013,1:20 PM,On Agreeing to the Amendment,None,Agreed to,226,6,0,1,1,192,0,8,0,0,0,0,227,198,0,9
285,R,113,H R 1947,20-Jun-2013,1:41 PM,On Motion to Recommit with Instructions,Federal Agriculture Reform and Risk Management Act,Failed,1,231,0,1,187,1,0,13,0,0,0,0,188,232,0,14
286,R,113,H R 1947,20-Jun-2013,1:54 PM,On Passage,Federal Agriculture Reform and Risk Management Act,Failed,171,62,0,1,24,172,0,5,0,0,0,0,195,234,0,6
287,R,113,H R 2383,25-Jun-2013,6:55 PM,On Motion to Suspend the Rules and Pass,"To designate the new Interstate Route 20 bridge over the Mississippi River connecting St. Louis, Missouri, and southwestern Illinois as the “Stan Musial Veterans Memorial Bridge”",Passed,212,2,0,19,183,0,0,18,0,0,0,0,395,2,0,37
288,R,113,H R 1092,25-Jun-2013,7:03 PM,On Motion to Suspend the Rules and Pass,"To designate the air traffic control center located in Nashua, New Hampshire, as the “Patricia Clark Boston Air Route Traffic Control Center”",Passed,210,3,1,19,182,0,0,19,0,0,0,0,392,3,1,38
289,R,113,H RES 274,26-Jun-2013,1:57 PM,On Ordering the Previous Question,"Providing for consideration of H.R. 1613, Outer Continental Shelf Transboundary Hydrocarbon Agreements Authorization Act; providing for consideration of H.R. 2231, Offshore Energy and Jobs Act; and providing for consideration of H.R. 2410, making appropriations for Agriculture, FY 2014",Passed,228,0,0,5,0,194,0,7,0,0,0,0,228,194,0,12
290,R,113,H RES 274,26-Jun-2013,2:09 PM,On Agreeing to the Resolution,"Providing for consideration of H.R. 1613, Outer Continental Shelf Transboundary Hydrocarbon Agreements Authorization Act; providing for consideration of H.R. 2231, Offshore Energy and Jobs Act; and providing for consideration of H.R. 2410, making appropriations for Agriculture, FY 2014",Passed,229,0,0,4,6,187,0,8,0,0,0,0,235,187,0,12
291,R,113,H R 1613,27-Jun-2013,2:38 PM,On Agreeing to the Amendment,None,Failed,21,208,0,4,192,5,0,4,0,0,0,0,213,213,0,8
292,R,113,H R 1613,27-Jun-2013,2:57 PM,On Motion to Recommit with Instructions,"To amend the Outer Continental Shelf Lands Act to provide for the proper Federal management and oversight of transboundary hydrocarbon reservoirs, and for other purposes",Failed,1,227,0,5,193,5,0,3,0,0,0,0,194,232,0,8
293,R,113,H R 1613,27-Jun-2013,3:04 PM,On Passage,"To amend the Outer Continental Shelf Lands Act to provide for the proper Federal management and oversight of transboundary hydrocarbon reservoirs, and for other purposes",Passed,228,1,0,4,28,170,0,3,0,0,0,0,256,171,0,7
294,R,113,H R 1864,27-Jun-2013,3:15 PM,On Motion to Suspend the Rules and Pass,"To amend title 10, United States Code, to require an Inspector General investigation of allegations of retaliatory personnel actions taken in response to making protected communications regarding sexual assault",Passed,226,0,0,7,197,0,0,4,0,0,0,0,423,0,0,11
295,R,113,H R 2231,27-Jun-2013,6:27 PM,On Agreeing to the Amendment,None,Failed,3,224,0,6,185,9,0,7,0,0,0,0,188,233,0,13
296,R,113,H R 2231,27-Jun-2013,6:32 PM,On Agreeing to the Amendment,None,Agreed to,223,2,0,8,10,188,0,3,0,0,0,0,233,190,0,11
297,R,113,H R 2231,27-Jun-2013,6:36 PM,On Agreeing to the Amendment,None,Agreed to,215,11,0,7,23,174,0,4,0,0,0,0,238,185,0,11
298,R,113,H R 2231,27-Jun-2013,6:40 PM,On Agreeing to the Amendment,None,Agreed to,221,6,0,6,13,185,0,3,0,0,0,0,234,191,0,9
299,R,113,H R 2231,28-Jun-2013,10:35 AM,On Agreeing to the Amendment,None,Failed,3,220,0,10,180,15,0,6,0,0,0,0,183,235,0,16
300,R,113,H R 2231,28-Jun-2013,10:40 AM,On Agreeing to the Amendment,None,Agreed to,214,10,0,9,3,192,0,6,0,0,0,0,217,202,0,15
301,R,113,H R 2231,28-Jun-2013,10:46 AM,On Agreeing to the Amendment,None,Failed,17,208,0,8,192,2,0,7,0,0,0,0,209,210,0,15
302,R,113,H R 2231,28-Jun-2013,10:50 AM,On Agreeing to the Amendment,None,Failed,0,224,0,9,176,17,0,8,0,0,0,0,176,241,0,17
303,R,113,H R 2231,28-Jun-2013,11:14 AM,On Motion to Recommit with Instructions,Offshore Energy and Jobs Act,Failed,0,224,1,8,195,1,0,5,0,0,0,0,195,225,1,13
304,R,113,H R 2231,28-Jun-2013,11:20 AM,On Passage,Offshore Energy and Jobs Act,Passed,219,6,0,8,16,180,0,5,0,0,0,0,235,186,0,13
305,R,113,H R 1341,8-Jul-2013,6:53 PM,"On Motion to Suspend the Rules and Pass, as Amended",To require the Financial Stability Oversight Council to conduct a study of the likely effects of the differences between the United States and other jurisdictions in implementing the derivatives credit valuation adjustment capital requirement,Passed,207,0,0,26,146,24,0,31,0,0,0,0,353,24,0,57
306,R,113,H R 1564,8-Jul-2013,7:01 PM,"On Motion to Suspend the Rules and Pass, as Amended",To amend the Sarbanes-Oxley Act of 2002 to prohibit the Public Company Accounting Oversight Board from requiring public companies to use specific auditors or require the use of different auditors on a rotating basis,Passed,211,0,0,22,110,62,0,29,0,0,0,0,321,62,0,51
307,R,113,H R 1171,8-Jul-2013,7:08 PM,On Motion to Suspend the Rules and Pass,"To amend title 40, United States Code, to improve veterans service organizations access to Federal surplus personal property",Passed,212,1,0,20,175,0,0,26,0,0,0,0,387,1,0,46
308,R,113,H RES 288,9-Jul-2013,1:31 PM,On Ordering the Previous Question,"Providing for consideration of the bill (H.R. 2609) making appropriations for energy and water development and related agencies for the fiscal year ending September 30, 2014, and for other purposes",Passed,220,0,0,13,0,182,0,19,0,0,0,0,220,182,0,32
309,R,113,H RES 288,9-Jul-2013,1:40 PM,On Agreeing to the Resolution,"Providing for consideration of the bill (H.R. 2609) making appropriations for energy and water development and related agencies for the fiscal year ending September 30, 2014, and for other purposes",Passed,218,0,0,15,8,178,0,15,0,0,0,0,226,178,0,30
310,R,113,JOURNAL,9-Jul-2013,1:48 PM,On Approving the Journal,None,Passed,148,68,0,17,114,70,1,16,0,0,0,0,262,138,1,33
311,R,113,H R 2609,9-Jul-2013,6:21 PM,On Agreeing to the Amendment,None,Failed,1,224,0,8,176,12,0,13,0,0,0,0,177,236,0,21
312,R,113,H R 2609,9-Jul-2013,6:29 PM,On Agreeing to the Amendment,None,Failed,7,216,0,10,181,10,0,10,0,0,0,0,188,226,0,20
313,R,113,H R 2609,9-Jul-2013,6:36 PM,On Agreeing to the Amendment,None,Failed,2,223,0,8,150,41,0,10,0,0,0,0,152,264,0,18
314,R,113,H R 2609,9-Jul-2013,6:43 PM,On Agreeing to the Amendment,None,Failed,56,169,0,8,84,106,0,11,0,0,0,0,140,275,0,19
315,R,113,H R 2609,9-Jul-2013,6:55 PM,On Agreeing to the Amendment,None,Failed,153,70,0,10,0,187,0,14,0,0,0,0,153,257,0,24
316,R,113,H R 2609,9-Jul-2013,10:28 PM,On Agreeing to the Amendment,None,Failed,2,217,0,14,166,24,0,11,0,0,0,0,168,241,0,25
317,R,113,H R 2609,9-Jul-2013,10:32 PM,On Agreeing to the Amendment,None,Failed,158,66,0,9,0,190,0,11,0,0,0,0,158,256,0,20
318,R,113,H R 2609,9-Jul-2013,10:35 PM,On Agreeing to the Amendment,None,Failed,13,210,0,10,188,3,0,10,0,0,0,0,201,213,0,20
319,R,113,H R 2609,9-Jul-2013,10:39 PM,On Agreeing to the Amendment,None,Failed,115,109,0,9,0,191,0,10,0,0,0,0,115,300,0,19
320,R,113,H R 2609,9-Jul-2013,10:42 PM,On Agreeing to the Amendment,None,Failed,8,216,0,9,183,7,0,11,0,0,0,0,191,223,0,20
321,R,113,H R 2609,9-Jul-2013,10:46 PM,On Agreeing to the Amendment,None,Failed,4,220,0,9,173,18,0,10,0,0,0,0,177,238,0,19
322,R,113,H R 2609,9-Jul-2013,10:49 PM,On Agreeing to the Amendment,None,Failed,2,222,0,9,172,20,0,9,0,0,0,0,174,242,0,18
323,R,113,H R 2609,9-Jul-2013,10:52 PM,On Agreeing to the Amendment,None,Failed,2,222,0,9,162,30,0,9,0,0,0,0,164,252,0,18
324,R,113,H R 2609,9-Jul-2013,10:57 PM,On Agreeing to the Amendment,None,Failed,3,221,0,9,163,29,0,9,0,0,0,0,166,250,0,18
325,R,113,H R 2609,9-Jul-2013,11:01 PM,On Agreeing to the Amendment,None,Failed,7,217,0,9,74,118,0,9,0,0,0,0,81,335,0,18
326,R,113,H R 2609,9-Jul-2013,11:04 PM,On Agreeing to the Amendment,None,Failed,2,222,0,9,148,44,0,9,0,0,0,0,150,266,0,18
327,R,113,H R 2609,9-Jul-2013,11:07 PM,On Agreeing to the Amendment,None,Failed,3,221,0,9,140,52,0,9,0,0,0,0,143,273,0,18
328,R,113,H R 2609,10-Jul-2013,2:26 PM,On Agreeing to the Amendment,None,Failed,2,224,0,7,154,42,0,5,0,0,0,0,156,266,0,12
329,R,113,H R 2609,10-Jul-2013,2:32 PM,On Agreeing to the Amendment,None,Failed,0,224,0,9,155,42,0,4,0,0,0,0,155,266,0,13
330,R,113,H R 2609,10-Jul-2013,2:39 PM,On Agreeing to the Amendment,None,Failed,162,60,0,11,3,192,0,6,0,0,0,0,165,252,0,17
331,R,113,H R 2609,10-Jul-2013,2:45 PM,On Agreeing to the Amendment,None,Failed,0,225,0,8,184,13,0,4,0,0,0,0,184,238,0,12
332,R,113,H R 2609,10-Jul-2013,2:52 PM,On Agreeing to the Amendment,None,Failed,30,196,0,7,166,31,0,4,0,0,0,0,196,227,0,11
333,R,113,H R 2609,10-Jul-2013,3:01 PM,On Agreeing to the Amendment,None,Failed,82,145,0,6,4,193,0,4,0,0,0,0,86,338,0,10
334,R,113,H R 2609,10-Jul-2013,5:45 PM,On Agreeing to the Amendment,None,Failed,18,211,0,4,164,32,0,5,0,0,0,0,182,243,0,9
335,R,113,H R 2609,10-Jul-2013,5:52 PM,On Agreeing to the Amendment,None,Failed,42,184,0,7,72,124,0,5,0,0,0,0,114,308,0,12
336,R,113,H R 2609,10-Jul-2013,5:59 PM,On Agreeing to the Amendment,None,Failed,48,179,0,6,83,112,0,6,0,0,0,0,131,291,0,12
337,R,113,H R 2609,10-Jul-2013,6:06 PM,On Agreeing to the Amendment,None,Failed,5,223,0,5,82,114,0,5,0,0,0,0,87,337,0,10
338,R,113,H R 2609,10-Jul-2013,6:12 PM,On Agreeing to the Amendment,None,Agreed to,32,195,0,6,185,11,0,5,0,0,0,0,217,206,0,11
339,R,113,H R 2609,10-Jul-2013,9:51 PM,On Agreeing to the Amendment,None,Failed,93,133,0,7,1,196,0,4,0,0,0,0,94,329,0,11
340,R,113,H R 2609,10-Jul-2013,9:56 PM,On Agreeing to the Amendment,None,Agreed to,223,4,0,6,7,190,0,4,0,0,0,0,230,194,0,10
341,R,113,H R 2609,10-Jul-2013,10:00 PM,On Agreeing to the Amendment,None,Failed,5,222,0,6,165,31,0,5,0,0,0,0,170,253,0,11
342,R,113,H R 2609,10-Jul-2013,10:04 PM,On Agreeing to the Amendment,None,Failed,38,189,0,6,136,61,0,4,0,0,0,0,174,250,0,10
343,R,113,H R 2609,10-Jul-2013,10:07 PM,On Agreeing to the Amendment,None,Failed,144,81,0,8,3,192,0,6,0,0,0,0,147,273,0,14
344,R,113,H R 2609,10-Jul-2013,10:23 PM,On Motion to Recommit with Instructions,"Making appropriations for energy and water development and related agencies for the fiscal year ending September 30, 2014, and for other purposes",Failed,0,228,0,5,195,2,0,4,0,0,0,0,195,230,0,9
345,R,113,H R 2609,10-Jul-2013,10:31 PM,On Passage,"Making appropriations for energy and water development and related agencies for the fiscal year ending September 30, 2014, and for other purposes",Passed,219,9,0,5,8,189,0,4,0,0,0,0,227,198,0,9
346,R,113,ADJOURN,11-Jul-2013,9:45 AM,On Motion to Adjourn,None,Failed,0,210,0,23,125,50,0,26,0,0,0,0,125,260,0,49
347,R,113,H RES 295,11-Jul-2013,11:16 AM,Table Appeal of the Ruling of the Chair,"Providing for consideration of the bill (H.R. 2642) to provide for the reform and continuation of agricultural and other programs of the Department of Agriculture through fiscal year 2018, and for other purposes",Passed,226,1,0,6,0,195,0,6,0,0,0,0,226,196,0,12
348,R,113,ADJOURN,11-Jul-2013,12:20 PM,On Motion to Adjourn,None,Failed,0,218,0,15,138,47,0,16,0,0,0,0,138,265,0,31
349,R,113,H RES 295,11-Jul-2013,1:00 PM,On Agreeing to the Resolution,"Providing for consideration of the bill (H.R. 2642) to provide for the reform and continuation of agricultural and other programs of the Department of Agriculture through fiscal year 2018, and for other purposes",Passed,223,1,0,9,0,194,0,7,0,0,0,0,223,195,0,16
350,R,113,H R 2642,11-Jul-2013,2:07 PM,Table Appeal of the Ruling of the Chair,Federal Agriculture Reform and Risk Management Act,Passed,224,1,0,8,2,188,0,11,0,0,0,0,226,189,0,19
351,R,113,H R 2642,11-Jul-2013,2:52 PM,Table Appeal of the Ruling of the Chair,Federal Agriculture Reform and Risk Management Act,Passed,219,0,0,14,2,181,0,18,0,0,0,0,221,181,0,32
352,R,113,H R 2642,11-Jul-2013,3:31 PM,On Motion to Recommit with Instructions,Federal Agriculture Reform and Risk Management Act,Failed,1,226,0,6,197,0,0,4,0,0,0,0,198,226,0,10
353,R,113,H R 2642,11-Jul-2013,3:39 PM,On Passage,Federal Agriculture Reform and Risk Management Act,Passed,216,12,0,6,0,196,0,5,0,0,0,0,216,208,0,11
354,R,113,H R 2576,16-Jul-2013,6:58 PM,On Motion to Suspend the Rules and Pass,"To amend title 49, United States Code, to modify requirements relating to the availability of pipeline safety regulatory documents, and for other purposes",Passed,222,0,0,11,183,2,0,15,0,0,0,0,405,2,0,26
355,R,113,H R 1848,16-Jul-2013,7:05 PM,"On Motion to Suspend the Rules and Pass, as Amended","To ensure that the Federal Aviation Administration advances the safety of small airplanes, and the continued development of the general aviation industry, and for other purposes",Passed,223,0,0,10,188,0,0,12,0,0,0,0,411,0,0,22
356,R,113,H R 2611,16-Jul-2013,7:14 PM,On Motion to Suspend the Rules and Pass,"To designate the headquarters building of the Coast Guard on the campus located at 2701 Martin Luther King, Jr., Avenue Southeast in the District of Columbia as the “Douglas A. Munro Coast Guard Headquarters Building”, and for other purposes",Passed,223,0,0,10,188,0,0,12,0,0,0,0,411,0,0,22
357,R,113,H RES 300,17-Jul-2013,2:42 PM,On Ordering the Previous Question,"Providing for consideration of the bill (H.R. 2668) to delay the application of the individual health insurance mandate; and providing for consideration of the bill (H.R. 2667) to delay the application of the employer health insurance mandate, and for other purposes",Passed,229,0,0,4,1,192,0,7,0,0,0,0,230,192,0,11
358,R,113,H RES 300,17-Jul-2013,2:49 PM,On Agreeing to the Resolution,"Providing for consideration of the bill (H.R. 2668) to delay the application of the individual health insurance mandate; and providing for consideration of the bill (H.R. 2667) to delay the application of the employer health insurance mandate, and for other purposes",Passed,228,0,0,5,4,183,0,13,0,0,0,0,232,183,0,18
359,R,113,ADJOURN,17-Jul-2013,3:11 PM,On Motion to Adjourn,None,Failed,1,227,0,5,9,182,0,9,0,0,0,0,10,409,0,14
360,R,113,H R 2667,17-Jul-2013,6:26 PM,On Motion to Recommit with Instructions,Authority for Mandate Delay Act,Failed,0,227,0,6,188,3,0,9,0,0,0,0,188,230,0,15
361,R,113,H R 2667,17-Jul-2013,6:34 PM,On Passage,Authority for Mandate Delay Act,Passed,229,1,0,3,35,160,0,5,0,0,0,0,264,161,0,8
362,R,113,H R 2668,17-Jul-2013,6:51 PM,On Motion to Recommit with Instructions,Fairness for American Families Act,Failed,0,229,0,4,193,1,0,6,0,0,0,0,193,230,0,10
363,R,113,H R 2668,17-Jul-2013,6:58 PM,On Passage,Fairness for American Families Act,Passed,229,1,0,3,22,173,0,5,0,0,0,0,251,174,0,8
364,R,113,H RES 303,18-Jul-2013,2:16 PM,On Ordering the Previous Question,"Providing for consideration of H.R. 5, the Student Success Act",Passed,229,1,0,3,3,191,0,6,0,0,0,0,232,192,0,9
365,R,113,H RES 303,18-Jul-2013,2:24 PM,On Agreeing to the Resolution,"Providing for consideration of H.R. 5, the Student Success Act",Passed,227,1,0,5,3,189,0,8,0,0,0,0,230,190,0,13
366,R,113,JOURNAL,18-Jul-2013,2:32 PM,On Approving the Journal,None,Passed,159,70,0,4,119,73,1,7,0,0,0,0,278,143,1,11
367,R,113,H R 5,18-Jul-2013,6:06 PM,On Agreeing to the Amendment,None,Agreed to,70,160,0,3,193,1,0,6,0,0,0,0,263,161,0,9
368,R,113,H R 5,18-Jul-2013,6:11 PM,On Agreeing to the Amendment,None,Agreed to,230,1,0,2,11,181,0,8,0,0,0,0,241,182,0,10
369,R,113,H R 5,18-Jul-2013,6:16 PM,On Agreeing to the Amendment,None,Agreed to,230,2,0,1,9,185,0,6,0,0,0,0,239,187,0,7
370,R,113,H R 5,19-Jul-2013,10:45 AM,On Agreeing to the Amendment,None,Agreed to,227,4,0,2,0,192,0,8,0,0,0,0,227,196,0,10
371,R,113,H R 5,19-Jul-2013,10:49 AM,On Agreeing to the Amendment,None,Failed,2,229,0,2,184,8,0,8,0,0,0,0,186,237,0,10
372,R,113,H R 5,19-Jul-2013,10:54 AM,On Agreeing to the Amendment,None,Failed,1,231,0,1,192,2,0,6,0,0,0,0,193,233,0,7
373,R,113,H R 5,19-Jul-2013,11:13 AM,On Motion to Recommit with Instructions,"To support State and local accountability for public education, protect State and local authority, inform parents of the performance of their children’s schools, and for other purposes",Failed,1,231,0,1,195,0,0,5,0,0,0,0,196,231,0,6
374,R,113,H R 5,19-Jul-2013,11:19 AM,On Passage,"To support State and local accountability for public education, protect State and local authority, inform parents of the performance of their children’s schools, and for other purposes",Passed,221,12,0,1,0,195,0,5,0,0,0,0,221,207,0,6
375,R,113,H R 1542,22-Jul-2013,6:56 PM,On Motion to Suspend the Rules and Pass,WMD Intelligence and Information Sharing Act,Passed,215,2,0,16,173,1,0,26,0,0,0,0,388,3,0,42
376,R,113,H CON RES 44,22-Jul-2013,7:03 PM,On Motion to Suspend the Rules and Agree,Authorizing the use of the Capitol Grounds for the District of Columbia Special Olympics Law Enforcement Torch Run,Passed,213,0,0,20,175,0,0,25,0,0,0,0,388,0,0,45
377,R,113,H RES 312,23-Jul-2013,2:06 PM,On Ordering the Previous Question,"Providing for consideration of H.R. 2397, making appropriations for the Department of Defense, FY 2014; and H.R. 2610, making appropriations for the Departments of Transportation, and Housing and Urban Development, and related agencies, FY 2014",Passed,227,0,0,6,2,190,0,8,0,0,0,0,229,190,0,14
378,R,113,H RES 312,23-Jul-2013,2:14 PM,On Agreeing to the Resolution,"Providing for consideration of H.R. 2397, making appropriations for the Department of Defense, FY 2014; and H.R. 2610, making appropriations for the Departments of Transportation, and Housing and Urban Development, and related agencies, FY 2014",Passed,224,2,0,7,2,192,0,6,0,0,0,0,226,194,0,13
379,R,113,H R 2397,23-Jul-2013,6:40 PM,On Agreeing to the Amendment,None,Failed,4,224,0,5,46,148,0,6,0,0,0,0,50,372,0,11
380,R,113,H R 2397,23-Jul-2013,6:44 PM,On Agreeing to the Amendment,None,Failed,4,219,0,10,172,23,0,5,0,0,0,0,176,242,0,15
381,R,113,H R 2397,23-Jul-2013,6:48 PM,On Agreeing to the Amendment,None,Failed,5,218,0,10,136,54,0,10,0,0,0,0,141,272,0,20
382,R,113,H R 2397,23-Jul-2013,6:51 PM,On Agreeing to the Amendment,None,Failed,3,224,0,6,46,148,0,6,0,0,0,0,49,372,0,12
383,R,113,H R 2397,23-Jul-2013,6:55 PM,On Agreeing to the Amendment,None,Failed,89,137,0,7,4,190,0,6,0,0,0,0,93,327,0,13
384,R,113,H R 2397,23-Jul-2013,6:58 PM,On Agreeing to the Amendment,None,Failed,7,219,0,7,166,30,0,4,0,0,0,0,173,249,0,11
385,R,113,H R 2397,23-Jul-2013,7:02 PM,On Agreeing to the Amendment,None,Failed,4,222,0,7,171,25,0,4,0,0,0,0,175,247,0,11
386,R,113,H R 2397,23-Jul-2013,7:05 PM,On Agreeing to the Amendment,None,Failed,136,91,0,6,50,146,0,4,0,0,0,0,186,237,0,10
387,R,113,H R 2397,23-Jul-2013,7:22 PM,On Agreeing to the Amendment,None,Agreed to,142,84,0,7,141,55,0,4,0,0,0,0,283,139,0,11
388,R,113,H R 2397,23-Jul-2013,10:22 PM,On Agreeing to the Amendment,None,Failed,56,168,0,9,128,69,0,3,0,0,0,0,184,237,0,12
389,R,113,H R 2397,23-Jul-2013,10:28 PM,On Agreeing to the Amendment,None,Agreed to,104,122,0,7,145,51,0,4,0,0,0,0,249,173,0,11
390,R,113,H R 2397,23-Jul-2013,10:32 PM,On Agreeing to the Amendment,None,Agreed to,161,67,0,5,185,12,0,3,0,0,0,0,346,79,0,8
391,R,113,H R 2397,23-Jul-2013,10:36 PM,On Agreeing to the Amendment,None,Failed,44,185,0,4,106,91,0,3,0,0,0,0,150,276,0,7
392,R,113,H R 2397,23-Jul-2013,10:39 PM,On Agreeing to the Amendment,None,Agreed to,227,2,0,4,26,171,0,3,0,0,0,0,253,173,0,7
393,R,113,H R 2397,23-Jul-2013,10:44 PM,On Agreeing to the Amendment,None,Agreed to,197,32,0,4,135,62,0,3,0,0,0,0,332,94,0,7
394,R,113,H R 2397,23-Jul-2013,10:47 PM,On Agreeing to the Amendment,None,Agreed to,227,2,0,4,10,187,0,3,0,0,0,0,237,189,0,7
395,R,113,H R 2397,23-Jul-2013,10:50 PM,On Agreeing to the Amendment,None,Agreed to,142,87,0,4,191,6,0,3,0,0,0,0,333,93,0,7
396,R,113,H R 2397,23-Jul-2013,10:54 PM,On Agreeing to the Amendment,None,Failed,3,226,0,4,106,91,0,3,0,0,0,0,109,317,0,7
397,R,113,H R 2397,23-Jul-2013,10:57 PM,On Agreeing to the Amendment,None,Failed,1,228,0,4,141,55,0,4,0,0,0,0,142,283,0,8
398,R,113,H R 2397,23-Jul-2013,11:01 PM,On Agreeing to the Amendment,None,Failed,138,90,0,5,47,148,0,5,0,0,0,0,185,238,0,10
399,R,113,H RES 315,24-Jul-2013,2:13 PM,On Ordering the Previous Question,"Providing for consideration of H.R. 2218, the Coal Residuals Reuse and Management Act and H.R. 1582, the Energy Consumers Relief Act",Passed,224,0,0,9,0,191,0,9,0,0,0,0,224,191,0,18
400,R,113,H RES 315,24-Jul-2013,2:22 PM,On Agreeing to the Resolution,"Providing for consideration of H.R. 2218, the Coal Residuals Reuse and Management Act and H.R. 1582, the Energy Consumers Relief Act",Passed,225,0,0,8,7,188,0,5,0,0,0,0,232,188,0,13
401,R,113,H R 2397,24-Jul-2013,2:29 PM,On Agreeing to the Amendment,None,Failed,77,150,0,6,100,96,0,4,0,0,0,0,177,246,0,10
402,R,113,H R 2397,24-Jul-2013,2:33 PM,On Agreeing to the Amendment,None,Agreed to,223,4,0,6,12,184,0,4,0,0,0,0,235,188,0,10
403,R,113,H R 2397,24-Jul-2013,2:38 PM,On Agreeing to the Amendment,None,Agreed to,38,188,0,7,177,18,0,5,0,0,0,0,215,206,0,12
404,R,113,H R 2397,24-Jul-2013,2:43 PM,On Agreeing to the Amendment,None,Failed,125,102,0,6,12,184,0,4,0,0,0,0,137,286,0,10
405,R,113,H R 2397,24-Jul-2013,2:47 PM,On Agreeing to the Amendment,None,Agreed to,224,3,0,6,14,182,0,4,0,0,0,0,238,185,0,10
406,R,113,H R 2397,24-Jul-2013,2:57 PM,On Agreeing to the Amendment,None,Agreed to,117,110,0,6,147,44,0,9,0,0,0,0,264,154,0,15
407,R,113,H R 2397,24-Jul-2013,5:22 PM,On Agreeing to the Amendment,None,Agreed to,82,142,0,9,195,0,0,5,0,0,0,0,277,142,0,14
408,R,113,H R 2397,24-Jul-2013,5:27 PM,On Agreeing to the Amendment,None,Failed,6,220,0,7,170,22,0,8,0,0,0,0,176,242,0,15
409,R,113,H R 2397,24-Jul-2013,5:32 PM,On Agreeing to the Amendment,None,Failed,9,219,0,5,178,18,0,4,0,0,0,0,187,237,0,9
410,R,113,H R 2397,24-Jul-2013,5:37 PM,On Agreeing to the Amendment,None,Failed,30,197,0,6,155,39,0,6,0,0,0,0,185,236,0,12
411,R,113,H R 2397,24-Jul-2013,6:47 PM,On Agreeing to the Amendment,None,Agreed to,227,0,0,6,182,12,0,6,0,0,0,0,409,12,0,12
412,R,113,H R 2397,24-Jul-2013,6:51 PM,On Agreeing to the Amendment,None,Failed,94,134,0,6,111,83,0,6,0,0,0,0,205,217,0,12
413,R,113,H R 2397,24-Jul-2013,7:15 PM,On Motion to Recommit with Instructions,"Making appropriations for the Department of Defense for fiscal year ending September 30, 2014, and for other purposes",Failed,1,227,0,5,191,4,0,5,0,0,0,0,192,231,0,10
414,R,113,H R 2397,24-Jul-2013,7:30 PM,On Passage,"Making appropriations for the Department of Defense for fiscal year ending September 30, 2014, and for other purposes",Passed,220,8,0,5,95,101,0,4,0,0,0,0,315,109,0,9
415,R,113,H R 2218,25-Jul-2013,11:06 AM,On Agreeing to the Amendment,None,Failed,2,223,0,8,183,8,0,9,0,0,0,0,185,231,0,17
416,R,113,H R 2218,25-Jul-2013,11:10 AM,On Agreeing to the Amendment,None,Failed,1,223,0,9,175,16,0,9,0,0,0,0,176,239,0,18
417,R,113,H R 2218,25-Jul-2013,11:29 AM,On Motion to Recommit with Instructions,To amend subtitle D of the Solid Waste Disposal Act to encourage recovery and beneficial use of coal combustion residuals and establish requirements for the proper management and disposal of coal combustion residuals that are protective of human health and the environment,Failed,0,225,1,7,192,0,0,8,0,0,0,0,192,225,1,15
418,R,113,H R 2218,25-Jul-2013,11:39 AM,On Passage,To amend subtitle D of the Solid Waste Disposal Act to encourage recovery and beneficial use of coal combustion residuals and establish requirements for the proper management and disposal of coal combustion residuals that are protective of human health and the environment,Passed,226,2,0,5,39,153,0,8,0,0,0,0,265,155,0,13
419,R,113,H R 2610,30-Jul-2013,7:01 PM,On Agreeing to the Amendment,None,Agreed to,132,92,0,9,185,0,0,15,0,0,0,0,317,92,0,24
420,R,113,H R 2610,30-Jul-2013,7:05 PM,On Agreeing to the Amendment,None,Agreed to,81,143,0,9,158,32,0,10,0,0,0,0,239,175,0,19
421,R,113,H R 2610,30-Jul-2013,7:10 PM,On Agreeing to the Amendment,None,Failed,137,88,0,8,54,136,0,10,0,0,0,0,191,224,0,18
422,R,113,H R 2610,30-Jul-2013,7:13 PM,On Agreeing to the Amendment,None,Failed,151,73,0,9,15,175,0,10,0,0,0,0,166,248,0,19
423,R,113,H R 2610,30-Jul-2013,7:17 PM,On Agreeing to the Amendment,None,Failed,9,213,0,11,145,45,0,10,0,0,0,0,154,258,0,21
424,R,113,H R 2610,30-Jul-2013,7:20 PM,On Agreeing to the Amendment,None,Failed,8,213,0,12,101,87,0,12,0,0,0,0,109,300,0,24
425,R,113,H R 2610,30-Jul-2013,7:29 PM,On Agreeing to the Amendment,None,Failed,9,215,0,9,107,80,0,13,0,0,0,0,116,295,0,22
426,R,113,H R 1911,31-Jul-2013,6:21 PM,On Motion to Suspend the Rules and Concur in the Senate Amendment,Smarter Solutions for Students Act,Passed,221,6,0,6,171,25,0,4,0,0,0,0,392,31,0,10
427,R,113,H R 850,31-Jul-2013,6:34 PM,"On Motion to Suspend the Rules and Pass, as Amended",Nuclear Iran Prevention Act of 2013,Passed,222,3,0,9,178,17,1,4,0,0,0,0,400,20,1,13
428,R,113,H R 1582,1-Aug-2013,3:02 PM,On Agreeing to the Amendment,None,Failed,1,222,0,10,182,8,0,10,0,0,0,0,183,230,0,20
429,R,113,H R 1582,1-Aug-2013,3:08 PM,On Agreeing to the Amendment,None,Failed,1,219,0,13,181,5,0,14,0,0,0,0,182,224,0,27
430,R,113,H R 1582,1-Aug-2013,3:13 PM,On Agreeing to the Amendment,None,Agreed to,219,3,0,11,15,175,0,10,0,0,0,0,234,178,0,21
431,R,113,H R 1582,1-Aug-2013,3:32 PM,On Motion to Recommit with Instructions,Energy Consumers Relief Act of 2013,Failed,0,221,0,12,188,0,0,12,0,0,0,0,188,221,0,24
432,R,113,H R 1582,1-Aug-2013,3:39 PM,On Passage,Energy Consumers Relief Act of 2013,Passed,223,0,0,10,9,181,0,10,0,0,0,0,232,181,0,20
433,R,113,H RES 322,1-Aug-2013,3:47 PM,On Ordering the Previous Question,"Providing for consideration of H.R. 367, REINS Act of 2013; providing for consideration of H.R. 2009, Keep the IRS Off Your Health Care Act of 2013; providing for proceedings during the period from August 3, 2013, through September 6, 2013; and providing for consideration of H.R. 2879, Stop Government Abuse Act",Passed,222,1,0,10,0,190,0,10,0,0,0,0,222,191,0,20
434,R,113,H RES 322,1-Aug-2013,3:54 PM,On Agreeing to the Resolution,"Providing for consideration of H.R. 367, REINS Act of 2013; providing for consideration of H.R. 2009, Keep the IRS Off Your Health Care Act of 2013; providing for proceedings during the period from August 3, 2013, through September 6, 2013; and providing for consideration of H.R. 2879, Stop Government Abuse Act",Passed,221,2,0,10,2,187,0,11,0,0,0,0,223,189,0,21
435,R,113,H R 1897,1-Aug-2013,4:12 PM,"On Motion to Suspend the Rules and Pass, as Amended",Vietnam Human Rights Act of 2013,Passed,220,2,0,11,185,1,0,14,0,0,0,0,405,3,0,25
436,R,113,H R 2879,1-Aug-2013,5:49 PM,On Passage,Stop Government Abuse Act,Passed,224,2,0,7,15,174,0,11,0,0,0,0,239,176,0,18
437,R,113,H R 367,2-Aug-2013,9:41 AM,On Agreeing to the Amendment,None,Agreed to,225,0,0,8,12,176,0,12,0,0,0,0,237,176,0,20
438,R,113,H R 367,2-Aug-2013,9:46 AM,On Agreeing to the Amendment,None,Agreed to,221,2,0,10,6,183,0,11,0,0,0,0,227,185,0,21
439,R,113,H R 367,2-Aug-2013,9:50 AM,On Agreeing to the Amendment,None,Agreed to,227,0,0,6,36,152,0,12,0,0,0,0,263,152,0,18
440,R,113,H R 367,2-Aug-2013,9:53 AM,On Agreeing to the Amendment,None,Failed,5,221,0,7,181,8,0,11,0,0,0,0,186,229,0,18
441,R,113,H R 367,2-Aug-2013,9:56 AM,On Agreeing to the Amendment,None,Failed,1,226,0,6,181,9,0,10,0,0,0,0,182,235,0,16
442,R,113,H R 367,2-Aug-2013,9:59 AM,On Agreeing to the Amendment,None,Failed,0,228,0,5,185,4,0,11,0,0,0,0,185,232,0,16
443,R,113,H R 367,2-Aug-2013,10:03 AM,On Agreeing to the Amendment,None,Failed,2,224,0,7,188,2,0,10,0,0,0,0,190,226,0,17
444,R,113,H R 367,2-Aug-2013,10:22 AM,On Motion to Recommit with Instructions,Regulations From the Executive in Need of Scrutiny Act,Failed,0,227,0,6,185,2,0,13,0,0,0,0,185,229,0,19
445,R,113,H R 367,2-Aug-2013,10:28 AM,On Passage,Regulations From the Executive in Need of Scrutiny Act,Passed,226,0,0,7,6,183,0,11,0,0,0,0,232,183,0,18
446,R,113,H R 2009,2-Aug-2013,12:16 PM,On Motion to Recommit with Instructions,Keep the IRS Off Your Health Care Act of 2013,Failed,0,228,0,5,186,2,0,12,0,0,0,0,186,230,0,17
447,R,113,H R 2009,2-Aug-2013,12:24 PM,On Passage,Keep the IRS Off Your Health Care Act of 2013,Passed,228,0,0,5,4,185,0,11,0,0,0,0,232,185,0,16
448,R,113,H R 2052,9-Sep-2013,7:11 PM,"On Motion to Suspend the Rules and Pass, as Amended",Global Investment in American Jobs Act of 2013,Passed,194,32,0,6,185,0,1,14,0,0,0,0,379,32,1,20
449,R,113,H R 2844,9-Sep-2013,7:25 PM,"On Motion to Suspend the Rules and Pass, as Amended",Federal Communications Commission Consolidated Reporting Act of 2013,Passed,227,0,0,5,188,0,0,12,0,0,0,0,415,0,0,17
450,R,113,H R 1155,10-Sep-2013,2:04 PM,"On Motion to Suspend the Rules and Pass, as Amended",National Association of Registered Agents and Brokers Reform Act,Passed,221,6,0,5,176,0,0,24,0,0,0,0,397,6,0,29
451,R,113,H R 2747,10-Sep-2013,2:15 PM,On Motion to Suspend the Rules and Pass,Streamlining Claims Processing for Federal Contractor Employees Act,Passed,218,10,0,4,178,0,0,22,0,0,0,0,396,10,0,26
452,R,113,S 130,10-Sep-2013,2:24 PM,On Motion to Suspend the Rules and Pass,Powell Shooting Range Land Conveyance Act,Passed,226,1,0,5,182,0,0,18,0,0,0,0,408,1,0,23
453,R,113,S 304,10-Sep-2013,4:56 PM,On Motion to Suspend the Rules and Pass,Natchez Trace Parkway Land Conveyance Act,Passed,226,1,0,5,193,0,0,7,0,0,0,0,419,1,0,12
454,R,113,S 256,10-Sep-2013,5:07 PM,On Motion to Suspend the Rules and Pass,"To amend Public Law 93-435 with respect to the Northern Mariana Islands, providing parity with Guam, the Virgin Islands, and American Samoa",Passed,227,0,0,5,188,0,0,12,0,0,0,0,415,0,0,17
455,R,113,S 459,10-Sep-2013,5:14 PM,On Motion to Suspend the Rules and Pass,Minuteman Missile National Historic Site Boundary Modification Act,Passed,222,5,0,5,192,0,0,8,0,0,0,0,414,5,0,13
456,R,113,H RES 339,11-Sep-2013,2:37 PM,On Ordering the Previous Question,"Providing for consideration of H.R. 2775, to condition the provision of premium and cost-sharing subsidies under the Patient Protection and Affordable Care Act upon a certification that a program to verify household income and other qualifications for such subsidies is operational, and for other purposes",Passed,227,0,0,5,0,196,0,4,0,0,0,0,227,196,0,9
457,R,113,H RES 339,11-Sep-2013,2:46 PM,On Agreeing to the Resolution,"Providing for consideration of H.R. 2775, to condition the provision of premium and cost-sharing subsidies under the Patient Protection and Affordable Care Act upon a certification that a program to verify household income and other qualifications for such subsidies is operational, and for other purposes",Passed,227,0,0,5,1,195,0,4,0,0,0,0,228,195,0,9
458,R,113,H R 2775,12-Sep-2013,11:01 AM,On Passage,"To condition the provision of premium and cost-sharing subsidies under the Patient Protection and Affordable Care Act upon a certification that a program to verify household income and other qualifications for such subsidies is operational, and for other purposes",Passed,230,0,0,2,5,191,0,4,0,0,0,0,235,191,0,6
459,R,113,JOURNAL,12-Sep-2013,11:11 AM,On Approving the Journal,None,Passed,138,78,0,16,115,69,1,15,0,0,0,0,253,147,1,31
460,R,113,H R 3092,17-Sep-2013,6:56 PM,"On Motion to Suspend the Rules and Pass, as Amended","“E. Clay Shaw, Jr. Missing Children’s Assistance Reauthorization Act of 2013”",Passed,221,2,0,9,186,0,0,14,0,0,0,0,407,2,0,23
461,R,113,H R 2449,17-Sep-2013,7:02 PM,On Motion to Suspend the Rules and Pass,"To authorize the President to extend the term of the Agreement for Cooperation between the Government of the United States of America and the Government of the Republic of Korea Concerning Civil Uses of Nuclear Energy for a period not to exceed March 19, 2016",Passed,224,0,0,8,183,0,0,17,0,0,0,0,407,0,0,25
462,R,113,S 793,17-Sep-2013,7:14 PM,"On Motion to Suspend the Rules and Pass, as Amended",Organization of American States Revitalization and Reform Act,Passed,202,24,0,6,181,0,0,19,0,0,0,0,383,24,0,25
463,R,113,H RES 347,18-Sep-2013,1:38 PM,On Ordering the Previous Question,"Providing for consideration of H.R. 761, the National Strategic and Critical Minerals Production Act of 2013",Passed,229,0,0,3,0,192,0,8,0,0,0,0,229,192,0,11
464,R,113,H RES 347,18-Sep-2013,1:45 PM,On Agreeing to the Resolution,"Providing for consideration of H.R. 761, the National Strategic and Critical Minerals Production Act of 2013",Passed,228,0,0,4,3,190,0,7,0,0,0,0,231,190,0,11
465,R,113,H R 301,18-Sep-2013,1:53 PM,"On Motion to Suspend the Rules and Pass, as Amended",To provide for the establishment of the Special Envoy to Promote Religious Freedom of Religious Minorities in the Near East and South Central Asia,Passed,207,21,0,4,195,1,0,4,0,0,0,0,402,22,0,8
466,R,113,H R 761,18-Sep-2013,4:59 PM,On Agreeing to the Amendment,None,Failed,0,231,0,1,187,10,0,3,0,0,0,0,187,241,0,4
467,R,113,H R 761,18-Sep-2013,5:06 PM,On Agreeing to the Amendment,None,Failed,1,229,0,2,188,8,0,4,0,0,0,0,189,237,0,6
468,R,113,H R 761,18-Sep-2013,5:12 PM,On Agreeing to the Amendment,None,Failed,0,230,0,2,186,10,0,4,0,0,0,0,186,240,0,6
469,R,113,H R 761,18-Sep-2013,5:17 PM,On Agreeing to the Amendment,None,Failed,1,230,0,1,190,5,0,5,0,0,0,0,191,235,0,6
470,R,113,H R 761,18-Sep-2013,5:35 PM,On Motion to Recommit with Instructions,National Strategic and Critical Minerals Production Act of 2013,Failed,1,229,0,2,196,0,0,4,0,0,0,0,197,229,0,6
471,R,113,H R 761,18-Sep-2013,5:42 PM,On Passage,National Strategic and Critical Minerals Production Act of 2013,Passed,231,0,0,1,15,178,0,7,0,0,0,0,246,178,0,8
472,R,113,H RES 352,19-Sep-2013,3:41 PM,On Ordering the Previous Question,"Providing for consideration of the joint resolution (H.J.Res. 59) making continuing appropriations for fiscal year 2014, and for other purposes, and providing for consideration of motions to suspend the rules",Passed,230,0,0,2,2,193,0,5,0,0,0,0,232,193,0,7
473,R,113,H RES 352,19-Sep-2013,3:47 PM,On Agreeing to the Resolution,"Providing for consideration of the joint resolution (H.J.Res. 59) making continuing appropriations for fiscal year 2014, and for other purposes, and providing for consideration of motions to suspend the rules",Passed,229,0,0,3,1,192,0,7,0,0,0,0,230,192,0,10
474,R,113,H RES 351,19-Sep-2013,3:54 PM,On Agreeing to the Resolution,"Providing for consideration of H.R. 687, the Southeast Arizona Land Exchange and Conservation Act of 2013; H.R. 1526, the Restoring Healthy Forests for Healthy Communities Act; and H.R. 3102, the Nutrition Reform and Work Opportunity Act of 2013",Passed,229,1,0,2,2,192,0,6,0,0,0,0,231,193,0,8
475,R,113,H R 3102,19-Sep-2013,5:59 PM,On Motion to Recommit with Instructions,Nutrition Reform and Work Opportunity Act,Failed,1,230,0,1,192,0,0,8,0,0,0,0,193,230,0,9
476,R,113,H R 3102,19-Sep-2013,6:07 PM,On Passage,Nutrition Reform and Work Opportunity Act,Passed,217,15,0,1,0,195,0,5,0,0,0,0,217,210,0,6
477,R,113,H J RES 59,20-Sep-2013,11:12 AM,On Motion to Recommit with Instructions,"Making continuing appropriations for fiscal year 2014, and for other purposes",Failed,1,228,0,3,189,0,0,11,0,0,0,0,190,228,0,14
478,R,113,H J RES 59,20-Sep-2013,11:19 AM,On Passage,"Making continuing appropriations for fiscal year 2014, and for other purposes",Passed,228,1,0,3,2,188,0,10,0,0,0,0,230,189,0,13
479,R,113,H R 1526,20-Sep-2013,11:43 AM,On Agreeing to the Amendment,None,Agreed to,217,9,0,6,2,187,0,11,0,0,0,0,219,196,0,17
480,R,113,H R 1526,20-Sep-2013,11:47 AM,On Agreeing to the Amendment,None,Agreed to,226,2,0,4,17,170,0,13,0,0,0,0,243,172,0,17
481,R,113,H R 1526,20-Sep-2013,11:52 AM,On Agreeing to the Amendment,None,Agreed to,227,1,0,4,22,165,0,13,0,0,0,0,249,166,0,17
482,R,113,H R 1526,20-Sep-2013,12:11 PM,On Motion to Recommit with Instructions,Restoring Healthy Forests for Healthy Communities Act,Failed,0,228,0,4,190,0,0,10,0,0,0,0,190,228,0,14
483,R,113,H R 1526,20-Sep-2013,12:17 PM,On Passage,Restoring Healthy Forests for Healthy Communities Act,Passed,227,1,0,4,17,172,0,11,0,0,0,0,244,173,0,15
484,R,113,H R 1961,25-Sep-2013,6:55 PM,On Motion to Suspend the Rules and Pass,"To amend title 46, United States Code, to extend the exemption from the fire-retardant materials construction requirement for vessels operating within the Boundary Line",Passed,198,5,0,29,82,84,0,34,0,0,0,0,280,89,0,63
485,R,113,H RES 354,25-Sep-2013,7:08 PM,On Motion to Suspend the Rules and Agree,"Providing for the concurrence by the House in the Senate amendment to H.R. 527, with an amendment",Passed,199,0,0,33,168,0,0,32,0,0,0,0,367,0,0,65
486,R,113,H R 3095,26-Sep-2013,1:10 PM,On Motion to Suspend the Rules and Pass,"To ensure any new or revised requirement providing for the screening, testing, or treatment of individuals operating commercial motor vehicles for sleep disorders is adopted pursuant to a rulemaking proceeding, and for other purposes",Passed,222,0,0,10,183,0,0,17,0,0,0,0,405,0,0,27
487,R,113,H R 2600,26-Sep-2013,1:23 PM,On Motion to Suspend the Rules and Pass,To amend the Interstate Land Sales Full Disclosure Act to clarify how the Act applies to condominiums,Passed,224,0,0,8,186,0,0,14,0,0,0,0,410,0,0,22
488,R,113,JOURNAL,26-Sep-2013,1:30 PM,On Approving the Journal,None,Passed,141,76,1,14,119,61,1,19,0,0,0,0,260,137,2,33
489,R,113,H R 687,26-Sep-2013,3:24 PM,On Agreeing to the Amendment,None,Failed,2,218,0,12,178,9,0,13,0,0,0,0,180,227,0,25
490,R,113,H R 687,26-Sep-2013,3:33 PM,On Agreeing to the Amendment,None,Failed,6,216,0,10,185,1,0,14,0,0,0,0,191,217,0,24
491,R,113,H R 1412,27-Sep-2013,10:21 AM,On Motion to Suspend the Rules and Concur in the Senate Amendments,Improving Job Opportunities for Veterans Act,Passed,222,0,0,9,180,0,0,20,0,0,0,0,402,0,0,29
492,R,113,H R 3096,27-Sep-2013,10:36 AM,On Motion to Suspend the Rules and Pass,"To designate the building occupied by the Federal Bureau of Investigation located at 801 Follin Lane, Vienna, Virginia, as the “Michael D. Resnick Terrorist Screening Center”",Passed,219,2,0,10,184,0,0,16,0,0,0,0,403,2,0,26
493,R,113,H RES 361,28-Sep-2013,1:43 PM,On Agreeing to the Resolution,"Waiving a requirement of clause 6(a) of rule XIII with respect to consideration of certain resolutions reported from the Committee on Rules, and relating to consideration of the Senate amendment to H.R. 2642, to provide for the reform of agricultural programs of the Department of Agriculture through fiscal year 2018",Passed,222,4,0,5,4,187,0,9,0,0,0,0,226,191,0,14
494,R,113,H RES 366,28-Sep-2013,9:18 PM,On Ordering the Previous Question,"Providing for consideration of the Senate amendment to the joint resolution (H.J.Res. 59) making continuing appropriations for fiscal year 2014, and for other purposes, and providing for consideration of the bill (H.R. 3210) making continuing appropriations for military pay in the event of a Government shutdown",Passed,229,0,0,2,0,192,0,8,0,0,0,0,229,192,0,10
495,R,113,H RES 366,28-Sep-2013,9:25 PM,On Agreeing to the Resolution,"Providing for consideration of the Senate amendment to the joint resolution (H.J.Res. 59) making continuing appropriations for fiscal year 2014, and for other purposes, and providing for consideration of the bill (H.R. 3210) making continuing appropriations for military pay in the event of a Government shutdown",Passed,229,0,0,2,2,191,0,7,0,0,0,0,231,191,0,9
496,R,113,H R 2251,28-Sep-2013,9:32 PM,"On Motion to Suspend the Rules and Pass, as Amended","To designate the United States courthouse located at 118 South Mill Street, in Fergus Falls, Minnesota, as the “Edward J. Devitt United States Courthouse”",Passed,225,3,0,3,191,1,0,8,0,0,0,0,416,4,0,11
497,R,113,H J RES 59,29-Sep-2013,12:10 AM,On concurring in the Senate amendment with amendment # 1,"Making continuing appropriations for fiscal year 2014, and for other purposes",Passed,231,0,0,0,17,174,0,9,0,0,0,0,248,174,0,9
498,R,113,H J RES 59,29-Sep-2013,12:16 AM,On concurring in the Senate amendment with amendment # 2,"Making continuing appropriations for fiscal year 2014, and for other purposes",Passed,229,2,0,0,2,190,0,8,0,0,0,0,231,192,0,8
499,R,113,H R 3210,29-Sep-2013,12:22 AM,On Passage,Making continuing appropriations for military pay in the event of a Government shutdown.,Passed,231,0,0,0,192,0,0,8,0,0,0,0,423,0,0,8
500,R,113,H R 2848,29-Sep-2013,12:29 AM,"On Motion to Suspend the Rules and Pass, as Amended","Department of State Operations and Embassy Security Authorization Act, Fiscal Year 2014",Passed,194,35,0,2,190,2,0,8,0,0,0,0,384,37,0,10
501,R,113,H RES 367,30-Sep-2013,7:08 PM,On Ordering the Previous Question,"Providing for consideration of the Senate amendment to the joint resolution (H.J.Res. 59) making continuing appropriations for fiscal year 2014, and for other purposes, and waiving a requirement of clause 6(a) of rule XIII with respect to consideration of certain resolutions reported from the Committee on Rules",Passed,229,1,0,1,0,197,0,3,0,0,0,0,229,198,0,4
502,R,113,H RES 367,30-Sep-2013,7:15 PM,On Agreeing to the Resolution,"Providing for consideration of the Senate amendment to the joint resolution (H.J.Res. 59) making continuing appropriations for fiscal year 2014, and for other purposes, and waiving a requirement of clause 6(a) of rule XIII with respect to consideration of certain resolutions reported from the Committee on Rules",Passed,225,6,0,0,0,198,0,2,0,0,0,0,225,204,0,2
503,R,113,S 1348,30-Sep-2013,7:22 PM,On Motion to Suspend the Rules and Pass,Congressional Award Program Reauthorization Act of 2013,Passed,192,35,0,4,195,0,0,5,0,0,0,0,387,35,0,9
504,R,113,H J RES 59,30-Sep-2013,8:40 PM,"On Receding from the House Amdts, and Concurring in the Senate Amdt with Amdt","Making continuing appropriations for fiscal year 2014, and for other purposes",Passed,219,12,0,1,9,189,0,2,0,0,0,0,228,201,0,3
505,R,113,H RES 368,1-Oct-2013,1:10 AM,On Agreeing to the Resolution,"Relating to consideration of the joint resolution (H.J. Res. 59) making continuing appropriations for fiscal year 2014, and for other purposes",Passed,221,9,0,1,7,190,0,3,0,0,0,0,228,199,0,4
506,R,113,H J RES 72,1-Oct-2013,7:44 PM,On Motion to Suspend the Rules and Pass,"Making continuing appropriations for veterans benefits for fiscal year 2014, and for other purposes",Failed,231,0,0,1,33,164,0,3,0,0,0,0,264,164,0,4
507,R,113,H J RES 71,1-Oct-2013,7:54 PM,On Motion to Suspend the Rules and Pass,Making continuing appropriations of local funds of the District of Columbia for fiscal year 2014,Failed,231,0,0,1,34,163,0,3,0,0,0,0,265,163,0,4
508,R,113,H J RES 70,1-Oct-2013,8:01 PM,On Motion to Suspend the Rules and Pass,"Making continuing appropriations for National Park Service operations, the Smithsonian Institution, the National Gallery of Art, and the United States Holocaust Memorial Museum for fiscal year 2014, and for other purposes",Failed,230,1,0,1,22,175,0,3,0,0,0,0,252,176,0,4
509,R,113,H RES 370,2-Oct-2013,3:18 PM,On Ordering the Previous Question,"Providing for consideration of H.J. Res. 70, H.J. Res. 71, H.J. Res. 72, H.J. Res. 73, and H.R. 3230",Passed,227,0,0,4,0,197,0,3,0,0,0,0,227,197,0,7
510,R,113,H RES 370,2-Oct-2013,3:27 PM,On Agreeing to the Resolution,"Providing for consideration of H.J. Res. 70, H.J. Res. 71, H.J. Res. 72, H.J. Res. 73, and H.R. 3230",Passed,228,1,0,2,0,197,0,3,0,0,0,0,228,198,0,5
511,R,113,JOURNAL,2-Oct-2013,3:35 PM,On Approving the Journal,None,Passed,156,70,1,4,90,103,1,6,0,0,0,0,246,173,2,10
512,R,113,H J RES 70,2-Oct-2013,6:28 PM,On Motion to Table the Appeal of the Ruling of the Chair,"Making continuing appropriations for National Park Service operations, the Smithsonian Institution, the National Gallery of Art, and the United States Holocaust Memorial Museum for fiscal year 2014, and for other purposes",Passed,230,0,0,1,0,194,0,6,0,0,0,0,230,194,0,7
513,R,113,H J RES 70,2-Oct-2013,6:34 PM,On Passage,"Making continuing appropriations for National Park Service operations, the Smithsonian Institution, the National Gallery of Art, and the United States Holocaust Memorial Museum for fiscal year 2014, and for other purposes",Passed,229,1,0,1,23,172,0,5,0,0,0,0,252,173,0,6
514,R,113,H J RES 73,2-Oct-2013,6:48 PM,On Passage,"Making continuing appropriations for the National Institutes of Health for fiscal year 2014, and for other purposes",Passed,229,1,0,1,25,170,0,5,0,0,0,0,254,171,0,6
515,R,113,H R 3230,3-Oct-2013,1:48 PM,Table Appeal of the Ruling of the Chair,Pay Our Guard and Reserve Act,Passed,228,0,0,3,0,194,0,6,0,0,0,0,228,194,0,9
516,R,113,H R 3230,3-Oct-2013,1:57 PM,On Passage,Pay Our Guard and Reserve Act,Passed,229,0,0,2,36,160,0,4,0,0,0,0,265,160,0,6
517,R,113,H J RES 72,3-Oct-2013,4:34 PM,Table Appeal of the Ruling of the Chair,"Making continuing appropriations for veterans benefits for fiscal year 2014, and for other purposes",Passed,225,0,0,6,0,193,0,7,0,0,0,0,225,193,0,13
518,R,113,H J RES 72,3-Oct-2013,4:48 PM,On Passage,"Making continuing appropriations for veterans benefits for fiscal year 2014, and for other purposes",Passed,224,0,0,7,35,157,0,8,0,0,0,0,259,157,0,15
519,R,113,H RES 371,4-Oct-2013,2:53 PM,On Ordering the Previous Question,"Providing for consideration of the joint resolution (H.J. Res. 75) making continuing appropriations for the Special Supplemental Nutrition Program for Women, Infants, and Children for fiscal year 2014, and for other purposes; providing for consideration of motions to suspend the rules; and for other purposes",Passed,223,0,0,8,0,184,0,16,0,0,0,0,223,184,0,24
520,R,113,H RES 371,4-Oct-2013,3:01 PM,On Agreeing to the Resolution,"Providing for consideration of the joint resolution (H.J. Res. 75) making continuing appropriations for the Special Supplemental Nutrition Program for Women, Infants, and Children for fiscal year 2014, and for other purposes; providing for consideration of motions to suspend the rules; and for other purposes",Passed,222,1,0,8,0,182,0,18,0,0,0,0,222,183,0,26
521,R,113,H J RES 85,4-Oct-2013,4:26 PM,On Motion to Table the Appeal of the Ruling of the Chair,"Making continuing appropriations for the Federal Emergency Management Agency for fiscal year 2014, and for other purposes",Passed,224,0,0,7,0,185,0,15,0,0,0,0,224,185,0,22
522,R,113,H J RES 85,4-Oct-2013,4:33 PM,On Passage,"Making continuing appropriations for the Federal Emergency Management Agency for fiscal year 2014, and for other purposes",Passed,224,0,0,7,23,164,0,13,0,0,0,0,247,164,0,20
523,R,113,H J RES 75,4-Oct-2013,6:01 PM,Table Appeal of the Ruling of the Chair,"Making continuing appropriations for the Special Supplemental Nutrition Program for Women, Infants, and Children for fiscal year 2014, and for other purposes",Passed,223,0,0,8,0,185,0,15,0,0,0,0,223,185,0,23
524,R,113,H J RES 75,4-Oct-2013,6:08 PM,On Passage,"Making continuing appropriations for the Special Supplemental Nutrition Program for Women, Infants, and Children for fiscal year 2014, and for other purposes",Passed,222,0,0,9,22,164,0,14,0,0,0,0,244,164,0,23
525,R,113,H R 3223,5-Oct-2013,10:57 AM,On Passage,To provide for the compensation of furloughed Federal employees,Passed,218,0,0,13,189,0,0,11,0,0,0,0,407,0,0,24
526,R,113,H CON RES 58,5-Oct-2013,11:13 AM,On Motion to Suspend the Rules and Agree,Expressing the sense of Congress regarding the need for the continued availability of religious services to members of the Armed Forces and their families during a lapse in appropriations,Passed,216,0,0,15,184,1,0,15,0,0,0,0,400,1,0,30
527,R,113,H J RES 77,7-Oct-2013,7:06 PM,Table Appeal of the Ruling of the Chair,"Making continuing appropriations for the Food and Drug Administration for fiscal year 2014, and for other purposes",Passed,217,0,0,14,0,182,0,18,0,0,0,0,217,182,0,32
528,R,113,H J RES 77,7-Oct-2013,7:14 PM,On Passage,"Making continuing appropriations for the Food and Drug Administration for fiscal year 2014, and for other purposes",Passed,215,1,0,15,20,161,0,19,0,0,0,0,235,162,0,34
529,R,113,H J RES 84,8-Oct-2013,1:49 PM,Table Appeal of the Ruling of the Chair,"Making continuing appropriations for Head Start for fiscal year 2014, and for other puposes",Passed,226,0,0,5,0,191,0,9,0,0,0,0,226,191,0,14
530,R,113,H J RES 84,8-Oct-2013,1:56 PM,On Passage,"Making continuing appropriations for Head Start for fiscal year 2014, and for other puposes",Passed,225,2,0,4,23,166,0,11,0,0,0,0,248,168,0,15
531,R,113,H RES 373,8-Oct-2013,5:27 PM,On Ordering the Previous Question,"Providing for consideration of H.J. Res. 89, Excepted Employees’ Pay Continuing Appropriations Resolution, 2014; consideration of H.R. 3273, Deficit Reduction and Economic Growth Working Group Act of 2013; and consideration of H.J. Res. 90, Federal Aviation Administration Continuing Appropriations Resolution, 2014",Passed,226,0,0,5,0,186,0,14,0,0,0,0,226,186,0,19
532,R,113,H RES 373,8-Oct-2013,5:35 PM,On Agreeing to the Resolution,"Providing for consideration of H.J. Res. 89, Excepted Employees’ Pay Continuing Appropriations Resolution, 2014; consideration of H.R. 3273, Deficit Reduction and Economic Growth Working Group Act of 2013; and consideration of H.J. Res. 90, Federal Aviation Administration Continuing Appropriations Resolution, 2014",Passed,226,0,0,5,1,186,0,13,0,0,0,0,227,186,0,18
533,R,113,H R 3273,8-Oct-2013,7:33 PM,Table Appeal of the Ruling of the Chair,Deficit Reduction and Economic Growth Working Group Act,Passed,227,0,0,4,0,194,0,6,0,0,0,0,227,194,0,10
534,R,113,H R 3273,8-Oct-2013,7:40 PM,On Passage,Deficit Reduction and Economic Growth Working Group Act,Passed,222,5,0,4,2,192,0,6,0,0,0,0,224,197,0,10
535,R,113,H J RES 89,8-Oct-2013,7:48 PM,On Passage,"Making appropriations for the salaries and related expenses of certain Federal employees during a lapse in funding authority for fiscal year 2014, and for other purposes",Passed,226,0,0,5,194,0,0,6,0,0,0,0,420,0,0,11
536,R,113,H J RES 90,9-Oct-2013,2:12 PM,Table Appeal of the Ruling of the Chair,"Making continuing appropriations for the Federal Aviation Administration for fiscal year 2014, and for other purposes",Passed,228,0,0,3,0,194,0,6,0,0,0,0,228,194,0,9
537,R,113,H J RES 90,9-Oct-2013,2:19 PM,On Passage,"Making continuing appropriations for the Federal Aviation Administration for fiscal year 2014, and for other purposes",Passed,229,0,0,2,23,172,0,5,0,0,0,0,252,172,0,7
538,R,113,H J RES 91,9-Oct-2013,2:33 PM,On Motion to Suspend the Rules and Pass,"Making continuing appropriations for death gratuities and related survivor benefits for survivors of deceased military service members of the Department of Defense for fiscal year 2014, and for other purposes",Passed,228,0,0,3,197,0,0,3,0,0,0,0,425,0,0,6
539,R,113,H J RES 79,10-Oct-2013,2:10 PM,On Motion to Table the Appeal of the Ruling of the Chair,"Making continuing appropriations for certain components of the Department of Homeland Security for fiscal year 2014, and for other purposes",Passed,226,0,0,5,0,196,0,4,0,0,0,0,226,196,0,9
540,R,113,H J RES 79,10-Oct-2013,2:18 PM,On Passage,"Making continuing appropriations for certain components of the Department of Homeland Security for fiscal year 2014, and for other purposes",Passed,228,0,0,3,21,175,0,4,0,0,0,0,249,175,0,7
541,R,113,H J RES 76,11-Oct-2013,10:55 AM,Table Appeal of the Ruling of the Chair,"Making continuing appropriations for the National Nuclear Security Administration for fiscal year 2014, and for other purposes",Passed,226,0,0,5,0,195,0,5,0,0,0,0,226,195,0,10
542,R,113,H J RES 76,11-Oct-2013,11:06 AM,On Passage,"Making continuing appropriations for the National Nuclear Security Administration for fiscal year 2014, and for other purposes",Passed,227,0,0,4,21,176,0,3,0,0,0,0,248,176,0,7
543,R,113,H RES 380,11-Oct-2013,3:40 PM,On Ordering the Previous Question,"Relating to consideration of the House amendment to the Senate amendment to H.R. 2642, the Federal Agriculture Reform and Risk Management Act, and for consideration of H.Res. 378 and H.Res. 379, expressing the sense of the House of Representatives regarding certain provisions of the Senate amendment to H.R. 2642",Passed,219,0,0,12,0,193,0,7,0,0,0,0,219,193,0,19
544,R,113,H RES 380,11-Oct-2013,3:51 PM,On Agreeing to the Resolution,"Relating to consideration of the House amendment to the Senate amendment to H.R. 2642, the Federal Agriculture Reform and Risk Management Act, and for consideration of H.Res. 378 and H.Res. 379, expressing the sense of the House of Representatives regarding certain provisions of the Senate amendment to H.R. 2642",Passed,218,1,0,12,5,188,0,7,0,0,0,0,223,189,0,19
545,R,113,H RES 378,12-Oct-2013,10:59 AM,On Agreeing to the Resolution,Expressing the sense of the House of Representatives regarding certain provisions of the Senate amendment to H.R. 2642 relating to the Secretary of Agriculture’s administration of tariff-rate quotas for raw and refined sugar,Failed,130,85,1,15,62,127,0,11,0,0,0,0,192,212,1,26
546,R,113,H R 2642,12-Oct-2013,11:07 AM,On Motion to Instruct Conferees,Federal Agriculture Reform and Risk Management Act,Failed,9,204,2,16,186,0,0,14,0,0,0,0,195,204,2,30
547,R,113,H J RES 80,14-Oct-2013,6:54 PM,Table Appeal of the Ruling of the Chair,"Making continuing appropriations for the Bureau of Indian Affairs, the Bureau of Indian Education, and the Indian Health Service for fiscal year 2014, and for other purposes",Passed,216,0,0,15,0,180,0,20,0,0,0,0,216,180,0,35
548,R,113,H J RES 80,14-Oct-2013,7:03 PM,On Passage,"Making continuing appropriations for the Bureau of Indian Affairs, the Bureau of Indian Education, and the Indian Health Service for fiscal year 2014, and for other purposes",Passed,212,1,0,18,21,159,0,20,0,0,0,0,233,160,0,38
549,R,113,H J RES 80,14-Oct-2013,7:20 PM,On Agreeing to the Grayson (FL) amendment to the title,"Making continuing appropriations for the Bureau of Indian Affairs, the Bureau of Indian Education, and the Indian Health Service for fiscal year 2014, and for other purposes",Failed,1,213,0,17,160,15,0,25,0,0,0,0,161,228,0,42
550,R,113,H R 2775,16-Oct-2013,10:18 PM,On Motion to Concur in the Senate Amendments,"To condition the provision of premium and cost-sharing subsidies under the Patient Protection and Affordable Care Act upon a certification that a program to verify household income and other qualifications for such subsidies is operational, and for other purposes",Passed,87,144,0,1,198,0,0,2,0,0,0,0,285,144,0,3
551,R,113,H R 185,22-Oct-2013,6:56 PM,On Motion to Suspend the Rules and Pass,Paul Brown United States Courthouse,Passed,212,1,0,17,190,0,0,10,0,0,0,0,402,1,0,27
552,R,113,H R 3205,22-Oct-2013,7:06 PM,On Motion to Suspend the Rules and Pass,Promoting Adoption and Legal Guardianship for Children in Foster Care Act,Passed,212,0,0,18,190,0,0,10,0,0,0,0,402,0,0,28
553,R,113,JOURNAL,22-Oct-2013,7:15 PM,On Approving the Journal,None,Passed,142,64,1,23,133,52,1,14,0,0,0,0,275,116,2,37
554,R,113,H RES 385,23-Oct-2013,2:15 PM,On Ordering the Previous Question,"Providing for consideration of H.R. 3080, the Water Resources Reform and Development Act of 2013",Passed,223,1,0,6,2,193,0,5,0,0,0,0,225,194,0,11
555,R,113,H RES 385,23-Oct-2013,2:23 PM,On Agreeing to the Resolution,"Providing for consideration of H.R. 3080, the Water Resources Reform and Development Act of 2013",Passed,223,1,0,6,48,146,0,6,0,0,0,0,271,147,0,12
556,R,113,H R 3080,23-Oct-2013,5:52 PM,On Agreeing to the Amendment,None,Failed,2,224,0,4,181,12,0,7,0,0,0,0,183,236,0,11
557,R,113,H R 3080,23-Oct-2013,6:00 PM,On Agreeing to the Amendment,None,Agreed to,218,6,0,6,7,187,0,6,0,0,0,0,225,193,0,12
558,R,113,H R 3080,23-Oct-2013,6:06 PM,On Agreeing to the Amendment,None,Failed,5,221,0,4,128,66,0,6,0,0,0,0,133,287,0,10
559,R,113,H R 3080,23-Oct-2013,6:12 PM,On Agreeing to the Amendment,None,Agreed to,120,106,0,4,117,77,0,6,0,0,0,0,237,183,0,10
560,R,113,H R 3080,23-Oct-2013,6:22 PM,On Passage,Water Resources Reform and Development Act,Passed,224,2,0,4,193,1,0,6,0,0,0,0,417,3,0,10
561,R,113,H R 2189,28-Oct-2013,6:54 PM,"On Motion to Suspend the Rules and Pass, as Amended",To establish a commission or task force to evaluate the backlog of disability claims of the Department of Veterans Affairs,Passed,220,1,0,9,184,0,0,16,0,0,0,0,404,1,0,25
562,R,113,H R 2011,28-Oct-2013,7:03 PM,On Motion to Suspend the Rules and Pass,Veterans’ Advisory Committee on Education Improvement Act,Passed,219,2,0,9,185,0,0,15,0,0,0,0,404,2,0,24
563,R,113,H RES 391,29-Oct-2013,2:09 PM,On Ordering the Previous Question,"Providing for consideration of H.R. 992, the Swaps Regulatory Improvement Act; and H.R. 2347, the Retail Investor Protection Act",Passed,226,0,0,4,0,193,0,7,0,0,0,0,226,193,0,11
564,R,113,H RES 391,29-Oct-2013,2:18 PM,On Agreeing to the Resolution,"Providing for consideration of H.R. 992, the Swaps Regulatory Improvement Act; and H.R. 2347, the Retail Investor Protection Act",Passed,224,0,0,6,6,188,0,6,0,0,0,0,230,188,0,12
565,R,113,H R 2374,29-Oct-2013,5:06 PM,On Agreeing to the Amendment,None,Failed,0,223,0,7,174,20,0,6,0,0,0,0,174,243,0,13
566,R,113,H R 2374,29-Oct-2013,5:26 PM,On Motion to Recommit with Instructions,Retail Investor Protection Act,Failed,2,223,0,5,193,0,0,7,0,0,0,0,195,223,0,12
567,R,113,H R 2374,29-Oct-2013,5:36 PM,On Passage,Retail Investor Protection Act,Passed,224,1,0,5,30,165,0,5,0,0,0,0,254,166,0,10
568,R,113,H R 992,30-Oct-2013,2:19 PM,On Motion to Recommit with Instructions,To amend provisions in section 716 of the Dodd-Frank Wall Street Reform and Consumer Protection Act relating to Federal assistance for swaps entities,Failed,1,223,0,6,189,0,0,11,0,0,0,0,190,223,0,17
569,R,113,H R 992,30-Oct-2013,2:27 PM,On Passage,To amend provisions in section 716 of the Dodd-Frank Wall Street Reform and Consumer Protection Act relating to Federal assistance for swaps entities,Passed,222,3,0,5,70,119,0,11,0,0,0,0,292,122,0,16
570,R,113,H J RES 99,30-Oct-2013,2:36 PM,On Passage,"Relating to the disapproval of the President’s exercise of authority to suspend the debt limit, as submitted under section 1002(b) of the Continuing Appropriations Act, 2014 on October 17, 2013",Passed,219,4,2,5,3,187,0,10,0,0,0,0,222,191,2,15
571,R,113,H R 2871,12-Nov-2013,6:55 PM,On Motion to Suspend the Rules and Pass,"To amend title 28, United States Code, to modify the composition of the southern judicial district of Mississippi to improve judicial efficiency, and for other purposes",Passed,212,0,0,18,189,0,0,11,0,0,0,0,401,0,0,29
572,R,113,H R 2922,12-Nov-2013,7:05 PM,On Motion to Suspend the Rules and Pass,To extend the authority of the Supreme Court Police to protect court officials away from the Supreme Court grounds,Passed,213,1,0,16,186,2,0,12,0,0,0,0,399,3,0,28
573,R,113,H RES 403,13-Nov-2013,2:06 PM,On Ordering the Previous Question,"Providing for consideration of H.R. 2655, the Lawsuit Abuse Reduction Act of 2013, and providing for consideration of H.R. 982, the Furthering Asbestos Claim Transparency Act of 2013",Passed,224,0,0,6,0,195,0,5,0,0,0,0,224,195,0,11
574,R,113,H RES 403,13-Nov-2013,2:16 PM,On Agreeing to the Resolution,"Providing for consideration of H.R. 2655, the Lawsuit Abuse Reduction Act of 2013, and providing for consideration of H.R. 982, the Furthering Asbestos Claim Transparency Act of 2013",Passed,223,0,0,7,0,194,0,6,0,0,0,0,223,194,0,13
575,R,113,H R 982,13-Nov-2013,4:46 PM,On Agreeing to the Amendment,None,Failed,2,222,0,6,196,1,0,3,0,0,0,0,198,223,0,9
576,R,113,H R 982,13-Nov-2013,4:53 PM,On Agreeing to the Amendment,None,Failed,0,224,0,6,194,2,0,4,0,0,0,0,194,226,0,10
577,R,113,H R 982,13-Nov-2013,4:58 PM,On Agreeing to the Amendment,None,Failed,0,224,0,6,195,2,0,3,0,0,0,0,195,226,0,9
578,R,113,H R 982,13-Nov-2013,5:16 PM,On Motion to Recommit with Instructions,Furthering Asbestos Claim Transparency (FACT) Act of 2013,Failed,0,223,0,7,197,1,0,2,0,0,0,0,197,224,0,9
579,R,113,H R 982,13-Nov-2013,5:26 PM,On Passage,Furthering Asbestos Claim Transparency (FACT) Act of 2013,Passed,216,7,0,7,5,192,0,3,0,0,0,0,221,199,0,10
580,R,113,H R 2655,14-Nov-2013,2:52 PM,On Motion to Recommit with Instructions,Lawsuit Abuse Reduction Act of 2013,Failed,1,225,0,4,196,0,0,4,0,0,0,0,197,225,0,8
581,R,113,H R 2655,14-Nov-2013,3:02 PM,On Passage,Lawsuit Abuse Reduction Act of 2013,Passed,225,2,0,3,3,193,0,4,0,0,0,0,228,195,0,7
582,R,113,H R 3080,14-Nov-2013,3:10 PM,On Motion to Instruct Conferees,Water Resources Reform and Development Act,Passed,150,76,1,3,197,0,0,3,0,0,0,0,347,76,1,6
583,R,113,H RES 413,15-Nov-2013,10:57 AM,On Ordering the Previous Question,"Providing for consideration of the bill (H.R. 3350) to authorize health insurance issuers to continue to offer for sale current individual health insurance coverage in satisfaction of the minimum essential health insurance coverage requirement, and for other purposes",Passed,223,0,0,7,2,193,0,5,0,0,0,0,225,193,0,12
584,R,113,H RES 413,15-Nov-2013,11:05 AM,On Agreeing to the Resolution,"Providing for consideration of the bill (H.R. 3350) to authorize health insurance issuers to continue to offer for sale current individual health insurance coverage in satisfaction of the minimum essential health insurance coverage requirement, and for other purposes",Passed,222,0,0,8,6,189,0,5,0,0,0,0,228,189,0,13
585,R,113,H R 3350,15-Nov-2013,1:07 PM,On Motion to Table the Appeal of the Ruling of the Chair,Keep Your Health Plan Act of 2013,Passed,226,0,0,4,3,191,0,6,0,0,0,0,229,191,0,10
586,R,113,H R 3350,15-Nov-2013,1:27 PM,On Motion to Recommit with Instructions,Keep Your Health Plan Act of 2013,Failed,0,226,0,4,187,4,0,9,0,0,0,0,187,230,0,13
587,R,113,H R 3350,15-Nov-2013,1:34 PM,On Passage,Keep Your Health Plan Act of 2013,Passed,222,4,0,4,39,153,0,8,0,0,0,0,261,157,0,12
588,R,113,H R 2061,18-Nov-2013,6:57 PM,"On Motion to Suspend the Rules and Pass, as Amended",Digital Accountability and Transparency Act,Passed,210,0,0,20,178,1,0,21,0,0,0,0,388,1,0,41
589,R,113,H R 272,18-Nov-2013,7:04 PM,"On Motion to Suspend the Rules and Pass, as Amended","To designate the Department of Veterans Affairs and Department of Defense joint outpatient clinic to be constructed in Marina, California, as the “General William H. Gourley Federal Outpatient Clinic: A Joint VA-DOD Health Care Facility”",Passed,208,0,0,22,180,0,0,20,0,0,0,0,388,0,0,42
590,R,113,H RES 419,19-Nov-2013,2:02 PM,On Ordering the Previous Question,Providing for consideration of the bill (H.R. 1965) Federal Lands Jobs and Energy Security Act and providing for consideration of the bill (H.R. 2728) Protecting States’ Rights to Promote American Energy Security Act,Passed,223,0,0,7,0,194,0,6,0,0,0,0,223,194,0,13
591,R,113,H RES 419,19-Nov-2013,2:10 PM,On Agreeing to the Resolution,Providing for consideration of the bill (H.R. 1965) Federal Lands Jobs and Energy Security Act and providing for consideration of the bill (H.R. 2728) Protecting States’ Rights to Promote American Energy Security Act,Passed,222,0,0,8,0,196,0,4,0,0,0,0,222,196,0,12
592,R,113,H RES 420,20-Nov-2013,1:45 PM,On Ordering the Previous Question,"Providing for consideration of the bill (H.R. 1900) to provide for the timely consideration of all licenses, permits, and approvals required under Federal law with respect to the sitting, construction, expansion, or operation of any natural gas pipeline projects, and for other purposes",Passed,223,0,0,7,0,195,0,5,0,0,0,0,223,195,0,12
593,R,113,H RES 420,20-Nov-2013,1:52 PM,On Agreeing to the Resolution,"Providing for consideration of the bill (H.R. 1900) to provide for the timely consideration of all licenses, permits, and approvals required under Federal law with respect to the sitting, construction, expansion, or operation of any natural gas pipeline projects, and for other purposes",Passed,221,1,0,8,4,193,0,3,0,0,0,0,225,194,0,11
594,R,113,H R 1965,20-Nov-2013,1:58 PM,On Agreeing to the Amendment,None,Failed,4,220,0,6,195,2,0,3,0,0,0,0,199,222,0,9
595,R,113,H R 1965,20-Nov-2013,2:02 PM,On Agreeing to the Amendment,None,Failed,0,224,0,6,194,4,0,2,0,0,0,0,194,228,0,8
596,R,113,H R 1965,20-Nov-2013,2:06 PM,On Agreeing to the Amendment,None,Failed,4,222,0,4,194,3,0,3,0,0,0,0,198,225,0,7
597,R,113,H R 1965,20-Nov-2013,2:11 PM,On Agreeing to the Amendment,None,Failed,8,219,0,3,194,2,0,4,0,0,0,0,202,221,0,7
598,R,113,H R 1965,20-Nov-2013,2:16 PM,On Agreeing to the Amendment,None,Failed,4,222,0,4,191,4,0,5,0,0,0,0,195,226,0,9
599,R,113,H R 1965,20-Nov-2013,2:32 PM,On Motion to Recommit with Instructions,"To streamline and ensure onshore energy permitting, provide for onshore leasing certainty, and give certainty to oil shale development for American energy security, economic development, and job creation, and for other purposes",Failed,1,224,0,5,188,8,0,4,0,0,0,0,189,232,0,9
600,R,113,H R 1965,20-Nov-2013,2:41 PM,On Passage,"To streamline and ensure onshore energy permitting, provide for onshore leasing certainty, and give certainty to oil shale development for American energy security, economic development, and job creation, and for other purposes",Passed,221,1,0,8,7,191,0,2,0,0,0,0,228,192,0,10
601,R,113,H R 2728,20-Nov-2013,5:02 PM,On Agreeing to the Amendment,None,Failed,1,222,0,7,189,8,0,3,0,0,0,0,190,230,0,10
602,R,113,H R 2728,20-Nov-2013,5:11 PM,On Agreeing to the Amendment,None,Failed,2,220,0,8,140,56,0,4,0,0,0,0,142,276,0,12
603,R,113,H R 2728,20-Nov-2013,5:28 PM,On Motion to Recommit with Instructions,Protecting States’ Rights to Promote American Energy Security Act,Failed,1,223,0,6,187,9,0,4,0,0,0,0,188,232,0,10
604,R,113,H R 2728,20-Nov-2013,5:39 PM,On Passage,Protecting States’ Rights to Promote American Energy Security Act,Passed,223,2,0,6,12,185,0,3,0,0,0,0,235,187,0,9
605,R,113,H R 1900,21-Nov-2013,11:22 AM,On Agreeing to the Amendment,None,Failed,2,223,0,5,181,10,0,9,0,0,0,0,183,233,0,14
606,R,113,H R 1900,21-Nov-2013,11:28 AM,On Agreeing to the Amendment,None,Failed,0,225,0,5,184,8,0,8,0,0,0,0,184,233,0,13
607,R,113,H R 1900,21-Nov-2013,11:33 AM,On Agreeing to the Amendment,None,Failed,2,223,0,5,181,13,0,6,0,0,0,0,183,236,0,11
608,R,113,H R 1900,21-Nov-2013,11:38 AM,On Agreeing to the Amendment,None,Failed,0,224,0,6,175,19,0,6,0,0,0,0,175,243,0,12
609,R,113,H R 1900,21-Nov-2013,11:42 AM,On Agreeing to the Amendment,None,Failed,0,225,0,5,175,14,0,11,0,0,0,0,175,239,0,16
610,R,113,H R 1900,21-Nov-2013,11:55 AM,On Motion to Recommit with Instructions,Natural Gas Pipeline Permitting Reform Act,Failed,0,223,0,7,180,10,0,10,0,0,0,0,180,233,0,17
611,R,113,H R 1900,21-Nov-2013,12:13 PM,On Passage,Natural Gas Pipeline Permitting Reform Act,Passed,226,0,0,5,26,165,0,9,0,0,0,0,252,165,0,14
612,R,113,H R 3547,2-Dec-2013,7:02 PM,On Motion to Suspend the Rules and Pass,Space Launch Liability Indemnification Extension Act,Passed,201,5,0,25,175,0,0,25,0,0,0,0,376,5,0,50
613,R,113,H R 3588,2-Dec-2013,7:10 PM,On Motion to Suspend the Rules and Pass,Community Fire Safety Act of 2013,Passed,209,0,0,22,175,0,0,25,0,0,0,0,384,0,0,47
614,R,113,JOURNAL,2-Dec-2013,7:19 PM,On Approving the Journal,None,Passed,127,68,1,35,110,58,0,32,0,0,0,0,237,126,1,67
615,R,113,H R 255,3-Dec-2013,2:34 PM,On Motion to Suspend the Rules and Pass,"To amend certain definitions contained in the Provo River Project Transfer Act for purposes of clarifying certain property descriptions, and for other purposes",Passed,220,0,0,11,186,0,0,14,0,0,0,0,406,0,0,25
616,R,113,H R 2719,3-Dec-2013,2:42 PM,"On Motion to Suspend the Rules and Pass, as Amended","To require the Transportation Security Administration to implement best practices and improve transparency with regard to technology acquisition programs, and for other purposes",Passed,223,0,0,8,193,0,0,7,0,0,0,0,416,0,0,15
617,R,113,H R 1204,3-Dec-2013,2:50 PM,"On Motion to Suspend the Rules and Pass, as Amended","To amend title 49, United States Code, to direct the Assistant Secretary of Homeland Security (Transportation Security Administration) to establish an Aviation Security Advisory Committee, and for other purposes",Passed,218,3,0,10,193,0,0,7,0,0,0,0,411,3,0,17
618,R,113,H RES 429,4-Dec-2013,2:28 PM,On Ordering the Previous Question,"Providing for consideration of H.R. 3309, the Innovation Act; and H.R. 1105, the Small Business Capital Access and Job Preservation Act",Passed,220,0,0,11,0,194,0,6,0,0,0,0,220,194,0,17
619,R,113,H RES 429,4-Dec-2013,2:34 PM,On Agreeing to the Resolution,"Providing for consideration of H.R. 3309, the Innovation Act; and H.R. 1105, the Small Business Capital Access and Job Preservation Act",Passed,220,0,0,11,9,185,0,6,0,0,0,0,229,185,0,17
620,R,113,H R 1105,4-Dec-2013,4:31 PM,On Agreeing to the Amendment,None,Failed,2,216,0,13,184,9,0,7,0,0,0,0,186,225,0,20
621,R,113,H R 1105,4-Dec-2013,4:53 PM,On Motion to Recommit with Instructions,"To amend the Investment Advisers Act of 1940 to provide a registration exemption for private equity fund advisers, and for other purposes",Failed,2,216,0,13,183,11,0,6,0,0,0,0,185,227,0,19
622,R,113,H R 1105,4-Dec-2013,5:00 PM,On Passage,"To amend the Investment Advisers Act of 1940 to provide a registration exemption for private equity fund advisers, and for other purposes",Passed,218,1,0,12,36,158,0,6,0,0,0,0,254,159,0,18
623,R,113,H R 3309,5-Dec-2013,12:41 PM,On Agreeing to the Amendment,None,Agreed to,214,6,0,11,127,67,0,6,0,0,0,0,341,73,0,17
624,R,113,H R 3309,5-Dec-2013,12:46 PM,On Agreeing to the Amendment,None,Failed,25,195,0,11,174,18,0,8,0,0,0,0,199,213,0,19
625,R,113,H R 3309,5-Dec-2013,12:50 PM,On Agreeing to the Amendment,None,Failed,48,173,0,10,71,123,0,6,0,0,0,0,119,296,0,16
626,R,113,H R 3309,5-Dec-2013,12:53 PM,On Agreeing to the Amendment,None,Failed,12,206,0,13,132,60,0,8,0,0,0,0,144,266,0,21
627,R,113,H R 3309,5-Dec-2013,12:57 PM,On Agreeing to the Amendment,None,Agreed to,87,135,0,9,173,21,0,6,0,0,0,0,260,156,0,15
628,R,113,H R 3309,5-Dec-2013,1:01 PM,On Agreeing to the Amendment,None,Failed,5,216,0,10,152,42,0,6,0,0,0,0,157,258,0,16
629,R,113,H R 3309,5-Dec-2013,1:12 PM,On Passage,The Innovation Act,Passed,195,27,0,9,130,64,0,6,0,0,0,0,325,91,0,15
630,R,113,H R 3521,10-Dec-2013,4:26 PM,"On Motion to Suspend the Rules and Pass, as Amended",Department of Veterans Affairs Major Medical Facility Lease Authorization Act of 2013,Passed,191,1,0,39,155,0,0,45,0,0,0,0,346,1,0,84
631,R,113,H R 1402,10-Dec-2013,4:33 PM,"On Motion to Suspend the Rules and Pass, as Amended",VA Expiring Authorities Extension Act of 2013,Passed,196,0,0,35,157,0,0,43,0,0,0,0,353,0,0,78
632,R,113,H R 2019,11-Dec-2013,4:00 PM,"On Motion to Suspend the Rules and Pass, as Amended",Gabriella Miller Kids First Research Act,Passed,223,1,0,7,72,102,0,26,0,0,0,0,295,103,0,33
633,R,113,H R 2319,11-Dec-2013,4:08 PM,"On Motion to Suspend the Rules and Pass, as Amended",To clarify certain provisions of the Native American Veterans’ Memorial Establishment Act of 1994,Passed,225,0,0,6,173,0,0,27,0,0,0,0,398,0,0,33
634,R,113,S 1471,11-Dec-2013,4:15 PM,On Motion to Suspend the Rules and Pass,"To authorize the Secretary of Veterans Affairs and the Secretary of the Army to reconsider decisions to inter or honor the memory of a person in a national cemetery, and for other purposes",Passed,225,1,0,5,173,0,0,27,0,0,0,0,398,1,0,32
635,R,113,H R 3212,11-Dec-2013,4:22 PM,"On Motion to Suspend the Rules and Pass, as Amended","To ensure compliance with the 1980 Hague Convention on the Civil Aspects of International Child Abduction by countries with which the United States enjoys reciprocal obligations, to establish procedures for the prompt return of children abducted to other countries, and for other purposes",Passed,225,0,0,6,173,0,0,27,0,0,0,0,398,0,0,33
636,R,113,H R 1992,11-Dec-2013,4:28 PM,"On Motion to Suspend the Rules and Pass, as Amended","To amend the requirements relating to assessment of Israel’s qualitative military edge over military threats, and for other purposes",Passed,225,0,0,6,174,0,0,26,0,0,0,0,399,0,0,32
637,R,113,H RES 438,12-Dec-2013,2:24 PM,On Ordering the Previous Question,"Providing for consideration of the Senate amendment to H.J.Res. 59, making continuing appropriations for fiscal year 2014, and for other purposes; providing for consideration of motions to suspend the rules; providing for proceedings during the period from December 14, 2013, through January 6, 2014",Passed,227,1,0,3,0,194,0,6,0,0,0,0,227,195,0,9
638,R,113,H RES 438,12-Dec-2013,2:42 PM,On Agreeing to the Resolution,"Providing for consideration of the Senate amendment to H.J.Res. 59, making continuing appropriations for fiscal year 2014, and for other purposes; providing for consideration of motions to suspend the rules; providing for proceedings during the period from December 14, 2013, through January 6, 2014",Passed,226,1,0,4,0,194,0,7,0,0,0,0,226,195,0,11
639,R,113,JOURNAL,12-Dec-2013,2:50 PM,On Approving the Journal,None,Passed,148,73,1,9,102,74,1,24,0,0,0,0,250,147,2,33
640,R,113,H J RES 59,12-Dec-2013,6:25 PM,On Motion to Recede and Concur in the Senate Amendment with Amendment,"Making continuing appropriations for fiscal year 2014, and for other purposes",Passed,169,62,0,1,163,32,0,6,0,0,0,0,332,94,0,7
641,R,113,H RES 441,12-Dec-2013,6:36 PM,On Motion to Suspend the Rules and Agree,"Providing for concurrence by the House in the Senate amendments to H.R. 3304, with an amendment",Passed,208,19,0,4,142,50,0,9,0,0,0,0,350,69,0,13
