Roll Call,Majority,Congress Num,Legislation Number,Date,Time,Question,Description,Result,Republican Yes,Republican No,Republican Present,Republican Not Voting,Democrat Yes,Democrat No,Democrat Present,Democrat Not Voting,Independent Yes,Independent No,Independent Present,Independent Not Voting,Total Yes,Total No,Total Present,Total Not Voting
1,R,113,QUORUM,7-Jan-2014,6:52 PM,Call of the House,None,Passed,0,0,178,53,0,0,138,62,0,0,0,0,0,0,316,115
2,R,113,H R 724,8-Jan-2014,3:30 PM,On Motion to Suspend the Rules and Pass,To amend the Clean Air Act to remove the requirement for dealer certification of new light-duty motor vehicles,Passed,220,0,0,11,185,0,0,15,0,0,0,0,405,0,0,26
3,R,113,H R 3527,8-Jan-2014,3:47 PM,"On Motion to Suspend the Rules and Pass, as Amended",Poison Center Network Act,Passed,202,18,0,12,186,0,0,14,0,0,0,0,388,18,0,26
4,R,113,H R 3628,8-Jan-2014,4:00 PM,On Motion to Suspend the Rules and Pass,Transportation Reports Elimination Act of 2013,Passed,221,0,0,11,185,0,0,15,0,0,0,0,406,0,0,26
5,R,113,H RES 455,9-Jan-2014,1:56 PM,On Ordering the Previous Question,"Providing for consideration of H.R. 2279, Reducing Excessive Deadline Obligations Act of 2013; consideration of H.R. 3362, to require transparency in the operation of Health Benefit Exchanges; and consideration of H.R. 3811, to require notification of breaches of personal information through Health Benefit Exchanges",Passed,226,0,0,6,0,191,0,9,0,0,0,0,226,191,0,15
6,R,113,H RES 455,9-Jan-2014,2:06 PM,On Agreeing to the Resolution,"Providing for consideration of H.R. 2279, Reducing Excessive Deadline Obligations Act of 2013; consideration of H.R. 3362, to require transparency in the operation of Health Benefit Exchanges; and consideration of H.R. 3811, to require notification of breaches of personal information through Health Benefit Exchanges",Passed,222,0,0,10,1,186,0,13,0,0,0,0,223,186,0,23
7,R,113,H R 2279,9-Jan-2014,3:59 PM,On Agreeing to the Amendment,None,Failed,1,226,0,5,188,2,0,10,0,0,0,0,189,228,0,15
8,R,113,H R 2279,9-Jan-2014,4:05 PM,On Agreeing to the Amendment,None,Failed,2,225,0,5,188,2,0,10,0,0,0,0,190,227,0,15
9,R,113,H R 2279,9-Jan-2014,4:23 PM,On Motion to Recommit with Instructions,Reducing Excessive Deadline Obligations Act of 2013,Failed,0,225,0,7,188,0,0,12,0,0,0,0,188,225,0,19
10,R,113,H R 2279,9-Jan-2014,4:31 PM,On Passage,Reducing Excessive Deadline Obligations Act of 2013,Passed,220,4,0,8,5,184,0,11,0,0,0,0,225,188,0,19
11,R,113,H R 3811,10-Jan-2014,10:54 AM,On Passage,Health Exchange Security and Transparency Act,Passed,224,0,0,8,67,122,0,11,0,0,0,0,291,122,0,19
12,R,113,H R 1513,13-Jan-2014,6:53 PM,On Motion to Suspend the Rules and Pass,"To revise the boundaries of the Gettysburg National Military Park to include the Gettysburg Train Station and certain land along Plum Run in Cumberland Township, to limit the means by which property within such revised boundaries may be acquired, and for other purposes",Passed,219,0,0,13,177,0,0,23,0,0,0,0,396,0,0,36
13,R,113,S 230,13-Jan-2014,7:00 PM,On Motion to Suspend the Rules and Pass,"To authorize the Peace Corps Commemorative Foundation to establish a commemorative work in the District of Columbia and its environs, and for other purposes",Passed,211,7,0,14,176,0,0,24,0,0,0,0,387,7,0,38
14,R,113,H R 2274,14-Jan-2014,1:58 PM,"On Motion to Suspend the Rules and Pass, as Amended",To amend the Securities Exchange Act of 1934 to provide for a notice-filing registration procedure for brokers performing services in connection with the transfer of ownership of smaller privately held companies and to provide for regulation appropriate to the limited scope of the activities of such brokers,Passed,228,0,0,4,194,0,0,6,0,0,0,0,422,0,0,10
15,R,113,H R 801,14-Jan-2014,2:08 PM,On Motion to Suspend the Rules and Pass,To amend the Securities Exchange Act of 1934 to make the shareholder threshold for registration of savings and loan holding companies the same as for bank holding companies,Passed,228,0,0,4,189,4,0,7,0,0,0,0,417,4,0,11
16,R,113,JOURNAL,14-Jan-2014,2:14 PM,On Approving the Journal,None,Passed,143,82,2,5,131,56,1,12,0,0,0,0,274,138,3,17
17,R,113,H R 2860,14-Jan-2014,5:27 PM,On Motion to Suspend the Rules and Pass,OPM IG Act,Passed,227,0,0,5,191,0,0,9,0,0,0,0,418,0,0,14
18,R,113,H R 1233,14-Jan-2014,5:35 PM,"On Motion to Suspend the Rules and Pass, as Amended",Presidential and Federal Records Act Amendments,Passed,227,0,0,5,193,0,0,7,0,0,0,0,420,0,0,12
19,R,113,H RES 458,15-Jan-2014,2:20 PM,On Ordering the Previous Question,"Providing for consideration of the Senate amendments to the bill (H.R. 3547) to extend the application of certain space launch liability provisions through 2014; providing for proceedings during the period from January 17, 2014, through January 24, 2014; and for other purposes",Passed,228,0,0,4,0,195,0,5,0,0,0,0,228,195,0,9
20,R,113,H RES 458,15-Jan-2014,2:29 PM,On Agreeing to the Resolution,"Providing for consideration of the Senate amendments to the bill (H.R. 3547) to extend the application of certain space launch liability provisions through 2014; providing for proceedings during the period from January 17, 2014, through January 24, 2014; and for other purposes",Passed,227,0,0,5,3,191,0,6,0,0,0,0,230,191,0,11
21,R,113,H R 3547,15-Jan-2014,4:18 PM,Concurring in the Senate Amendments with an Amendment,To extend the application of certain space launch liability provisions through 2014,Passed,166,64,0,3,193,3,0,4,0,0,0,0,359,67,0,7
22,R,113,H R 3362,16-Jan-2014,11:51 AM,On Motion to Recommit with Instructions,To amend the Patient Protection and Affordable Care Act to require transparency in the operation of American Health Benefit Exchanges,Failed,0,224,0,8,186,2,0,12,0,0,0,0,186,226,0,20
23,R,113,H R 3362,16-Jan-2014,12:00 PM,On Passage,To amend the Patient Protection and Affordable Care Act to require transparency in the operation of American Health Benefit Exchanges,Passed,226,0,0,6,33,154,0,13,0,0,0,0,259,154,0,19
24,R,113,H R 2166,27-Jan-2014,6:55 PM,"On Motion to Suspend the Rules and Pass, as Amended",Good Samaritan Search and Recovery Act,Passed,215,0,0,16,179,0,0,21,0,0,0,0,394,0,0,37
25,R,113,H R 3008,27-Jan-2014,7:04 PM,"On Motion to Suspend the Rules and Pass, as Amended","To provide for the conveyance of a small parcel of National Forest System land in Los Padres National Forest in California, and for other purposes",Passed,187,27,0,17,180,0,0,20,0,0,0,0,367,27,0,37
26,R,113,H RES 465,28-Jan-2014,2:52 PM,On Ordering the Previous Question,"Providing for consideration of H.R. 7, to prohibit taxpayer funded abortions; and providing for consideration of the conference report to accompany H.R. 2642, to provide for the reform and continuation of agricultural and other programs of the Department of Agriculture through fiscal year 2018",Passed,222,0,0,9,0,194,0,6,0,0,0,0,222,194,0,15
27,R,113,H RES 465,28-Jan-2014,3:02 PM,On Agreeing to the Resolution,"Providing for consideration of H.R. 7, to prohibit taxpayer funded abortions; and providing for consideration of the conference report to accompany H.R. 2642, to provide for the reform and continuation of agricultural and other programs of the Department of Agriculture through fiscal year 2018",Passed,222,0,0,9,2,192,0,6,0,0,0,0,224,192,0,15
28,R,113,JOURNAL,28-Jan-2014,3:09 PM,On Approving the Journal,None,Passed,143,73,1,14,117,69,2,12,0,0,0,0,260,142,3,26
29,R,113,H R 7,28-Jan-2014,5:04 PM,On Motion to Recommit with Instructions,To prohibit taxpayer funded abortions,Failed,0,221,0,10,192,0,1,7,0,0,0,0,192,221,1,17
30,R,113,H R 7,28-Jan-2014,5:12 PM,On Passage,To prohibit taxpayer funded abortions,Passed,221,1,1,8,6,187,0,7,0,0,0,0,227,188,1,15
31,R,113,H R 2642,29-Jan-2014,10:59 AM,On Agreeing to the Conference Report,"To provide for the reform and continuation of agricultural and other programs of the Department of Agriculture through fiscal year 2018, and for other purposes",Passed,162,63,0,6,89,103,0,8,0,0,0,0,251,166,0,14
32,R,113,H R 1791,3-Feb-2014,6:56 PM,"On Motion to Suspend the Rules and Pass, as Amended",Medical Preparedness Allowable Use Act,Passed,209,2,0,20,182,0,0,18,0,0,0,0,391,2,0,38
33,R,113,H R 357,3-Feb-2014,7:06 PM,"On Motion to Suspend the Rules and Pass, as Amended",GI Bill Tuition Fairness Act of 2013,Passed,209,0,0,22,181,0,0,19,0,0,0,0,390,0,0,41
34,R,113,H RES 470,4-Feb-2014,1:54 PM,On Ordering the Previous Question,"Providing for consideration of the bill (H.R. 3590) to protect and enhance opportunities for recreational hunting, fishing, and shooting, and for other purposes",Passed,225,1,0,5,0,192,0,8,0,0,0,0,225,193,0,13
35,R,113,H RES 470,4-Feb-2014,2:04 PM,On Agreeing to the Resolution,"Providing for consideration of the bill (H.R. 3590) to protect and enhance opportunities for recreational hunting, fishing, and shooting, and for other purposes",Passed,226,0,0,5,8,185,0,7,0,0,0,0,234,185,0,12
36,R,113,H RES 472,5-Feb-2014,2:05 PM,On Ordering the Previous Question,"Providing for consideration of H.R. 2954, to authorize Escambia County, Florida, to convey certain property that was formerly part of Santa Rosa Island National Monument; and providing for consideration of H.R. 3964, the Sacramento-San Joaquin Valley Emergency Water Delivery Act",Passed,224,2,0,5,2,194,0,4,0,0,0,0,226,196,0,9
37,R,113,H RES 472,5-Feb-2014,2:13 PM,On Agreeing to the Resolution,"Providing for consideration of H.R. 2954, to authorize Escambia County, Florida, to convey certain property that was formerly part of Santa Rosa Island National Monument; and providing for consideration of H.R. 3964, the Sacramento-San Joaquin Valley Emergency Water Delivery Act",Passed,226,0,0,5,3,190,0,7,0,0,0,0,229,190,0,12
38,R,113,H R 3590,5-Feb-2014,2:19 PM,On Agreeing to the Amendment,None,Failed,5,221,0,5,180,16,0,4,0,0,0,0,185,237,0,9
39,R,113,H R 3590,5-Feb-2014,2:26 PM,On Agreeing to the Amendment,None,Failed,0,227,0,4,181,15,0,4,0,0,0,0,181,242,0,8
40,R,113,H R 3590,5-Feb-2014,2:44 PM,On Motion to Recommit with Instructions,Sportmen’s Heritage And Recreational Enhancement (SHARE) Act of 2013,Failed,2,221,0,8,185,10,0,5,0,0,0,0,187,231,0,13
41,R,113,H R 3590,5-Feb-2014,2:50 PM,On Passage,Sportmen’s Heritage And Recreational Enhancement (SHARE) Act of 2013,Passed,227,0,0,4,41,154,0,5,0,0,0,0,268,154,0,9
42,R,113,H R 3964,5-Feb-2014,5:44 PM,On Agreeing to the Amendment,None,Failed,0,225,0,6,179,14,0,7,0,0,0,0,179,239,0,13
43,R,113,H R 3964,5-Feb-2014,5:49 PM,On Agreeing to the Amendment,None,Failed,1,223,0,7,192,5,0,3,0,0,0,0,193,228,0,10
44,R,113,H R 3964,5-Feb-2014,5:53 PM,On Agreeing to the Amendment,None,Failed,1,222,0,8,193,4,0,3,0,0,0,0,194,226,0,11
45,R,113,H R 3964,5-Feb-2014,5:58 PM,On Agreeing to the Amendment,None,Failed,2,222,0,7,192,5,0,3,0,0,0,0,194,227,0,10
46,R,113,H R 3964,5-Feb-2014,6:01 PM,On Agreeing to the Amendment,None,Failed,0,226,0,5,189,5,0,6,0,0,0,0,189,231,0,11
47,R,113,H R 3964,5-Feb-2014,6:05 PM,On Agreeing to the Amendment,None,Failed,1,225,0,5,192,5,0,3,0,0,0,0,193,230,0,8
48,R,113,H R 3964,5-Feb-2014,6:09 PM,On Agreeing to the Amendment,None,Failed,1,225,0,5,191,6,0,3,0,0,0,0,192,231,0,8
49,R,113,H R 3964,5-Feb-2014,6:29 PM,On Motion to Recommit with Instructions,Sacramento-San Joaquin Valley Emergency Water Delivery Act,Failed,0,226,0,5,191,5,0,4,0,0,0,0,191,231,0,9
50,R,113,H R 3964,5-Feb-2014,6:38 PM,On Passage,Sacramento-San Joaquin Valley Emergency Water Delivery Act,Passed,222,2,0,7,7,189,0,4,0,0,0,0,229,191,0,11
51,R,113,H R 2954,6-Feb-2014,11:42 AM,On Agreeing to the Amendment,None,Failed,1,219,0,11,189,5,0,6,0,0,0,0,190,224,0,17
52,R,113,H R 2954,6-Feb-2014,11:49 AM,On Agreeing to the Amendment,None,Agreed to,215,7,0,9,3,191,0,6,0,0,0,0,218,198,0,15
53,R,113,H R 2954,6-Feb-2014,12:11 PM,On Motion to Recommit with Instructions,"To authorize Escambia County, Florida, to convey certain property that was formerly part of Santa Rosa Island National Monument and that was conveyed to Escambia County subject to restrictions on use and reconveyance",Failed,0,222,0,9,194,0,0,6,0,0,0,0,194,222,0,15
54,R,113,H R 2954,6-Feb-2014,12:17 PM,On Passage,"To authorize Escambia County, Florida, to convey certain property that was formerly part of Santa Rosa Island National Monument and that was conveyed to Escambia County subject to restrictions on use and reconveyance",Passed,214,6,0,11,6,188,0,6,0,0,0,0,220,194,0,17
55,R,113,H R 2431,10-Feb-2014,6:58 PM,"On Motion to Suspend the Rules and Pass, as Amended",National Integrated Drought Information System Reauthorization Act of 2013,Passed,192,21,0,18,173,0,0,27,0,0,0,0,365,21,0,45
56,R,113,H RES 447,10-Feb-2014,7:07 PM,"On Motion to Suspend the Rules and Agree, as Amended","Supporting the democratic and European aspirations of the people of the Ukraine, and their right to choose their own future free of intimidation and fear.",Passed,208,2,0,21,173,0,0,27,0,0,0,0,381,2,0,48
57,R,113,JOURNAL,10-Feb-2014,7:13 PM,On Approving the Journal,None,Passed,128,78,1,24,113,45,0,42,0,0,0,0,241,123,1,66
58,R,113,H RES 475,11-Feb-2014,2:53 PM,On Ordering the Previous Question,"Providing for consideration of the bill (H.R. 3193) to amend the Consumer Financial Protection Act of 2010 to strengthen the review authority of the Financial Stability Oversight Council of regulations issued by the Bureau of Consumer Financial Protection, providing for proceedings from Feb. 13, 2014 - Feb. 24, 2014.",Passed,222,4,0,5,0,191,0,9,0,0,0,0,222,195,0,14
59,R,113,H RES 475,11-Feb-2014,3:01 PM,On Agreeing to the Resolution,"Providing for consideration of the bill (H.R. 3193) to amend the Consumer Financial Protection Act of 2010 to strengthen the review authority of the Financial Stability Oversight Council of regulations issued by the Bureau of Consumer Financial Protection, providing for proceedings from Feb. 13, 2014 - Feb. 24, 2014.",Passed,223,2,1,5,0,191,0,9,0,0,0,0,223,193,1,14
60,R,113,S 25,11-Feb-2014,3:09 PM,"On Motion to Suspend the Rules and Pass, as Amended","To direct the Secretary of the Interior to convey certain Federal features of the electric distribution system to the South Utah Valley Electric Service District, and for other purposes",Passed,206,19,0,6,120,71,1,8,0,0,0,0,326,90,1,14
61,R,113,S 540,11-Feb-2014,5:27 PM,On Passage,"To designate the air route traffic control center located in Nashua, New Hampshire, as the “Patricia Clark Boston Air Route Traffic Control Center”",Passed,28,199,0,5,193,2,0,5,0,0,0,0,221,201,0,10
62,R,113,H R 3448,11-Feb-2014,5:35 PM,"On Motion to Suspend the Rules and Pass, as Amended",To amend the Securities Exchange Act of 1934 to provide for an optional pilot program allowing certain emerging growth companies to increase the tick sizes of their stocks,Passed,219,4,0,8,193,0,0,7,0,0,0,0,412,4,0,15
63,R,113,H R 1211,25-Feb-2014,7:00 PM,"On Motion to Suspend the Rules and Pass, as Amended",FOIA Oversight and Implementation Act of 2014,Passed,220,0,0,11,190,0,0,9,0,0,0,0,410,0,0,20
64,R,113,H R 1123,25-Feb-2014,7:09 PM,"On Motion to Suspend the Rules and Pass, as Amended",Unlocking Consumer Choice and Wireless Competition Act,Passed,200,20,0,11,95,94,0,10,0,0,0,0,295,114,0,21
65,R,113,H RES 487,26-Feb-2014,2:11 PM,On Ordering the Previous Question,Providing for consideration of the bill (H.R. 3865) Stop Targeting of Political Beliefs by the IRS Act and providing for consideration of the bill (H.R. 2804) All Economic Regulations are Transparent Act or the ALERT Act; and providing for consideration of motions to suspend the rules.,Passed,224,0,0,7,0,192,0,7,0,0,0,0,224,192,0,14
66,R,113,H RES 487,26-Feb-2014,2:21 PM,On Agreeing to the Resolution,Providing for consideration of the bill (H.R. 3865) Stop Targeting of Political Beliefs by the IRS Act and providing for consideration of the bill (H.R. 2804) All Economic Regulations are Transparent Act or the ALERT Act; and providing for consideration of motions to suspend the rules.,Passed,226,0,0,5,5,185,0,9,0,0,0,0,231,185,0,14
67,R,113,H R 1944,26-Feb-2014,2:29 PM,On Motion to Suspend the Rules and Pass,Private Property Rights Protection Act,Passed,226,0,0,5,127,65,0,7,0,0,0,0,353,65,0,12
68,R,113,H R 3865,26-Feb-2014,4:20 PM,On Motion to Recommit with Instructions,Stop Targeting of Political Beliefs by the IRS Act of 2014,Failed,0,229,0,2,191,1,0,7,0,0,0,0,191,230,0,9
69,R,113,H R 3865,26-Feb-2014,4:27 PM,On Passage,Stop Targeting of Political Beliefs by the IRS Act of 2014,Passed,229,0,0,2,14,176,0,9,0,0,0,0,243,176,0,11
70,R,113,H R 3865,26-Feb-2014,4:45 PM,On Agreeing to the Amendment,None,Failed,1,228,0,2,176,13,0,10,0,0,0,0,177,241,0,12
71,R,113,H R 2804,27-Feb-2014,1:46 PM,On Agreeing to the Amendment,None,Agreed to,223,0,0,8,26,162,0,11,0,0,0,0,249,162,0,19
72,R,113,H R 2804,27-Feb-2014,1:53 PM,On Agreeing to the Amendment,None,Failed,2,224,0,5,179,11,0,9,0,0,0,0,181,235,0,14
73,R,113,H R 2804,27-Feb-2014,1:57 PM,On Agreeing to the Amendment,None,Failed,0,224,0,7,180,8,0,11,0,0,0,0,180,232,0,18
74,R,113,H R 2804,27-Feb-2014,2:01 PM,On Agreeing to the Amendment,None,Failed,1,225,0,5,178,10,0,11,0,0,0,0,179,235,0,16
75,R,113,H R 2804,27-Feb-2014,2:05 PM,On Agreeing to the Amendment,None,Failed,2,222,0,7,181,7,0,11,0,0,0,0,183,229,0,18
76,R,113,H R 2804,27-Feb-2014,2:10 PM,On Agreeing to the Amendment,None,Failed,1,224,0,6,180,8,0,11,0,0,0,0,181,232,0,17
77,R,113,H R 2804,27-Feb-2014,2:31 PM,On Motion to Recommit with Instructions,"To amend title 5, United States Code, to require the Administrator of the Office of Information of Regulatory Affairs to publish information about rules on the Internet, and for other purposes",Failed,0,226,0,5,187,3,0,9,0,0,0,0,187,229,0,14
78,R,113,H R 2804,27-Feb-2014,2:38 PM,On Passage,"To amend title 5, United States Code, to require the Administrator of the Office of Information of Regulatory Affairs to publish information about rules on the Internet, and for other purposes",Passed,226,0,0,5,10,179,0,10,0,0,0,0,236,179,0,15
79,R,113,H RES 492,27-Feb-2014,5:43 PM,On Ordering the Previous Question,"Providing for consideration of the bill (H.R. 899) to provide for additional safeguards with respect to imposing Federal mandates, and for other purposes",Passed,225,0,0,6,0,192,0,7,0,0,0,0,225,192,0,13
80,R,113,H RES 492,27-Feb-2014,5:50 PM,On Agreeing to the Resolution,"Providing for consideration of the bill (H.R. 899) to provide for additional safeguards with respect to imposing Federal mandates, and for other purposes",Passed,225,0,0,6,2,190,0,7,0,0,0,0,227,190,0,13
81,R,113,H R 3193,27-Feb-2014,5:57 PM,On Agreeing to the Amendment,None,Agreed to,225,0,0,6,25,167,0,7,0,0,0,0,250,167,0,13
82,R,113,H R 3193,27-Feb-2014,6:01 PM,On Agreeing to the Amendment,None,Agreed to,223,0,0,8,4,186,0,9,0,0,0,0,227,186,0,17
83,R,113,H R 3193,27-Feb-2014,6:06 PM,On Agreeing to the Amendment,None,Failed,0,224,0,7,181,12,0,6,0,0,0,0,181,236,0,13
84,R,113,H R 3193,27-Feb-2014,6:30 PM,On Motion to Recommit with Instructions,Consumer Financial Protection Safety and Soundness Improvement Act of 2013,Failed,1,223,0,7,193,0,0,6,0,0,0,0,194,223,0,13
85,R,113,H R 3193,27-Feb-2014,6:39 PM,On Passage,Consumer Financial Protection Safety and Soundness Improvement Act of 2013,Passed,222,0,0,9,10,182,0,7,0,0,0,0,232,182,0,16
86,R,113,H R 899,28-Feb-2014,10:55 AM,On Agreeing to the Amendment,None,Failed,0,217,0,14,185,7,0,7,0,0,0,0,185,224,0,21
87,R,113,H R 899,28-Feb-2014,10:59 AM,On Agreeing to the Amendment,None,Failed,3,215,0,13,191,1,0,7,0,0,0,0,194,216,0,20
88,R,113,H R 899,28-Feb-2014,11:04 AM,On Agreeing to the Amendment,None,Failed,1,217,0,13,179,15,0,5,0,0,0,0,180,232,0,18
89,R,113,H R 899,28-Feb-2014,11:24 AM,On Motion to Recommit with Instructions,Unfunded Mandates Information and Transparency Act of 2013,Failed,1,218,0,12,191,0,0,8,0,0,0,0,192,218,0,20
90,R,113,H R 899,28-Feb-2014,11:31 AM,On Passage,Unfunded Mandates Information and Transparency Act of 2013,Passed,217,0,0,14,17,176,0,6,0,0,0,0,234,176,0,20
91,R,113,H R 3370,4-Mar-2014,6:56 PM,"On Motion to Suspend the Rules and Pass, as Amended",Homeowner Flood Insurance Affordability Act of 2014,Passed,126,86,0,19,180,5,0,14,0,0,0,0,306,91,0,33
92,R,113,H RES 488,4-Mar-2014,7:04 PM,"On Motion to Suspend the Rules and Agree, as Amended",Supporting the people of Venezuela as they protest peacefully for democratic change and calling to end the violence,Passed,209,1,0,21,184,0,0,15,0,0,0,0,393,1,0,36
93,R,113,H RES 497,5-Mar-2014,1:37 PM,On Ordering the Previous Question,"Providing for consideration of H.R. 3826, Electricity Security and Affordability Act, and providing for consideration of H.R. 4118, Suspending the Individual Mandate Penalty Law Equals Fairness Act",Passed,221,0,0,10,0,184,0,15,0,0,0,0,221,184,0,25
94,R,113,H RES 497,5-Mar-2014,1:44 PM,On Agreeing to the Resolution,"Providing for consideration of H.R. 3826, Electricity Security and Affordability Act, and providing for consideration of H.R. 4118, Suspending the Individual Mandate Penalty Law Equals Fairness Act",Passed,224,0,0,7,4,182,0,13,0,0,0,0,228,182,0,20
95,R,113,H R 938,5-Mar-2014,1:55 PM,"On Motion to Suspend the Rules and Pass, as Amended","To strengthen the strategic alliance between the United States and Israel, and for other purposes",Passed,223,1,0,7,187,0,0,12,0,0,0,0,410,1,0,19
96,R,113,H R 4118,5-Mar-2014,3:29 PM,On Motion to Recommit with Instructions,To amend the Internal Revenue Code of 1986 to delay the implementation of the penalty for failure to comply with the individual health insurance mandate,Failed,0,225,0,6,185,2,0,12,0,0,0,0,185,227,0,18
97,R,113,H R 4118,5-Mar-2014,3:38 PM,On Passage,To amend the Internal Revenue Code of 1986 to delay the implementation of the penalty for failure to comply with the individual health insurance mandate,Passed,223,1,0,7,27,159,0,13,0,0,0,0,250,160,0,20
98,R,113,H R 2126,5-Mar-2014,3:46 PM,"On Motion to Suspend the Rules and Pass, as Amended","To facilitate better alignment, cooperation, and best practices between commercial real estate landlords and tenants regarding energy efficiency in buildings, and for other purposes",Passed,191,33,0,7,184,3,0,12,0,0,0,0,375,36,0,19
99,R,113,H RES 501,6-Mar-2014,10:18 AM,On Ordering the Previous Question,Providing for consideration of the bill (H.R. 2824) Preventing Government Waste and Protecting Coal Mining Jobs in America; providing for consideration of the bill (H.R. 2641) Responsibly And Professionally Invigorating Development Act or as the “RAPID Act”; and providing for motions to suspend the rules.,Passed,219,0,0,12,0,191,0,8,0,0,0,0,219,191,0,20
100,R,113,H RES 501,6-Mar-2014,10:28 AM,On Agreeing to the Resolution,Providing for consideration of the bill (H.R. 2824) Preventing Government Waste and Protecting Coal Mining Jobs in America; providing for consideration of the bill (H.R. 2641) Responsibly And Professionally Invigorating Development Act or as the “RAPID Act”; and providing for motions to suspend the rules.,Passed,224,0,0,7,1,190,0,8,0,0,0,0,225,190,0,15
101,R,113,H R 3826,6-Mar-2014,10:34 AM,On Agreeing to the Amendment,None,Agreed to,222,2,0,7,8,182,0,9,0,0,0,0,230,184,0,16
102,R,113,H R 3826,6-Mar-2014,10:38 AM,On Agreeing to the Amendment,None,Failed,2,221,0,8,182,7,0,10,0,0,0,0,184,228,0,18
103,R,113,H R 3826,6-Mar-2014,10:42 AM,On Agreeing to the Amendment,None,Failed,3,219,0,9,187,2,0,10,0,0,0,0,190,221,0,19
104,R,113,H R 3826,6-Mar-2014,10:46 AM,On Agreeing to the Amendment,None,Failed,0,222,0,9,178,9,0,12,0,0,0,0,178,231,0,21
105,R,113,H R 3826,6-Mar-2014,11:04 AM,On Motion to Recommit with Instructions,Electricity Security and Affordability Act,Failed,0,220,0,11,184,3,0,12,0,0,0,0,184,223,0,23
106,R,113,H R 3826,6-Mar-2014,11:11 AM,On Passage,Electricity Security and Affordability Act,Passed,219,3,0,9,10,180,0,9,0,0,0,0,229,183,0,18
107,R,113,H RES 504,6-Mar-2014,2:08 PM,On Motion to Table,None,Passed,211,0,6,14,0,186,4,9,0,0,0,0,211,186,10,23
108,R,113,H R 2641,6-Mar-2014,2:15 PM,On Agreeing to the Amendment,None,Failed,1,218,0,12,179,10,0,10,0,0,0,0,180,228,0,22
109,R,113,H R 2641,6-Mar-2014,2:20 PM,On Agreeing to the Amendment,None,Agreed to,218,2,0,11,4,186,0,9,0,0,0,0,222,188,0,20
110,R,113,H R 2641,6-Mar-2014,2:24 PM,On Agreeing to the Amendment,None,Failed,3,215,0,13,184,5,0,10,0,0,0,0,187,220,0,23
111,R,113,H R 2641,6-Mar-2014,2:29 PM,On Agreeing to the Amendment,None,Failed,4,214,0,13,188,3,0,8,0,0,0,0,192,217,0,21
112,R,113,H R 2641,6-Mar-2014,2:47 PM,On Motion to Recommit with Instructions,Responsibly And Professionally Invigorating Development (RAPID) Act of 2013,Failed,0,217,0,14,190,0,0,9,0,0,0,0,190,217,0,23
113,R,113,H R 2641,6-Mar-2014,2:54 PM,On Passage,Responsibly And Professionally Invigorating Development (RAPID) Act of 2013,Passed,217,0,0,14,12,179,0,8,0,0,0,0,229,179,0,22
114,R,113,H R 4152,6-Mar-2014,3:01 PM,On Motion to Suspend the Rules and Pass,To provide for the costs of loan guarantees for Ukraine,Passed,194,23,0,14,191,0,0,8,0,0,0,0,385,23,0,22
115,R,113,H R 3474,11-Mar-2014,6:54 PM,On Motion to Suspend the Rules and Pass,Hire More Heroes Act of 2013,Passed,223,0,0,8,183,1,0,15,0,0,0,0,406,1,0,23
116,R,113,H R 3979,11-Mar-2014,7:02 PM,"On Motion to Suspend the Rules and Pass, as Amended",Protecting Volunteer Firefighters and Emergency Responders Act of 2014,Passed,224,0,0,7,186,0,0,13,0,0,0,0,410,0,0,20
117,R,113,H RES 499,11-Mar-2014,7:11 PM,"On Motion to Suspend the Rules and Agree, as Amended","Condemning the violation of Ukrainian sovereignty, independence, and territorial integrity by military forces of the Russian Federation",Passed,218,5,1,7,184,2,0,13,0,0,0,0,402,7,1,20
118,R,113,H RES 511,12-Mar-2014,1:46 PM,On Ordering the Previous Question,"Providing for consideration of the bill (H.R. 4138) to protect the separation of powers in the Constitution of the United States by ensuring that the President takes care that the laws be faithfully executed, and providing for consideration of the bill (H.R. 3973) to amend section 530D of title 28, United States Code",Passed,227,0,0,4,0,190,0,9,0,0,0,0,227,190,0,13
119,R,113,H RES 511,12-Mar-2014,1:53 PM,On Agreeing to the Resolution,"Providing for consideration of the bill (H.R. 4138) to protect the separation of powers in the Constitution of the United States by ensuring that the President takes care that the laws be faithfully executed, and providing for consideration of the bill (H.R. 3973) to amend section 530D of title 28, United States Code",Passed,227,0,0,4,2,192,0,5,0,0,0,0,229,192,0,9
120,R,113,H R 4138,12-Mar-2014,4:21 PM,On Agreeing to the Amendment,None,Failed,1,227,0,3,187,0,0,12,0,0,0,0,188,227,0,15
121,R,113,H R 4138,12-Mar-2014,4:29 PM,On Agreeing to the Amendment,None,Failed,4,224,0,3,186,1,0,12,0,0,0,0,190,225,0,15
122,R,113,H R 4138,12-Mar-2014,4:35 PM,On Agreeing to the Amendment,None,Failed,1,227,0,3,184,4,0,11,0,0,0,0,185,231,0,14
123,R,113,H R 4138,12-Mar-2014,4:56 PM,On Motion to Recommit with Instructions,Executive Needs to Faithfully Observe and Respect Congressional Enactments of the Law Act of 2014,Failed,0,228,0,3,187,0,0,12,0,0,0,0,187,228,0,15
124,R,113,H R 4138,12-Mar-2014,5:03 PM,On Passage,Executive Needs to Faithfully Observe and Respect Congressional Enactments of the Law Act of 2014,Passed,228,0,0,3,5,181,0,13,0,0,0,0,233,181,0,16
125,R,113,H RES 515,13-Mar-2014,2:04 PM,On Ordering the Previous Question,"Providing for consideration of H.R. 3189, the Water Rights Protection Act; and providing for consideration of H.R. 4015, the SGR Repeal and Medicare Provider Payment Modernization Act of 2014",Passed,227,0,0,4,0,193,0,6,0,0,0,0,227,193,0,10
126,R,113,H RES 515,13-Mar-2014,2:23 PM,On Agreeing to the Resolution,"Providing for consideration of H.R. 3189, the Water Rights Protection Act; and providing for consideration of H.R. 4015, the SGR Repeal and Medicare Provider Payment Modernization Act of 2014",Passed,225,0,0,7,3,184,0,12,0,0,0,0,228,184,0,19
127,R,113,H R 3973,13-Mar-2014,4:42 PM,On Agreeing to the Amendment,None,Failed,0,225,0,7,191,2,0,6,0,0,0,0,191,227,0,13
128,R,113,H R 3973,13-Mar-2014,5:02 PM,On Motion to Recommit with Instructions,Faithful Execution of the Law Act of 2014,Failed,0,225,0,7,192,0,0,7,0,0,0,0,192,225,0,14
129,R,113,H R 3973,13-Mar-2014,5:14 PM,On Passage,Faithful Execution of the Law Act of 2014,Passed,226,1,0,5,18,170,0,11,0,0,0,0,244,171,0,16
130,R,113,H R 3189,13-Mar-2014,5:20 PM,On Agreeing to the Amendment,None,Failed,0,226,0,6,175,10,0,14,0,0,0,0,175,236,0,20
131,R,113,H R 3189,13-Mar-2014,5:35 PM,On Motion to Recommit with Instructions,"To prohibit the conditioning of any permit, lease, or other use agreement on the transfer, relinquishment, or other impairment of any water right to the United States by the Secretaries of the Interior and Agriculture",Failed,0,224,0,8,183,3,0,13,0,0,0,0,183,227,0,21
132,R,113,H R 3189,13-Mar-2014,5:41 PM,On Passage,"To prohibit the conditioning of any permit, lease, or other use agreement on the transfer, relinquishment, or other impairment of any water right to the United States by the Secretaries of the Interior and Agriculture",Passed,226,0,0,6,12,174,0,13,0,0,0,0,238,174,0,19
133,R,113,H RES 517,13-Mar-2014,6:10 PM,On Motion to Table,Raising a question of the privileges of the House,Passed,216,0,6,10,1,173,4,21,0,0,0,0,217,173,10,31
134,R,113,H R 4015,14-Mar-2014,11:07 AM,On Motion to Recommit with Instructions,"To amend title XVIII of the Social Security Act to repeal the Medicare sustainable growth rate and improve Medicare payments for physicians and other professionals, and for other purposes",Failed,0,226,0,6,191,0,0,8,0,0,0,0,191,226,0,14
135,R,113,H R 4015,14-Mar-2014,11:15 AM,On Passage,"To amend title XVIII of the Social Security Act to repeal the Medicare sustainable growth rate and improve Medicare payments for physicians and other professionals, and for other purposes",Passed,226,0,0,6,12,181,0,6,0,0,0,0,238,181,0,12
136,R,113,H R 3060,24-Mar-2014,6:57 PM,On Motion to Suspend the Rules and Pass,"Sergeant William Moody Post Office Building in Burleson, Texas",Passed,218,0,0,14,180,0,0,19,0,0,0,0,398,0,0,33
137,R,113,H R 1813,24-Mar-2014,7:08 PM,"On Motion to Suspend the Rules and Pass, as Amended","Lance Corporal Daniel Nathan Deyarmin Post Office Building in Tallmadge, Ohio",Passed,216,0,0,16,177,0,0,22,0,0,0,0,393,0,0,38
138,R,113,H R 2824,25-Mar-2014,2:27 PM,On Agreeing to the Amendment,None,Failed,2,225,0,5,186,6,0,7,0,0,0,0,188,231,0,12
139,R,113,H R 2824,25-Mar-2014,2:35 PM,On Agreeing to the Amendment,None,Failed,6,220,0,6,190,5,0,4,0,0,0,0,196,225,0,10
140,R,113,H R 2824,25-Mar-2014,2:54 PM,On Motion to Recommit with Instructions,"To amend the Surface Mining Control and Reclamation Act of 1977 to stop the ongoing waste by the Department of the Interior of taxpayer resources and implement the final rule on excess spoil, mining waste, and buffers for perennial and intermittent streams, and for other purposes",Failed,2,224,0,6,195,0,0,4,0,0,0,0,197,224,0,10
141,R,113,H R 2824,25-Mar-2014,3:06 PM,On Passage,"To amend the Surface Mining Control and Reclamation Act of 1977 to stop the ongoing waste by the Department of the Interior of taxpayer resources and implement the final rule on excess spoil, mining waste, and buffers for perennial and intermittent streams, and for other purposes",Passed,219,7,0,6,10,185,0,4,0,0,0,0,229,192,0,10
142,R,113,H RES 524,26-Mar-2014,2:25 PM,On Ordering the Previous Question,"Providing for consideration of H.R. 1459, the Ensuring Public Involvement in the Creation of National Monuments Act",Passed,228,0,0,4,2,187,0,10,0,0,0,0,230,187,0,14
143,R,113,H RES 524,26-Mar-2014,2:33 PM,On Agreeing to the Resolution,"Providing for consideration of H.R. 1459, the Ensuring Public Involvement in the Creation of National Monuments Act",Passed,227,0,0,5,0,190,0,9,0,0,0,0,227,190,0,14
144,R,113,H R 1228,26-Mar-2014,2:42 PM,"On Motion to Suspend the Rules and Pass, as Amended","Corporal Justin D. Ross Post Office Building in Green Bay, Wisconsin",Passed,226,0,0,6,192,0,0,7,0,0,0,0,418,0,0,13
145,R,113,H R 1459,26-Mar-2014,4:28 PM,On Agreeing to the Amendment,None,Failed,7,222,0,3,190,1,0,8,0,0,0,0,197,223,0,11
146,R,113,H R 1459,26-Mar-2014,4:47 PM,On Motion to Recommit with Instructions,"To ensure that the National Environmental Policy Act of 1969 applies to the declaration of national monuments, and for other purposes",Failed,0,227,0,5,193,0,0,6,0,0,0,0,193,227,0,11
147,R,113,H R 1459,26-Mar-2014,4:56 PM,On Passage,"To ensure that the National Environmental Policy Act of 1969 applies to the declaration of national monuments, and for other purposes",Passed,219,10,0,3,3,191,0,5,0,0,0,0,222,201,0,8
148,R,113,H R 4278,27-Mar-2014,12:33 PM,"On Motion to Suspend the Rules and Pass, as Amended","To support the independence, sovereignty, and territorial integrity of Ukraine, and for other purposes",Passed,210,17,0,5,189,2,0,8,0,0,0,0,399,19,0,13
149,R,113,H R 4152,1-Apr-2014,6:55 PM,On Motion to Suspend the Rules and Concur in the Senate Amendment,To provide for the costs of loan guarantees for Ukraine,Passed,190,32,0,10,188,2,0,9,0,0,0,0,378,34,0,19
150,R,113,S 2183,1-Apr-2014,7:03 PM,On Motion to Suspend the Rules and Pass,United States international programming to Ukraine and neighboring regions,Passed,211,10,0,11,188,2,0,9,0,0,0,0,399,12,0,20
151,R,113,JOURNAL,1-Apr-2014,7:12 PM,On Approving the Journal,None,Passed,134,85,1,12,127,55,1,16,0,0,0,0,261,140,2,28
152,R,113,H RES 530,2-Apr-2014,1:47 PM,On Ordering the Previous Question,Providing for consideration of the bill (H.R. 2575) to amend the Internal Revenue Code of 1986 to repeal the 30-hour threshold for classification as a full-time employee for purposes of the employer mandate in the Patient Protection and Affordable Care Act and replace it with 40 hours,Passed,229,0,0,3,0,194,0,5,0,0,0,0,229,194,0,8
153,R,113,H RES 530,2-Apr-2014,1:55 PM,On Agreeing to the Resolution,Providing for consideration of the bill (H.R. 2575) to amend the Internal Revenue Code of 1986 to repeal the 30-hour threshold for classification as a full-time employee for purposes of the employer mandate in the Patient Protection and Affordable Care Act and replace it with 40 hours,Passed,229,0,0,3,7,186,0,6,0,0,0,0,236,186,0,9
154,R,113,JOURNAL,2-Apr-2014,2:02 PM,On Approving the Journal,None,Passed,146,83,1,2,116,74,1,8,0,0,0,0,262,157,2,10
155,R,113,H R 2575,3-Apr-2014,3:10 PM,On Motion to Recommit with Instructions,Save American Workers Act of 2014,Failed,0,228,0,4,191,4,0,4,0,0,0,0,191,232,0,8
156,R,113,H R 2575,3-Apr-2014,3:21 PM,On Passage,Save American Workers Act of 2014,Passed,230,0,0,2,18,179,0,2,0,0,0,0,248,179,0,4
157,R,113,H RES 539,4-Apr-2014,10:47 AM,On Ordering the Previous Question,"Providing for consideration of the bill (H.R. 1874) the Pro-Growth Budgeting Act, providing for consideration of the bill (H.R. 1871) Baseline Reform Act and providing for consideration of the bill (H.R. 1872) Budget and Accounting Transparency Act and for other purposes",Passed,222,0,0,10,0,193,0,6,0,0,0,0,222,193,0,16
158,R,113,H RES 539,4-Apr-2014,10:54 AM,On Agreeing to the Resolution,"Providing for consideration of the bill (H.R. 1874) the Pro-Growth Budgeting Act, providing for consideration of the bill (H.R. 1871) Baseline Reform Act and providing for consideration of the bill (H.R. 1872) Budget and Accounting Transparency Act and for other purposes",Passed,220,0,0,12,0,194,0,5,0,0,0,0,220,194,0,17
159,R,113,H R 1874,4-Apr-2014,1:03 PM,On Agreeing to the Amendment,None,Failed,6,209,0,17,176,5,0,18,0,0,0,0,182,214,0,35
160,R,113,H R 1874,4-Apr-2014,1:08 PM,On Agreeing to the Amendment,None,Failed,8,209,0,15,181,2,0,16,0,0,0,0,189,211,0,31
161,R,113,H R 1874,4-Apr-2014,1:12 PM,On Agreeing to the Amendment,None,Failed,4,215,0,13,182,4,0,13,0,0,0,0,186,219,0,26
162,R,113,H R 1874,4-Apr-2014,1:17 PM,On Agreeing to the Amendment,None,Failed,4,216,0,12,181,6,0,12,0,0,0,0,185,222,0,24
163,R,113,H R 1874,4-Apr-2014,1:32 PM,On Motion to Recommit with Instructions,Pro-Growth Budgeting Act,Failed,1,218,0,13,186,0,0,13,0,0,0,0,187,218,0,26
164,R,113,H R 1874,4-Apr-2014,1:41 PM,On Passage,Pro-Growth Budgeting Act,Passed,220,0,0,12,4,182,0,13,0,0,0,0,224,182,0,25
165,R,113,H R 1872,7-Apr-2014,6:57 PM,On Motion to Recommit with Instructions,Budget and Accounting Transparency Act,Failed,0,215,0,17,179,2,0,18,0,0,0,0,179,217,0,35
166,R,113,H R 1872,7-Apr-2014,7:04 PM,On Passage,Budget and Accounting Transparency Act,Passed,214,0,0,18,16,165,0,18,0,0,0,0,230,165,0,36
167,R,113,H R 1871,8-Apr-2014,2:56 PM,On Motion to Recommit with Instructions,Baseline Reform Act,Failed,1,221,0,10,190,0,0,9,0,0,0,0,191,221,0,19
168,R,113,H R 1871,8-Apr-2014,3:03 PM,On Passage,Baseline Reform Act,Passed,223,0,0,9,7,185,0,7,0,0,0,0,230,185,0,16
169,R,113,H RES 544,8-Apr-2014,3:10 PM,On Ordering the Previous Question,"Providing for consideration of the concurrent resolution (H.Con.Res. 96) establishing the budget for the United States Government for fiscal year 2015 and setting forth appropriate budgetary levels for fiscal years 2016 through 2024, and providing for proceedings from April 11, 2014, through April 25, 2014",Passed,219,0,0,13,0,190,0,9,0,0,0,0,219,190,0,22
170,R,113,H RES 544,8-Apr-2014,3:17 PM,On Agreeing to the Resolution,"Providing for consideration of the concurrent resolution (H.Con.Res. 96) establishing the budget for the United States Government for fiscal year 2015 and setting forth appropriate budgetary levels for fiscal years 2016 through 2024, and providing for proceedings from April 11, 2014, through April 25, 2014",Passed,222,1,0,9,0,193,0,6,0,0,0,0,222,194,0,15
171,R,113,H CON RES 96,9-Apr-2014,5:24 PM,On Agreeing to the Amendment,None,Failed,0,224,0,8,2,189,0,8,0,0,0,0,2,413,0,16
172,R,113,H CON RES 96,9-Apr-2014,5:31 PM,On Agreeing to the Amendment,None,Failed,0,224,0,8,116,76,0,7,0,0,0,0,116,300,0,15
173,R,113,H CON RES 96,9-Apr-2014,5:43 PM,On Agreeing to the Amendment,None,Failed,0,224,0,8,89,103,0,7,0,0,0,0,89,327,0,15
174,R,113,H R 4414,9-Apr-2014,5:53 PM,On Motion to Suspend the Rules and Pass,Expatriate Health Coverage Clarification Act of 2014,Failed,205,20,0,7,52,139,0,8,0,0,0,0,257,159,0,15
175,R,113,H CON RES 96,10-Apr-2014,10:20 AM,On Agreeing to the Amendment,None,Failed,133,97,0,2,0,194,0,5,0,0,0,0,133,291,0,7
176,R,113,H CON RES 96,10-Apr-2014,11:26 AM,On Agreeing to the Amendment,None,Failed,0,230,0,2,163,31,0,5,0,0,0,0,163,261,0,7
177,R,113,H CON RES 96,10-Apr-2014,12:01 PM,On Agreeing to the Resolution,Establishing the budget for the United States Government for fiscal year 2015 and setting forth appropriate budgetary levels for fiscal years 2016 through 2024,Passed,219,12,0,2,0,193,0,6,0,0,0,0,219,205,0,8
178,R,113,H R 4192,28-Apr-2014,6:57 PM,"On Motion to Suspend the Rules and Pass, as Amended",To amend the Act entitled “An Act to regulate the height of buildings in the District of Columbia” to clarify the rules of the District of Columbia regarding human occupancy of penthouses above the top story of the building upon which the penthouse is placed.,Passed,197,15,0,20,170,1,0,28,0,0,0,0,367,16,0,48
179,R,113,H R 4120,28-Apr-2014,7:06 PM,On Motion to Suspend the Rules and Pass,To amend the National Law Enforcement Museum Act to extend the termination date,Passed,211,0,0,21,173,0,0,26,0,0,0,0,384,0,0,47
180,R,113,H RES 555,29-Apr-2014,2:18 PM,On Ordering the Previous Question,"Providing for consideration of H.R. 4414, Expatriate Health Coverage Clarification Act of 2014",Passed,224,0,0,8,2,189,0,8,0,0,0,0,226,189,0,16
181,R,113,H RES 555,29-Apr-2014,2:25 PM,On Agreeing to the Resolution,"Providing for consideration of H.R. 4414, Expatriate Health Coverage Clarification Act of 2014",Passed,226,0,0,6,12,181,0,6,0,0,0,0,238,181,0,12
182,R,113,H R 4414,29-Apr-2014,3:43 PM,On Passage,Expatriate Health Coverage Clarification Act of 2014,Passed,208,17,0,7,60,133,0,6,0,0,0,0,268,150,0,13
183,R,113,H R 627,29-Apr-2014,3:53 PM,"On Motion to Suspend the Rules and Pass, as Amended",National Park Service 100th Anniversary Commemorative Coin Act,Passed,211,13,0,8,192,0,0,7,0,0,0,0,403,13,0,15
184,R,113,H RES 557,30-Apr-2014,1:39 PM,On Ordering the Previous Question,"Providing for consideration of (H.R. 4486) making appropriations for military construction, the Department of Veterans Affairs, and related agencies for FY 2015, and providing for consideration of (H.R. 4487) making appropriations for the Legislative Branch for FY 2015.",Passed,227,0,0,5,0,189,0,10,0,0,0,0,227,189,0,15
185,R,113,H R 4486,30-Apr-2014,7:01 PM,On Agreeing to the Amendment,None,Failed,4,221,0,7,164,28,0,7,0,0,0,0,168,249,0,14
186,R,113,H R 4486,30-Apr-2014,7:12 PM,On Agreeing to the Amendment,None,Failed,22,204,0,6,173,18,0,8,0,0,0,0,195,222,0,14
187,R,113,H R 4486,30-Apr-2014,7:21 PM,On Passage,"Making appropriations for military construction, the Department of Veterans Affairs, and related agencies for the fiscal year ending September 30, 2015, and for other purposes",Passed,225,1,0,6,191,0,0,8,0,0,0,0,416,1,0,14
188,R,113,H R 4487,1-May-2014,11:26 AM,On Agreeing to the Amendment,None,Failed,137,89,0,6,59,132,0,8,0,0,0,0,196,221,0,14
189,R,113,H R 4487,1-May-2014,11:32 AM,On Agreeing to the Amendment,None,Agreed to,190,37,0,5,29,161,0,9,0,0,0,0,219,198,0,14
190,R,113,H R 4487,1-May-2014,11:36 AM,On Agreeing to the Amendment,None,Failed,185,43,0,4,22,169,0,8,0,0,0,0,207,212,0,12
191,R,113,H R 4487,1-May-2014,11:41 AM,On Agreeing to the Amendment,None,Failed,9,217,0,6,155,31,0,13,0,0,0,0,164,248,0,19
192,R,113,H R 4487,1-May-2014,12:02 PM,On Motion to Recommit with Instructions,"Making appropriations for Legislative Branch, FY 2015",Failed,4,222,0,6,190,0,0,9,0,0,0,0,194,222,0,15
193,R,113,H R 4487,1-May-2014,12:08 PM,On Passage,"Making appropriations for Legislative Branch, FY 2015",Passed,218,9,0,5,184,5,0,10,0,0,0,0,402,14,0,15
194,R,113,H R 4292,6-May-2014,6:56 PM,On Motion to Suspend the Rules and Pass,Foreign Cultural Exchange Jurisdictional Immunity Clarification Act,Passed,202,4,0,26,186,0,0,13,0,0,0,0,388,4,0,39
195,R,113,H R 3584,6-May-2014,7:04 PM,"On Motion to Suspend the Rules and Pass, as Amended",Capital Access for Small Community Financial Institutions Act,Passed,207,0,0,25,188,0,0,11,0,0,0,0,395,0,0,36
196,R,113,JOURNAL,6-May-2014,7:11 PM,On Approving the Journal,None,Passed,137,66,1,28,116,61,1,21,0,0,0,0,253,127,2,49
197,R,113,H RES 568,7-May-2014,3:42 PM,On Ordering the Previous Question,"Relating to the consideration of House Report 113-415 and an accompanying resolution, and providing for consideration of the resolution (H.Res. 565) calling on Attorney General Eric H. Holder, Jr., to appoint a special counsel to investigate the targeting of conservative nonprofit groups by the Internal Revenue Service",Passed,223,0,0,9,0,192,0,7,0,0,0,0,223,192,0,16
198,R,113,H RES 568,7-May-2014,3:48 PM,On Agreeing to the Resolution,"Relating to the consideration of House Report 113-415 and an accompanying resolution, and providing for consideration of the resolution (H.Res. 565) calling on Attorney General Eric H. Holder, Jr., to appoint a special counsel to investigate the targeting of conservative nonprofit groups by the Internal Revenue Service",Passed,222,0,0,10,2,187,0,10,0,0,0,0,224,187,0,20
199,R,113,H RES 569,7-May-2014,3:54 PM,On Ordering the Previous Question,Providing for consideration of the bill (H.R. 4438) to amend the Internal Revenue Code of 1986 to simplify and make permanent the research credit,Passed,224,0,0,8,1,191,0,7,0,0,0,0,225,191,0,15
200,R,113,H RES 569,7-May-2014,4:01 PM,On Agreeing to the Resolution,Providing for consideration of the bill (H.R. 4438) to amend the Internal Revenue Code of 1986 to simplify and make permanent the research credit,Passed,224,0,0,8,6,188,0,5,0,0,0,0,230,188,0,13
201,R,113,H R 863,7-May-2014,4:12 PM,"On Motion to Suspend the Rules and Pass, as Amended","To establish the Commission to Study the Potential Creation of a National Women’s History Museum, and for other purposes",Passed,191,33,0,8,192,0,0,7,0,0,0,0,383,33,0,15
202,R,113,H RES 574,7-May-2014,6:55 PM,On the Motion to Refer the Resolution to the Committee on Oversight and Government Reform,"Recommending that the House of Representatives find Lois G. Lerner, former Director, Exempt Organizations, Internal Revenue Service, in contempt of Congress for refusal to comply with a subpoena duly issued by the Committee on Oversight & Government Reform",Failed,0,223,0,9,191,1,0,7,0,0,0,0,191,224,0,16
203,R,113,H RES 574,7-May-2014,7:02 PM,On Agreeing to the Resolution,"Recommending that the House of Representatives find Lois G. Lerner, former Director, Exempt Organizations, Internal Revenue Service, in contempt of Congress for refusal to comply with a subpoena duly issued by the Committee on Oversight & Government Reform",Passed,225,0,0,7,6,187,0,6,0,0,0,0,231,187,0,13
204,R,113,H RES 565,7-May-2014,7:10 PM,On Agreeing to the Resolution,"Calling on Attorney General Eric H. Holder, Jr., to appoint a special counsel to investigate the targeting of conservative nonprofit groups by the Internal Revenue Service",Passed,224,0,0,8,26,168,0,5,0,0,0,0,250,168,0,13
205,R,113,H RES 576,8-May-2014,3:47 PM,"On Agreeing to the Resolution, as Amended","Providing for consideration of H.R. 10, the Success and Opportunity through Quality Charter Schools Act and relating to consideration of H.R. 4438, the American Research and Competitiveness Act of 2014",Passed,223,0,0,9,9,178,0,12,0,0,0,0,232,178,0,21
206,R,113,H RES 575,8-May-2014,3:54 PM,On Ordering the Previous Question,"Providing for consideration of H.Res. 567, providing for the Establishment of the Select Committee on the Events Surrounding the 2012 Terrorist Attack in Benghazi",Passed,223,0,0,9,0,192,0,7,0,0,0,0,223,192,0,16
207,R,113,H RES 575,8-May-2014,4:02 PM,On Agreeing to the Resolution,"Providing for consideration of H.Res. 567, providing for the Establishment of the Select Committee on the Events Surrounding the 2012 Terrorist Attack in Benghazi",Passed,223,0,0,9,1,192,0,6,0,0,0,0,224,192,0,15
208,R,113,H R 2548,8-May-2014,4:11 PM,"On Motion to Suspend the Rules and Pass, as Amended",Electrify Africa Act of 2014,Passed,106,116,0,10,191,1,0,7,0,0,0,0,297,117,0,17
209,R,113,H RES 567,8-May-2014,6:29 PM,On Agreeing to the Resolution,Providing for the Establishment of the Select Committee on the Events Surrounding the 2012 Terrorist Attack in Benghazi,Passed,225,0,0,8,7,186,0,6,0,0,0,0,232,186,0,14
210,R,113,H R 4438,9-May-2014,9:49 AM,On Motion to Recommit with Instructions,American Research and Competitiveness Act of 2014,Failed,1,209,0,22,190,0,0,9,0,0,0,0,191,209,0,31
211,R,113,H R 4438,9-May-2014,9:58 AM,On Passage,American Research and Competitiveness Act of 2014,Passed,212,1,0,19,62,130,0,7,0,0,0,0,274,131,0,26
212,R,113,H R 10,9-May-2014,11:46 AM,On Agreeing to the Amendment,None,Failed,12,201,0,19,178,4,0,17,0,0,0,0,190,205,0,36
213,R,113,H R 10,9-May-2014,11:51 AM,On Agreeing to the Amendment,None,Failed,4,207,0,21,175,13,0,11,0,0,0,0,179,220,0,32
214,R,113,H R 10,9-May-2014,11:57 AM,On Agreeing to the Amendment,None,Agreed to,182,32,0,18,191,0,0,8,0,0,0,0,373,32,0,26
215,R,113,H R 10,9-May-2014,12:01 PM,On Agreeing to the Amendment,None,Agreed to,187,27,0,18,191,0,0,8,0,0,0,0,378,27,0,26
216,R,113,H R 10,9-May-2014,12:04 PM,On Agreeing to the Amendment,None,Agreed to,172,41,0,19,191,0,0,8,0,0,0,0,363,41,0,27
217,R,113,H R 10,9-May-2014,12:20 PM,On Passage,To amend the charter school program under the Elementary and Secondary Education Act of 1965.,Passed,202,11,0,20,158,34,0,7,0,0,0,0,360,45,0,27
218,R,113,H R 2203,19-May-2014,6:56 PM,"On Motion to Suspend the Rules and Pass, as Amended","To provide for the award of a gold medal on behalf of Congress to Jack Nicklaus, in recognition of his service to the Nation in promoting excellence, good sportsmanship, and philanthropy",Passed,199,10,0,23,172,0,0,27,0,0,0,0,371,10,0,50
219,R,113,H R 685,19-May-2014,7:04 PM,"On Motion to Suspend the Rules and Pass, as Amended","To award a Congressional Gold Medal to the American Fighter Aces, collectively, in recognition of their heroic military service and defense of our country’s freedom throughout the history of aviation warfare",Passed,210,0,0,22,171,0,0,28,0,0,0,0,381,0,0,50
220,R,113,H R 3080,20-May-2014,2:01 PM,On Motion to Suspend the Rules and Agree to the Conference Report,"To provide for improvements to the rivers and harbors of the United States, to provide for the conservation and development of water and related resources, and for other purposes",Passed,223,4,0,5,189,0,0,10,0,0,0,0,412,4,0,15
221,R,113,H R 3530,20-May-2014,6:26 PM,"On Motion to Suspend the Rules and Pass, as Amended",Justice for Victims of Trafficking Act,Passed,219,0,0,13,190,0,0,9,0,0,0,0,409,0,0,22
222,R,113,H R 4225,20-May-2014,6:35 PM,"On Motion to Suspend the Rules and Pass, as Amended",Stop Advertising Victims of Exploitation (SAVE) Act of 2014,Passed,220,1,0,11,172,18,0,9,0,0,0,0,392,19,0,20
223,R,113,ADJOURN,21-May-2014,12:56 PM,On Motion to Adjourn,None,Failed,1,213,0,18,6,168,0,25,0,0,0,0,7,381,0,43
224,R,113,ADJOURN,21-May-2014,3:11 PM,On Motion to Adjourn,None,Failed,1,208,0,23,22,153,0,24,0,0,0,0,23,361,0,47
225,R,113,H R 4435,21-May-2014,5:37 PM,On Agreeing to the Amendment,None,Failed,11,216,0,5,181,13,0,5,0,0,0,0,192,229,0,10
226,R,113,H R 4435,21-May-2014,5:44 PM,On Agreeing to the Amendment,None,Failed,4,223,0,5,190,4,0,5,0,0,0,0,194,227,0,10
227,R,113,H R 4435,21-May-2014,5:49 PM,On Agreeing to the Amendment,None,Agreed to,218,7,0,7,4,189,0,6,0,0,0,0,222,196,0,13
228,R,113,H RES 590,21-May-2014,5:58 PM,On Agreeing to the Resolution,Providing for further consideration of the bill (H.R. 4435) “Howard P. ’Buck’ McKeon National Defense Authorization Act of FY 2015”; and providing for consideration of the bill (H.R. 3361) USA FREEDOM Act,Passed,223,4,0,5,8,186,0,5,0,0,0,0,231,190,0,10
229,R,113,H R 4031,21-May-2014,6:08 PM,On Motion to Suspend the Rules and Pass,Department of Veterans Affairs Management Accountability Act,Passed,228,0,0,4,162,33,0,4,0,0,0,0,390,33,0,8
230,R,113,H R 3361,22-May-2014,11:03 AM,On Passage,USA FREEDOM Act,Passed,179,51,0,2,124,70,0,5,0,0,0,0,303,121,0,7
231,R,113,H R 4435,22-May-2014,11:11 AM,On Agreeing to the Amendment,None,Agreed to,227,3,0,2,4,189,0,6,0,0,0,0,231,192,0,8
232,R,113,H R 4435,22-May-2014,11:16 AM,On Agreeing to the Amendment,None,Agreed to,228,0,0,4,17,177,0,5,0,0,0,0,245,177,0,9
233,R,113,H R 4435,22-May-2014,11:21 AM,On Agreeing to the Amendment,None,Failed,6,224,0,2,171,23,0,5,0,0,0,0,177,247,0,7
234,R,113,H R 4435,22-May-2014,11:24 AM,On Agreeing to the Amendment,None,Failed,15,214,0,3,176,16,0,7,0,0,0,0,191,230,0,10
235,R,113,H R 4435,22-May-2014,11:28 AM,On Agreeing to the Amendment,None,Failed,178,51,0,3,1,193,0,5,0,0,0,0,179,244,0,8
236,R,113,H R 4435,22-May-2014,11:32 AM,On Agreeing to the Amendment,None,Agreed to,226,4,0,2,7,187,0,5,0,0,0,0,233,191,0,7
237,R,113,H R 4435,22-May-2014,11:36 AM,On Agreeing to the Amendment,None,Failed,27,203,0,2,164,30,0,5,0,0,0,0,191,233,0,7
238,R,113,H R 4435,22-May-2014,11:40 AM,On Agreeing to the Amendment,None,Agreed to,33,197,0,2,191,2,0,6,0,0,0,0,224,199,0,8
239,R,113,H R 4435,22-May-2014,11:58 AM,On Motion to Recommit with Instructions,"To authorize appropriations for fiscal year 2015 for military activities of the Department of Defense and for military construction, to prescribe military personnel strengths for such fiscal year, and for other purposes",Failed,0,227,0,5,194,0,0,5,0,0,0,0,194,227,0,10
240,R,113,H R 4435,22-May-2014,12:16 PM,On Passage,"To authorize appropriations for fiscal year 2015 for military activities of the Department of Defense and for military construction, to prescribe military personnel strengths for such fiscal year, and for other purposes",Passed,216,13,0,3,109,85,0,5,0,0,0,0,325,98,0,8
241,R,113,H RES 599,28-May-2014,6:57 PM,On Motion to Suspend the Rules and Agree,"Urging the Government of the People’s Republic of China to respect the freedom of assembly, expression, and religion and all fundamental human rights and the rule of law for all its citizens and to stop censoring discussion of the 1989 Tiananmen Square demonstrations and their violent suppression",Passed,206,1,0,25,173,0,0,26,0,0,0,0,379,1,0,51
242,R,113,H R 503,28-May-2014,7:09 PM,"On Motion to Suspend the Rules and Pass, as Amended",National Desert Storm and Desert Shield War Memorial Act,Passed,207,0,0,25,163,0,0,36,0,0,0,0,370,0,0,61
243,R,113,H R 4660,29-May-2014,1:44 PM,On Agreeing to the Amendment,None,Failed,129,93,0,10,0,187,0,12,0,0,0,0,129,280,0,22
244,R,113,H R 4660,29-May-2014,1:53 PM,On Agreeing to the Amendment,None,Agreed to,136,86,0,10,170,20,0,9,0,0,0,0,306,106,0,19
245,R,113,H R 4660,29-May-2014,1:59 PM,On Agreeing to the Amendment,None,Agreed to,212,9,0,11,128,62,0,9,0,0,0,0,340,71,0,20
246,R,113,H R 4660,29-May-2014,2:05 PM,On Agreeing to the Amendment,None,Agreed to,213,9,0,10,5,184,0,10,0,0,0,0,218,193,0,20
247,R,113,H R 4660,29-May-2014,2:09 PM,On Agreeing to the Amendment,None,Failed,3,218,0,11,124,64,0,11,0,0,0,0,127,282,0,22
248,R,113,H R 4660,29-May-2014,2:15 PM,On Agreeing to the Amendment,None,Failed,10,212,0,10,163,26,0,10,0,0,0,0,173,238,0,20
249,R,113,H R 4660,29-May-2014,6:23 PM,On Agreeing to the Amendment,None,Agreed to,76,142,0,14,184,3,1,11,0,0,0,0,260,145,1,25
250,R,113,H R 4660,29-May-2014,6:27 PM,On Agreeing to the Amendment,None,Failed,25,193,0,14,41,146,0,12,0,0,0,0,66,339,0,26
251,R,113,H R 4660,29-May-2014,6:31 PM,On Agreeing to the Amendment,None,Failed,43,178,0,11,153,34,0,12,0,0,0,0,196,212,0,23
252,R,113,H R 4660,29-May-2014,6:36 PM,On Agreeing to the Amendment,None,Agreed to,203,18,0,11,5,183,0,11,0,0,0,0,208,201,0,22
253,R,113,H R 4660,29-May-2014,6:40 PM,On Agreeing to the Amendment,None,Failed,116,104,0,12,0,186,0,13,0,0,0,0,116,290,0,25
254,R,113,H R 4660,30-May-2014,12:08 AM,On Agreeing to the Amendment,None,Failed,9,206,0,17,160,24,0,15,0,0,0,0,169,230,0,32
255,R,113,H R 4660,30-May-2014,12:11 AM,On Agreeing to the Amendment,None,Failed,141,78,0,13,7,175,0,17,0,0,0,0,148,253,0,30
256,R,113,H R 4660,30-May-2014,12:15 AM,On Agreeing to the Amendment,None,Failed,196,24,0,12,2,184,0,13,0,0,0,0,198,208,0,25
257,R,113,H R 4660,30-May-2014,12:18 AM,On Agreeing to the Amendment,None,Agreed to,66,154,0,12,171,16,0,12,0,0,0,0,237,170,0,24
258,R,113,H R 4660,30-May-2014,12:22 AM,On Agreeing to the Amendment,None,Agreed to,49,172,0,11,170,17,0,12,0,0,0,0,219,189,0,23
259,R,113,H R 4660,30-May-2014,12:25 AM,On Agreeing to the Amendment,None,Agreed to,214,7,0,11,5,182,0,12,0,0,0,0,219,189,0,23
260,R,113,H R 4660,30-May-2014,12:29 AM,On Agreeing to the Amendment,None,Agreed to,75,146,0,11,171,16,0,12,0,0,0,0,246,162,0,23
261,R,113,H R 4660,30-May-2014,12:33 AM,On Agreeing to the Amendment,None,Failed,167,54,0,11,18,169,0,12,0,0,0,0,185,223,0,23
262,R,113,H R 4660,30-May-2014,12:36 AM,On Agreeing to the Amendment,None,Failed,10,211,0,11,186,0,0,13,0,0,0,0,196,211,0,24
263,R,113,H R 4660,30-May-2014,12:39 AM,On Agreeing to the Amendment,None,Agreed to,53,168,0,11,172,15,0,12,0,0,0,0,225,183,0,23
264,R,113,H R 4660,30-May-2014,12:42 AM,On Agreeing to the Amendment,None,Agreed to,219,1,0,12,10,177,0,12,0,0,0,0,229,178,0,24
265,R,113,H R 4660,30-May-2014,12:45 AM,On Agreeing to the Amendment,None,Agreed to,215,5,0,12,1,185,0,13,0,0,0,0,216,190,0,25
266,R,113,H R 4660,30-May-2014,12:48 AM,On Agreeing to the Amendment,None,Agreed to,212,9,0,11,2,185,0,12,0,0,0,0,214,194,0,23
267,R,113,H R 4660,30-May-2014,12:51 AM,On Agreeing to the Amendment,None,Agreed to,219,2,0,11,7,177,0,15,0,0,0,0,226,179,0,26
268,R,113,H R 4660,30-May-2014,1:08 AM,On Motion to Recommit with Instructions,"Making appropriations for the Departments of Commerce and Justice, Science, and Related Agencies for the fiscal year ending September 30, 2015, and for other purposes",Failed,0,220,0,12,185,0,2,12,0,0,0,0,185,220,2,24
269,R,113,H R 4660,30-May-2014,1:14 AM,On Passage,"Making appropriations for the Departments of Commerce and Justice, Science, and Related Agencies for the fiscal year ending September 30, 2015, and for other purposes",Passed,204,17,0,11,117,70,0,12,0,0,0,0,321,87,0,23
270,R,113,H R 4681,30-May-2014,11:45 AM,On Motion to Recommit with Instructions,Intelligence Authorization Act for Fiscal Years 2014 and 2015,Failed,0,220,0,12,183,0,0,16,0,0,0,0,183,220,0,28
271,R,113,H R 4681,30-May-2014,11:53 AM,On Passage,Intelligence Authorization Act for Fiscal Years 2014 and 2015,Passed,194,26,0,12,151,33,0,15,0,0,0,0,345,59,0,27
272,R,113,H R 4412,9-Jun-2014,6:56 PM,"On Motion to Suspend the Rules and Pass, as Amended","To authorize the programs of the National Aeronautics and Space Administration, and for other purposes",Passed,218,2,0,12,183,0,0,16,0,0,0,0,401,2,0,28
273,R,113,H R 4745,9-Jun-2014,7:05 PM,On Agreeing to the Amendment,None,Failed,149,71,0,12,5,177,0,17,0,0,0,0,154,248,0,29
274,R,113,H R 4745,9-Jun-2014,7:11 PM,On Agreeing to the Amendment,None,Failed,127,94,0,11,0,185,0,14,0,0,0,0,127,279,0,25
275,R,113,,10-Jun-2014,,,This vote was vacated by unanimous consent on 10-Jun-2014.,,0,0,0,0,0,0,0,0,0,0,0,0,0,0,0,0
276,R,113,H R 4745,10-Jun-2014,2:01 PM,On Agreeing to the Amendment,None,Failed,158,70,0,4,2,196,0,1,0,0,0,0,160,266,0,5
277,R,113,H R 4745,10-Jun-2014,2:05 PM,On Agreeing to the Amendment,None,Failed,14,214,0,4,191,7,0,1,0,0,0,0,205,221,0,5
278,R,113,H R 4745,10-Jun-2014,2:09 PM,On Agreeing to the Amendment,None,Failed,101,127,0,4,13,184,0,2,0,0,0,0,114,311,0,6
279,R,113,H R 4745,10-Jun-2014,2:13 PM,On Agreeing to the Amendment,None,Failed,133,91,0,8,1,197,0,1,0,0,0,0,134,288,0,9
280,R,113,H R 4745,10-Jun-2014,2:17 PM,On Agreeing to the Amendment,None,Failed,140,88,0,4,3,195,0,1,0,0,0,0,143,283,0,5
281,R,113,H R 4745,10-Jun-2014,2:21 PM,On Agreeing to the Amendment,None,Failed,128,99,0,5,2,196,0,1,0,0,0,0,130,295,0,6
282,R,113,H R 4745,10-Jun-2014,2:25 PM,On Agreeing to the Amendment,None,Failed,186,41,0,5,2,196,0,1,0,0,0,0,188,237,0,6
283,R,113,H R 4745,10-Jun-2014,2:29 PM,On Agreeing to the Amendment,None,Agreed to,210,18,0,4,4,194,0,1,0,0,0,0,214,212,0,5
284,R,113,H R 4745,10-Jun-2014,2:33 PM,On Agreeing to the Amendment,None,Failed,177,51,0,4,0,198,0,1,0,0,0,0,177,249,0,5
285,R,113,H R 4745,10-Jun-2014,2:39 PM,On Agreeing to the Amendment,None,Agreed to,219,9,0,4,0,198,0,1,0,0,0,0,219,207,0,5
286,R,113,H R 4745,10-Jun-2014,2:46 PM,On Agreeing to the Amendment,None,Agreed to,202,26,0,4,53,145,0,1,0,0,0,0,255,171,0,5
287,R,113,H R 4810,10-Jun-2014,3:04 PM,On Motion to Suspend the Rules and Pass,To direct the Secretary of Veterans Affairs to enter into contracts for the provision of hospital care and medical services at non-Department of Veterans Affairs facilities for Department of Veterans Affairs patients with extended waiting times for appointments at Department facilities and for other purposes,Passed,228,0,0,4,198,0,0,1,0,0,0,0,426,0,0,5
288,R,113,H R 4745,10-Jun-2014,6:20 PM,On Agreeing to the Amendment,None,Agreed to,221,3,0,8,6,183,0,10,0,0,0,0,227,186,0,18
289,R,113,H R 4745,10-Jun-2014,6:28 PM,On Agreeing to the Amendment,None,Failed,155,71,0,6,4,189,0,6,0,0,0,0,159,260,0,12
290,R,113,H R 4745,10-Jun-2014,6:33 PM,On Agreeing to the Amendment,None,Agreed to,199,27,0,6,11,182,0,6,0,0,0,0,210,209,0,12
291,R,113,H R 4745,10-Jun-2014,6:38 PM,On Agreeing to the Amendment,None,Failed,183,44,0,5,7,188,0,4,0,0,0,0,190,232,0,9
292,R,113,H R 4745,10-Jun-2014,6:41 PM,On Agreeing to the Amendment,None,Failed,176,51,0,5,5,189,0,5,0,0,0,0,181,240,0,10
293,R,113,H R 4745,10-Jun-2014,6:49 PM,On Agreeing to the Amendment,None,Failed,30,196,0,6,178,16,0,5,0,0,0,0,208,212,0,11
294,R,113,H R 4745,10-Jun-2014,6:53 PM,On Agreeing to the Amendment,None,Failed,164,60,0,8,3,190,0,6,0,0,0,0,167,250,0,14
295,R,113,H R 4745,10-Jun-2014,7:03 PM,On Agreeing to the Amendment,None,Failed,167,60,0,5,0,194,0,5,0,0,0,0,167,254,0,10
296,R,113,H R 4745,10-Jun-2014,7:17 PM,On Motion to Recommit with Instructions,"Making appropriations for the Departments of Transportation, and Housing and Urban Development, and related agencies for the fiscal year ending September 30, 2015, and for other purposes",Failed,0,227,0,5,195,0,0,4,0,0,0,0,195,227,0,9
297,R,113,H R 4745,10-Jun-2014,7:24 PM,On Passage,"Making appropriations for the Departments of Transportation, and Housing and Urban Development, and related agencies for the fiscal year ending September 30, 2015, and for other purposes",Passed,215,12,0,5,14,180,0,5,0,0,0,0,229,192,0,10
298,R,113,H RES 616,11-Jun-2014,1:41 PM,On Ordering the Previous Question,"Providing for consideration of the bills (H.R. 4800) making appropriations for Agriculture, Rural Development, Food and Drug Administration, and Related Agencies, FY 2015; (H.R. 4457) America’s Small Business Tax Relief Act; and (H.R. 4453) Permanent S Corporation Built-in Gains Recognition Period Act",Passed,224,0,0,8,0,194,0,5,0,0,0,0,224,194,0,13
299,R,113,H RES 616,11-Jun-2014,1:48 PM,On Agreeing to the Resolution,"Providing for consideration of the bills (H.R. 4800) making appropriations for Agriculture, Rural Development, Food and Drug Administration, and Related Agencies, FY 2015; (H.R. 4457) America’s Small Business Tax Relief Act; and (H.R. 4453) Permanent S Corporation Built-in Gains Recognition Period Act",Passed,223,1,0,8,4,188,0,7,0,0,0,0,227,189,0,15
300,R,113,H R 4800,11-Jun-2014,6:30 PM,On Agreeing to the Amendment,None,Failed,173,55,0,4,5,188,0,6,0,0,0,0,178,243,0,10
301,R,113,H R 4800,11-Jun-2014,6:35 PM,On Agreeing to the Amendment,None,Failed,129,99,0,4,1,191,0,7,0,0,0,0,130,290,0,11
302,R,113,H R 4800,11-Jun-2014,6:39 PM,On Agreeing to the Amendment,None,Agreed to,93,135,0,4,130,63,0,6,0,0,0,0,223,198,0,10
303,R,113,H R 4800,11-Jun-2014,6:43 PM,On Agreeing to the Amendment,None,Failed,15,212,0,5,135,60,0,4,0,0,0,0,150,272,0,9
304,R,113,H R 4800,11-Jun-2014,6:47 PM,On Agreeing to the Amendment,None,Failed,17,211,0,4,131,65,0,3,0,0,0,0,148,276,0,7
305,R,113,H R 4800,11-Jun-2014,6:51 PM,On Agreeing to the Amendment,None,Failed,117,110,0,5,2,193,0,4,0,0,0,0,119,303,0,9
306,R,113,H R 4800,11-Jun-2014,6:54 PM,On Agreeing to the Amendment,None,Failed,60,167,0,5,2,191,0,6,0,0,0,0,62,358,0,11
307,R,113,H R 4800,11-Jun-2014,7:00 PM,On Agreeing to the Amendment,None,Failed,5,222,0,5,189,5,0,5,0,0,0,0,194,227,0,10
308,R,113,H R 4457,12-Jun-2014,11:49 AM,On Motion to Recommit with Instructions,"To amend the Internal Revenue Code of 1986 to permanently extend increased expensing limitations, and for other purposes",Failed,0,224,0,8,180,8,0,11,0,0,0,0,180,232,0,19
309,R,113,H R 4457,12-Jun-2014,11:57 AM,On Passage,"To amend the Internal Revenue Code of 1986 to permanently extend increased expensing limitations, and for other purposes",Passed,219,2,0,11,53,142,0,4,0,0,0,0,272,144,0,15
310,R,113,H R 4453,12-Jun-2014,12:03 PM,On Motion to Recommit with Instructions,To amend the Internal Revenue Code of 1986 to make permanent the reduced recognition period for built-in gains of S corporations,Failed,0,222,0,10,188,7,0,4,0,0,0,0,188,229,0,14
311,R,113,H R 4453,12-Jun-2014,12:09 PM,On Passage,To amend the Internal Revenue Code of 1986 to make permanent the reduced recognition period for built-in gains of S corporations,Passed,221,2,0,9,42,153,0,4,0,0,0,0,263,155,0,13
312,R,113,H RES 617,12-Jun-2014,12:15 PM,On Agreeing to the Resolution,Condemning the abduction of female students by armed militants from the terrorist group known as Boko Haram in northeastern provinces of the Federal Republic of Nigeria,Passed,220,2,0,10,191,0,0,8,0,0,0,0,411,2,0,18
313,R,113,H R 3375,17-Jun-2014,6:57 PM,On Motion to Suspend the Rules and Pass,"To designate the community-based outpatient clinic of the Department of Veterans Affairs to be constructed at 3141 Centennial Boulevard, Colorado Springs, Colorado, as the “PFC Floyd K. Lindstrom Department of Veterans Affairs Clinic”.",Passed,214,0,0,18,182,0,0,17,0,0,0,0,396,0,0,35
314,R,113,H R 1671,17-Jun-2014,7:05 PM,On Motion to Suspend the Rules and Pass,"To designate the facility of the United States Postal Service located at 6937 Village Parkway in Dublin, California, as the “James ’Jim’ Kohnen Post Office”.",Passed,218,0,0,14,180,0,0,19,0,0,0,0,398,0,0,33
315,R,113,H RES 628,18-Jun-2014,1:22 PM,On Agreeing to the Resolution,"Providing for consideration of H.R. 4870, Making appropriations for the Department of Defense for the fiscal year ending September 30, 2015, and for other purposes; and the consideration of Senate amendments to H.R. 3230, the Veterans’ Access to Care through Choice, Accountability, and Transparency Act of 2014",Passed,220,0,0,12,24,163,0,12,0,0,0,0,244,163,0,24
316,R,113,H R 3230,18-Jun-2014,2:41 PM,On Motion to Instruct Conferees,"Veterans’ Access to Care through Choice, Accountability, and Transparency Act of 2014",Failed,3,220,0,9,195,0,0,4,0,0,0,0,198,220,0,13
317,R,113,H RES 629,19-Jun-2014,5:01 PM,On Agreeing to the Resolution,"Providing for consideration of the bill (H.R. 4413), the “Customer Protection and End User Relief Act”.",Passed,225,0,0,7,5,184,0,10,0,0,0,0,230,184,0,17
318,R,113,H R 4870,19-Jun-2014,5:13 PM,On Agreeing to the Amendment,None,Failed,111,118,0,3,19,174,0,6,0,0,0,0,130,292,0,9
319,R,113,H R 4870,19-Jun-2014,5:18 PM,On Agreeing to the Amendment,None,Failed,4,224,0,4,175,18,0,6,0,0,0,0,179,242,0,10
320,R,113,H R 4870,19-Jun-2014,5:22 PM,On Agreeing to the Amendment,None,Failed,7,221,0,4,180,12,0,7,0,0,0,0,187,233,0,11
321,R,113,H R 4870,19-Jun-2014,5:26 PM,On Agreeing to the Amendment,None,Agreed to,221,4,0,7,17,175,0,7,0,0,0,0,238,179,0,14
322,R,113,H R 4870,19-Jun-2014,10:27 PM,On Agreeing to the Amendment,None,Agreed to,155,73,0,4,145,41,0,13,0,0,0,0,300,114,0,17
323,R,113,H R 4870,19-Jun-2014,10:31 PM,On Agreeing to the Amendment,None,Agreed to,218,10,0,4,12,174,0,13,0,0,0,0,230,184,0,17
324,R,113,H R 4870,19-Jun-2014,10:35 PM,On Agreeing to the Amendment,None,Failed,4,224,0,4,159,25,0,15,0,0,0,0,163,249,0,19
325,R,113,H R 4870,19-Jun-2014,10:39 PM,On Agreeing to the Amendment,None,Failed,23,206,0,3,142,44,0,13,0,0,0,0,165,250,0,16
326,R,113,H R 4870,19-Jun-2014,10:43 PM,On Agreeing to the Amendment,None,Failed,31,196,0,5,151,35,0,13,0,0,0,0,182,231,0,18
327,R,113,H R 4870,19-Jun-2014,10:47 PM,On Agreeing to the Amendment,None,Agreed to,135,94,0,3,158,29,1,11,0,0,0,0,293,123,1,14
328,R,113,H R 4870,19-Jun-2014,10:52 PM,On Agreeing to the Amendment,None,Failed,103,121,0,8,64,123,0,12,0,0,0,0,167,244,0,20
329,R,113,H R 4870,19-Jun-2014,10:56 PM,On Agreeing to the Amendment,None,Failed,19,210,0,3,43,145,0,11,0,0,0,0,62,355,0,14
330,R,113,H R 4870,19-Jun-2014,10:59 PM,On Agreeing to the Amendment,None,Failed,21,208,0,3,136,52,0,11,0,0,0,0,157,260,0,14
331,R,113,H R 4870,19-Jun-2014,11:04 PM,On Agreeing to the Amendment,None,Agreed to,25,204,0,3,187,0,0,12,0,0,0,0,212,204,0,15
332,R,113,H R 4870,20-Jun-2014,11:47 AM,On Agreeing to the Amendment,None,Failed,20,207,0,5,133,53,0,13,0,0,0,0,153,260,0,18
333,R,113,H R 4870,20-Jun-2014,11:53 AM,On Agreeing to the Amendment,None,Failed,73,152,0,7,19,168,0,12,0,0,0,0,92,320,0,19
334,R,113,H R 4870,20-Jun-2014,11:58 AM,On Agreeing to the Amendment,None,Failed,203,23,0,6,2,185,0,12,0,0,0,0,205,208,0,18
335,R,113,H R 4870,20-Jun-2014,12:03 PM,On Agreeing to the Amendment,None,Agreed to,212,14,0,6,68,119,0,12,0,0,0,0,280,133,0,18
336,R,113,H R 4870,20-Jun-2014,12:07 PM,On Agreeing to the Amendment,None,Failed,139,85,0,8,24,163,0,12,0,0,0,0,163,248,0,20
337,R,113,H R 4870,20-Jun-2014,12:24 PM,On Motion to Recommit with Instructions,"Making appropriations for the Department of Defense for the fiscal year ending September 30, 2015, and for other purposes",Failed,2,220,0,10,188,0,0,11,0,0,0,0,190,220,0,21
338,R,113,H R 4870,20-Jun-2014,12:31 PM,On Passage,"Making appropriations for the Department of Defense for the fiscal year ending September 30, 2015, and for other purposes",Passed,219,6,0,7,121,67,0,11,0,0,0,0,340,73,0,18
339,R,113,S 1044,23-Jun-2014,6:57 PM,On Motion to Suspend the Rules and Pass,World War II Memorial Prayer Act,Passed,205,0,0,27,165,12,0,22,0,0,0,0,370,12,0,49
340,R,113,H R 316,23-Jun-2014,7:08 PM,On Motion to Suspend the Rules and Concur in the Senate Amendment,Collinsville Renewable Energy Production Act,Passed,202,3,0,27,177,0,0,22,0,0,0,0,379,3,0,49
341,R,113,H RES 636,24-Jun-2014,1:47 PM,On Ordering the Previous Question,"Providing for consideration of H.R. 6, the Domestic Prosperity and Global Freedom Act and H.R. 3301, the North American Energy Infrastructure Act",Passed,219,0,0,13,0,184,0,15,0,0,0,0,219,184,0,28
342,R,113,H RES 636,24-Jun-2014,1:55 PM,On Agreeing to the Resolution,"Providing for consideration of H.R. 6, the Domestic Prosperity and Global Freedom Act and H.R. 3301, the North American Energy Infrastructure Act",Passed,220,0,0,12,1,186,0,12,0,0,0,0,221,186,0,24
343,R,113,H R 4413,24-Jun-2014,2:01 PM,On Agreeing to the Amendment,None,Failed,1,220,0,11,162,29,0,8,0,0,0,0,163,249,0,19
344,R,113,H R 4413,24-Jun-2014,2:05 PM,On Agreeing to the Amendment,None,Failed,0,220,0,12,168,22,0,9,0,0,0,0,168,242,0,21
345,R,113,H R 4413,24-Jun-2014,2:09 PM,On Agreeing to the Amendment,None,Failed,1,220,0,11,172,19,0,8,0,0,0,0,173,239,0,19
346,R,113,H R 4413,24-Jun-2014,2:12 PM,On Agreeing to the Amendment,None,Failed,6,213,0,13,171,20,0,8,0,0,0,0,177,233,0,21
347,R,113,H R 4413,24-Jun-2014,2:17 PM,On Agreeing to the Amendment,None,Agreed to,219,2,0,11,33,156,0,10,0,0,0,0,252,158,0,21
348,R,113,H R 4413,24-Jun-2014,2:33 PM,On Motion to Recommit with Instructions,Customer Protection and End User Relief Act,Failed,1,219,0,12,190,1,0,8,0,0,0,0,191,220,0,20
349,R,113,H R 4413,24-Jun-2014,2:40 PM,On Passage,Customer Protection and End User Relief Act,Passed,219,1,0,12,46,143,0,10,0,0,0,0,265,144,0,22
350,R,113,H R 3301,24-Jun-2014,5:42 PM,On Agreeing to the Amendment,None,Failed,1,222,0,9,175,11,0,13,0,0,0,0,176,233,0,22
351,R,113,H R 3301,24-Jun-2014,5:48 PM,On Agreeing to the Amendment,None,Failed,0,223,0,9,171,17,0,11,0,0,0,0,171,240,0,20
352,R,113,H R 3301,24-Jun-2014,5:52 PM,On Agreeing to the Amendment,None,Failed,1,222,0,9,175,12,0,12,0,0,0,0,176,234,0,21
353,R,113,H R 3301,24-Jun-2014,6:08 PM,On Motion to Recommit with Instructions,North American Energy Infrastructure Act,Failed,0,223,0,9,185,4,0,10,0,0,0,0,185,227,0,19
354,R,113,H R 3301,24-Jun-2014,6:17 PM,On Passage,North American Energy Infrastructure Act,Passed,221,1,0,10,17,172,0,10,0,0,0,0,238,173,0,20
355,R,113,H RES 641,25-Jun-2014,4:01 PM,On Ordering the Previous Question,"Providing for consideration of H.R. 4899, the Lowering Gasoline Prices to Fuel an America That Works Act of 2014 and H.R. 4923, making appropriations for energy and water development and related agencies for the fiscal year ending September 30, 2015, and for other purposes; and for other purposes",Passed,224,0,0,8,14,180,0,5,0,0,0,0,238,180,0,13
356,R,113,H RES 641,25-Jun-2014,4:15 PM,On Agreeing to the Resolution,"Providing for consideration of H.R. 4899, the Lowering Gasoline Prices to Fuel an America That Works Act of 2014 and H.R. 4923, making appropriations for energy and water development and related agencies for the fiscal year ending September 30, 2015, and for other purposes; and for other purposes",Passed,223,0,0,10,5,189,0,5,0,0,0,0,228,189,0,15
357,R,113,H R 6,25-Jun-2014,4:21 PM,On Agreeing to the Amendment,None,Failed,11,212,0,10,185,9,0,5,0,0,0,0,196,221,0,15
358,R,113,H R 6,25-Jun-2014,4:39 PM,On Motion to Recommit with Instructions,"To provide for expedited approval of exportation of natural gas to World Trade Organization countries, and for other purposes",Failed,2,222,0,9,190,3,0,6,0,0,0,0,192,225,0,15
359,R,113,H R 6,25-Jun-2014,4:47 PM,On Passage,"To provide for expedited approval of exportation of natural gas to World Trade Organization countries, and for other purposes",Passed,220,2,0,11,46,148,0,5,0,0,0,0,266,150,0,16
360,R,113,H R 4899,26-Jun-2014,11:33 AM,On Agreeing to the Amendment,None,Agreed to,225,2,0,6,19,170,0,10,0,0,0,0,244,172,0,16
361,R,113,H R 4899,26-Jun-2014,11:42 AM,On Agreeing to the Amendment,None,Failed,1,224,0,8,178,8,0,13,0,0,0,0,179,232,0,21
362,R,113,H R 4899,26-Jun-2014,11:46 AM,On Agreeing to the Amendment,None,Failed,4,222,0,7,179,5,0,15,0,0,0,0,183,227,0,22
363,R,113,H R 4899,26-Jun-2014,11:50 AM,On Agreeing to the Amendment,None,Failed,5,220,0,8,183,3,0,13,0,0,0,0,188,223,0,21
364,R,113,H R 4899,26-Jun-2014,11:53 AM,On Agreeing to the Amendment,None,Failed,5,217,0,11,174,12,0,13,0,0,0,0,179,229,0,24
365,R,113,H R 4899,26-Jun-2014,11:57 AM,On Agreeing to the Amendment,None,Agreed to,224,2,0,7,17,171,0,11,0,0,0,0,241,173,0,18
366,R,113,H R 4899,26-Jun-2014,12:00 PM,On Agreeing to the Amendment,None,Failed,4,221,0,8,185,2,0,12,0,0,0,0,189,223,0,20
367,R,113,H R 4899,26-Jun-2014,12:15 PM,On Motion to Recommit with Instructions,Lowering Gasoline Prices to Fuel an America That Works Act,Failed,1,224,0,8,176,11,0,12,0,0,0,0,177,235,0,20
368,R,113,H R 4899,26-Jun-2014,12:26 PM,On Passage,Lowering Gasoline Prices to Fuel an America That Works Act,Passed,219,6,0,8,10,179,0,10,0,0,0,0,229,185,0,18
369,R,113,H R 4263,8-Jul-2014,6:57 PM,"On Motion to Suspend the Rules and Pass, as Amended",Social Media Working Group Act of 2014,Passed,197,19,0,17,178,0,0,21,0,0,0,0,375,19,0,38
370,R,113,H R 4289,8-Jul-2014,7:04 PM,On Motion to Suspend the Rules and Pass,Department of Homeland Security Interoperable Communications Act,Passed,215,0,0,18,178,0,0,21,0,0,0,0,393,0,0,39
371,R,113,H R 4923,9-Jul-2014,5:30 PM,On Agreeing to the Amendment,None,Failed,128,99,0,6,4,185,0,10,0,0,0,0,132,284,0,16
372,R,113,H R 4923,9-Jul-2014,5:37 PM,On Agreeing to the Amendment,None,Agreed to,110,116,0,7,171,21,0,7,0,0,0,0,281,137,0,14
373,R,113,H R 4923,9-Jul-2014,5:41 PM,On Agreeing to the Amendment,None,Failed,101,127,0,5,3,189,0,7,0,0,0,0,104,316,0,12
374,R,113,H R 4923,9-Jul-2014,5:45 PM,On Agreeing to the Amendment,None,Failed,110,119,0,4,2,190,0,7,0,0,0,0,112,309,0,11
375,R,113,H R 4923,9-Jul-2014,5:49 PM,On Agreeing to the Amendment,None,Failed,4,224,0,5,168,21,0,10,0,0,0,0,172,245,0,15
376,R,113,H R 4923,9-Jul-2014,5:53 PM,On Agreeing to the Amendment,None,Failed,110,118,0,5,0,192,0,7,0,0,0,0,110,310,0,12
377,R,113,H R 4923,9-Jul-2014,5:57 PM,On Agreeing to the Amendment,None,Failed,97,131,0,5,0,190,0,9,0,0,0,0,97,321,0,14
378,R,113,H R 803,9-Jul-2014,6:05 PM,On Motion to Suspend the Rules and Concur in the Senate Amendments,Workforce Innovation and Opportunity Act,Passed,223,6,0,4,192,0,0,7,0,0,0,0,415,6,0,11
379,R,113,H R 4923,10-Jul-2014,2:58 PM,On Agreeing to the Amendment,None,Failed,129,98,0,6,0,192,0,7,0,0,0,0,129,290,0,13
380,R,113,H R 4923,10-Jul-2014,3:02 PM,On Agreeing to the Amendment,None,Agreed to,33,195,0,5,188,4,0,7,0,0,0,0,221,199,0,12
381,R,113,H R 4923,10-Jul-2014,3:06 PM,On Agreeing to the Amendment,None,Failed,67,160,0,6,117,75,0,7,0,0,0,0,184,235,0,13
382,R,113,H R 4923,10-Jul-2014,3:11 PM,On Agreeing to the Amendment,None,Failed,6,222,0,5,69,122,0,8,0,0,0,0,75,344,0,13
383,R,113,H R 4923,10-Jul-2014,3:15 PM,On Agreeing to the Amendment,None,Agreed to,27,201,0,5,189,4,0,6,0,0,0,0,216,205,0,11
384,R,113,H R 4923,10-Jul-2014,3:18 PM,On Agreeing to the Amendment,None,Failed,20,208,0,5,161,31,0,7,0,0,0,0,181,239,0,12
385,R,113,H R 4923,10-Jul-2014,3:22 PM,On Agreeing to the Amendment,None,Failed,159,69,0,5,17,174,0,8,0,0,0,0,176,243,0,13
386,R,113,H R 4923,10-Jul-2014,3:26 PM,On Agreeing to the Amendment,None,Failed,7,222,0,4,89,104,0,6,0,0,0,0,96,326,0,10
387,R,113,H R 4923,10-Jul-2014,3:29 PM,On Agreeing to the Amendment,None,Agreed to,34,194,0,5,187,6,0,6,0,0,0,0,221,200,0,11
388,R,113,H R 4923,10-Jul-2014,3:33 PM,On Agreeing to the Amendment,None,Failed,181,46,0,6,0,193,0,6,0,0,0,0,181,239,0,12
389,R,113,H R 4923,10-Jul-2014,3:36 PM,On Agreeing to the Amendment,None,Agreed to,224,1,0,8,3,190,0,6,0,0,0,0,227,191,0,14
390,R,113,H R 4923,10-Jul-2014,3:39 PM,On Agreeing to the Amendment,None,Agreed to,227,2,0,4,5,185,0,9,0,0,0,0,232,187,0,13
391,R,113,H RES 661,10-Jul-2014,3:47 PM,On Ordering the Previous Question,"Providing for consideration of H.R. 5016, making appropriations for financial services and general government for the fiscal year ending September 30, 2015, and for other purposes; and H.R. 4718, to amend the Internal Revenue Code of 1986 to modify and make permanent bonus depreciation",Passed,229,0,0,4,0,192,0,7,0,0,0,0,229,192,0,11
392,R,113,H RES 661,10-Jul-2014,3:53 PM,On Agreeing to the Resolution,"Providing for consideration of H.R. 5016, making appropriations for financial services and general government for the fiscal year ending September 30, 2015, and for other purposes; and H.R. 4718, to amend the Internal Revenue Code of 1986 to modify and make permanent bonus depreciation",Passed,229,0,0,4,5,188,0,6,0,0,0,0,234,188,0,10
393,R,113,H R 4923,10-Jul-2014,8:29 PM,On Agreeing to the Amendment,None,Agreed to,223,3,0,7,3,190,0,6,0,0,0,0,226,193,0,13
394,R,113,H R 4923,10-Jul-2014,8:35 PM,On Agreeing to the Amendment,None,Agreed to,224,3,0,6,15,179,0,5,0,0,0,0,239,182,0,11
395,R,113,H R 4923,10-Jul-2014,8:39 PM,On Agreeing to the Amendment,None,Failed,140,88,0,5,0,194,0,5,0,0,0,0,140,282,0,10
396,R,113,H R 4923,10-Jul-2014,8:42 PM,On Agreeing to the Amendment,None,Agreed to,216,12,0,5,2,192,0,5,0,0,0,0,218,204,0,10
397,R,113,H R 4923,10-Jul-2014,8:46 PM,On Agreeing to the Amendment,None,Agreed to,224,1,0,8,5,187,0,7,0,0,0,0,229,188,0,15
398,R,113,H R 4923,10-Jul-2014,8:50 PM,On Agreeing to the Amendment,None,Failed,147,80,0,6,3,191,0,5,0,0,0,0,150,271,0,11
399,R,113,H R 4923,10-Jul-2014,8:54 PM,On Agreeing to the Amendment,None,Agreed to,224,3,0,6,2,191,0,6,0,0,0,0,226,194,0,12
400,R,113,H R 4923,10-Jul-2014,8:58 PM,On Agreeing to the Amendment,None,Failed,131,96,0,6,0,193,0,6,0,0,0,0,131,289,0,12
401,R,113,H R 4923,10-Jul-2014,9:15 PM,On Motion to Recommit with Instructions,"Making appropriations for energy and water development and related agencies for the fiscal year ending September 30, 2015, and for other purposes",Failed,0,228,0,5,188,3,0,8,0,0,0,0,188,231,0,13
402,R,113,H R 4923,10-Jul-2014,9:22 PM,On Passage,"Making appropriations for energy and water development and related agencies for the fiscal year ending September 30, 2015, and for other purposes",Passed,218,11,0,4,35,159,0,5,0,0,0,0,253,170,0,9
403,R,113,H R 4718,11-Jul-2014,10:49 AM,On Motion to Recommit with Instructions,To amend the Internal Revenue Code of 1986 to modify and make permanent bonus depreciation,Failed,0,226,0,7,191,3,0,5,0,0,0,0,191,229,0,12
404,R,113,H R 4718,11-Jul-2014,10:57 AM,On Passage,To amend the Internal Revenue Code of 1986 to modify and make permanent bonus depreciation,Passed,224,2,0,7,34,158,0,7,0,0,0,0,258,160,0,14
405,R,113,H R 4195,14-Jul-2014,7:01 PM,On Motion to Suspend the Rules and Pass,"To amend chapter 15 of title 44, United States Code (commonly known as the Federal Register Act), to modernize the Federal Register, and for other purposes.",Passed,206,0,0,27,180,0,0,19,0,0,0,0,386,0,0,46
406,R,113,H R 5029,14-Jul-2014,7:09 PM,On Motion to Suspend the Rules and Pass,To provide for the establishment of a body to indentify and coordinate international science and technology cooperation that can strengthen the domestic science and technology enterprise and support United States foreign policy goals,Passed,165,41,0,27,181,0,0,18,0,0,0,0,346,41,0,45
407,R,113,H RES 669,15-Jul-2014,2:40 PM,On Ordering the Previous Question,"Providing for consideration of H.R. 5021, the Highway and Transportation Funding Act of 2014",Passed,224,0,0,9,4,192,0,3,0,0,0,0,228,192,0,12
408,R,113,H RES 669,15-Jul-2014,2:47 PM,On Agreeing to the Resolution,"Providing for consideration of H.R. 5021, the Highway and Transportation Funding Act of 2014",Passed,220,2,0,11,11,184,0,4,0,0,0,0,231,186,0,15
409,R,113,H R 5016,15-Jul-2014,2:53 PM,On Agreeing to the Amendment,None,Failed,13,212,0,8,148,46,0,5,0,0,0,0,161,258,0,13
410,R,113,H R 5016,15-Jul-2014,2:57 PM,On Agreeing to the Amendment,None,Agreed to,222,2,0,9,116,78,0,5,0,0,0,0,338,80,0,14
411,R,113,H R 5016,15-Jul-2014,3:00 PM,On Agreeing to the Amendment,None,Failed,1,221,0,11,169,23,0,7,0,0,0,0,170,244,0,18
412,R,113,H R 5016,15-Jul-2014,3:03 PM,On Agreeing to the Amendment,None,Failed,1,224,0,8,183,11,0,5,0,0,0,0,184,235,0,13
413,R,113,H R 5021,15-Jul-2014,4:52 PM,On Motion to Recommit with Instructions,"To provide an extension of Federal-aid highway, highway safety, motor carrier safety, transit, and other programs funded out of the Highway Trust Fund, and for other purposes.",Failed,0,224,0,9,193,3,0,3,0,0,0,0,193,227,0,12
414,R,113,H R 5021,15-Jul-2014,4:59 PM,On Passage,"To provide an extension of Federal-aid highway, highway safety, motor carrier safety, transit, and other programs funded out of the Highway Trust Fund, and for other purposes.",Passed,181,45,0,7,186,10,0,3,0,0,0,0,367,55,0,10
415,R,113,H R 5016,16-Jul-2014,2:46 PM,On Agreeing to the Amendment,None,Failed,179,46,0,8,7,190,0,2,0,0,0,0,186,236,0,10
416,R,113,H R 5016,16-Jul-2014,2:52 PM,On Agreeing to the Amendment,None,Agreed to,225,0,0,8,57,138,1,3,0,0,0,0,282,138,1,11
417,R,113,H R 5016,16-Jul-2014,2:57 PM,On Agreeing to the Amendment,None,Failed,0,225,0,8,193,5,0,1,0,0,0,0,193,230,0,9
418,R,113,H R 5016,16-Jul-2014,3:01 PM,On Agreeing to the Amendment,None,Agreed to,45,180,0,8,186,12,0,1,0,0,0,0,231,192,0,9
419,R,113,H R 5016,16-Jul-2014,3:05 PM,On Agreeing to the Amendment,None,Agreed to,223,1,0,9,128,70,0,1,0,0,0,0,351,71,0,10
420,R,113,H R 5016,16-Jul-2014,3:09 PM,On Agreeing to the Amendment,None,Agreed to,222,3,0,8,42,154,0,3,0,0,0,0,264,157,0,11
421,R,113,H R 5016,16-Jul-2014,3:13 PM,On Agreeing to the Amendment,None,Failed,165,61,0,7,3,195,0,1,0,0,0,0,168,256,0,8
422,R,113,H R 5016,16-Jul-2014,3:17 PM,On Agreeing to the Amendment,None,Agreed to,222,3,0,8,17,181,0,1,0,0,0,0,239,184,0,9
423,R,113,H R 5016,16-Jul-2014,3:20 PM,On Agreeing to the Amendment,None,Agreed to,221,4,0,8,2,196,0,1,0,0,0,0,223,200,0,9
424,R,113,H R 5016,16-Jul-2014,3:24 PM,On Agreeing to the Amendment,None,Agreed to,225,0,0,8,4,194,0,1,0,0,0,0,229,194,0,9
425,R,113,H R 5016,16-Jul-2014,3:27 PM,On Agreeing to the Amendment,None,Agreed to,221,4,0,8,20,177,0,2,0,0,0,0,241,181,0,10
426,R,113,H R 5016,16-Jul-2014,3:52 PM,On Motion to Recommit with Instructions,"Making appropriations for financial services and general government for the fiscal year ending September 30, 2015, and for other purposes",Failed,0,225,0,8,198,0,0,1,0,0,0,0,198,225,0,9
427,R,113,H R 5016,16-Jul-2014,4:02 PM,On Passage,"Making appropriations for financial services and general government for the fiscal year ending September 30, 2015, and for other purposes",Passed,222,4,0,7,6,191,0,2,0,0,0,0,228,195,0,9
428,R,113,H RES 670,17-Jul-2014,10:31 AM,On Ordering the Previous Question,Providing for consideration of the bill (H.R. 4719) to amend the Internal Revenue Code of 1986 to permanently extend and expand the charitable deduction for contributions of food inventory,Passed,222,0,0,11,4,186,0,9,0,0,0,0,226,186,0,20
429,R,113,H RES 670,17-Jul-2014,10:39 AM,On Agreeing to the Resolution,Providing for consideration of the bill (H.R. 4719) to amend the Internal Revenue Code of 1986 to permanently extend and expand the charitable deduction for contributions of food inventory,Passed,223,0,0,10,7,183,0,9,0,0,0,0,230,183,0,19
430,R,113,H R 3230,17-Jul-2014,10:46 AM,On Motion to Instruct Conferees,"Veterans’ Access to Care through Choice, Accountability, and Transparency Act of 2014",Failed,13,211,0,9,188,2,0,9,0,0,0,0,201,213,0,18
431,R,113,H R 4719,17-Jul-2014,12:34 PM,On Motion to Recommit with Instructions,To amend the Internal Revenue Code of 1986 to permanently extend and expand the charitable deduction for contributions of food inventory,Failed,0,223,0,10,185,4,0,10,0,0,0,0,185,227,0,20
432,R,113,H R 4719,17-Jul-2014,12:41 PM,On Passage,To amend the Internal Revenue Code of 1986 to permanently extend and expand the charitable deduction for contributions of food inventory,Passed,221,1,0,11,56,129,0,14,0,0,0,0,277,130,0,25
433,R,113,H R 4450,22-Jul-2014,7:00 PM,"On Motion to Suspend the Rules and Pass, as Amended","To extend the Travel Promotion Act of 2009, and for other purposes.",Passed,164,57,0,12,183,0,0,16,0,0,0,0,347,57,0,28
434,R,113,H R 4411,22-Jul-2014,7:07 PM,"On Motion to Suspend the Rules and Pass, as Amended","To prevent Hezbollah and associated entities from gaining access to international financial and other institutions, and for other purposes.",Passed,221,0,0,12,183,0,0,16,0,0,0,0,404,0,0,28
435,R,113,H R 1022,22-Jul-2014,7:14 PM,"On Motion to Suspend the Rules and Pass, as Amended",Securing Energy Critical Elements and American Jobs Act,Failed,78,142,0,13,182,1,0,16,0,0,0,0,260,143,0,29
436,R,113,H R 3230,22-Jul-2014,7:23 PM,On Motion to Instruct Conferees,"Veterans’ Access to Care through Choice, Accountability, and Transparency Act of 2014",Failed,11,207,0,15,180,0,0,19,0,0,0,0,191,207,0,34
437,R,113,H RES 677,23-Jul-2014,2:33 PM,On Ordering the Previous Question,"Providing for consideration of the bill (H.R. 3136) to establish a demonstration program for competency-based education, and providing for consideration of the bill (H.R. 4984) to amend the loan counseling requirements under the Higher Education Act of 1965, and for other purposes",Passed,224,0,0,9,0,190,0,9,0,0,0,0,224,190,0,18
438,R,113,H RES 677,23-Jul-2014,2:45 PM,On Agreeing to the Resolution,"Providing for consideration of the bill (H.R. 3136) to establish a demonstration program for competency-based education, and providing for consideration of the bill (H.R. 4984) to amend the loan counseling requirements under the Higher Education Act of 1965, and for other purposes",Passed,223,0,0,10,7,185,0,7,0,0,0,0,230,185,0,17
439,R,113,H R 3136,23-Jul-2014,4:49 PM,On Agreeing to the Amendment,None,Agreed to,224,0,0,9,189,0,0,10,0,0,0,0,413,0,0,19
440,R,113,H R 3136,23-Jul-2014,5:07 PM,On Motion to Recommit with Instructions,To establish a demonstration program for competency-based education.,Failed,2,221,0,10,192,0,0,7,0,0,0,0,194,221,0,17
441,R,113,H R 3136,23-Jul-2014,5:17 PM,On Passage,To establish a demonstration program for competency-based education.,Passed,225,0,0,8,189,0,0,10,0,0,0,0,414,0,0,18
442,R,113,H RES 680,24-Jul-2014,3:01 PM,On Ordering the Previous Question,"Providing for consideration of H.R. 3393, to amend the Internal Revenue Code of 1986 to consolidate certain tax benefits for educational expenses, and for other purposes, and providing for consideration of H.R. 4935, to amend the Internal Revenue Code of 1986 to make improvements to the child tax credit",Passed,225,1,0,7,1,190,0,8,0,0,0,0,226,191,0,15
443,R,113,H RES 680,24-Jul-2014,3:08 PM,On Agreeing to the Resolution,"Providing for consideration of H.R. 3393, to amend the Internal Revenue Code of 1986 to consolidate certain tax benefits for educational expenses, and for other purposes, and providing for consideration of H.R. 4935, to amend the Internal Revenue Code of 1986 to make improvements to the child tax credit",Passed,225,0,0,8,1,189,0,9,0,0,0,0,226,189,0,17
444,R,113,H R 4984,24-Jul-2014,3:16 PM,On Agreeing to the Amendment,None,Agreed to,211,14,0,8,193,0,0,6,0,0,0,0,404,14,0,14
445,R,113,H R 4984,24-Jul-2014,3:32 PM,On Motion to Recommit with Instructions,"To amend the loan counseling requirements under the Higher Education Act of 1965, and for other purposes",Failed,3,220,0,10,190,0,0,9,0,0,0,0,193,220,0,19
446,R,113,H R 4984,24-Jul-2014,3:39 PM,On Passage,"To amend the loan counseling requirements under the Higher Education Act of 1965, and for other purposes",Passed,214,11,0,8,191,0,0,8,0,0,0,0,405,11,0,16
447,R,113,H R 5111,24-Jul-2014,3:53 PM,"On Motion to Suspend the Rules and Pass, as Amended",To improve the response to victims of child sex trafficking,Passed,220,0,0,13,189,0,0,10,0,0,0,0,409,0,0,23
448,R,113,H R 3393,24-Jul-2014,5:25 PM,On Motion to Recommit with Instructions,Student and Family Tax Simplification Act,Failed,2,219,0,12,193,0,0,6,0,0,0,0,195,219,0,18
449,R,113,H R 3393,24-Jul-2014,5:31 PM,On Passage,Student and Family Tax Simplification Act,Passed,195,26,0,12,32,161,0,6,0,0,0,0,227,187,0,18
450,R,113,H R 3230,24-Jul-2014,5:43 PM,On Motion to Instruct Conferees,"Veterans’ Access to Care through Choice, Accountability, and Transparency Act of 2014",Failed,13,207,0,13,192,0,0,7,0,0,0,0,205,207,0,20
451,R,113,H R 4935,25-Jul-2014,12:37 PM,On Passage,To amend the Internal Revenue Code of 1986 to make improvements to the child tax credit,Passed,212,5,0,16,25,168,0,6,0,0,0,0,237,173,0,22
452,R,113,H CON RES 105,25-Jul-2014,12:43 PM,"On Agreeing to the Resolution, As Amended","Directing the President, pursuant to section 5(c) of the War Powers Resolution, to remove United States Armed Forces, other than Armed Forces required to protect United States diplomatic facilities and personnel, from Iraq",Passed,180,37,0,16,190,3,0,6,0,0,0,0,370,40,0,22
453,R,113,H R 3230,25-Jul-2014,12:51 PM,On Motion to Instruct Conferees,"Veterans’ Access to Care through Choice, Accountability, and Transparency Act of 2014",Passed,22,193,0,18,191,0,0,8,0,0,0,0,213,193,0,26
454,R,113,H R 5081,25-Jul-2014,12:58 PM,On Motion to Suspend the Rules and Pass,Strengthening Child Welfare Response to Trafficking Act of 2014,Passed,210,0,0,23,189,0,0,10,0,0,0,0,399,0,0,33
455,R,113,H R 935,28-Jul-2014,6:57 PM,On Motion to Suspend the Rules and Pass,"To amend the Federal Insecticide, Fungicide, and Rodenticide Act and the Federal Water Pollution Control Act to clarify Congressional intent regarding the regulation of the use of pesticides in or near navigable waters, and for other purposes",Failed,216,0,0,17,37,148,0,14,0,0,0,0,253,148,0,31
456,R,113,H R 3202,28-Jul-2014,7:03 PM,"On Motion to Suspend the Rules and Pass, as Amended",Essential Transportation Worker Identification Credential Assessment Act,Passed,215,0,0,18,185,0,0,14,0,0,0,0,400,0,0,32
457,R,113,H R 3107,28-Jul-2014,7:10 PM,"On Motion to Suspend the Rules and Pass, as Amended",Homeland Security Cybersecurity Boots-on-the-Ground Act,Passed,210,8,0,15,185,0,0,14,0,0,0,0,395,8,0,29
458,R,113,H RES 693,29-Jul-2014,1:31 PM,On Ordering the Previous Question,"Providing for consideration of the bill (H.R. 4315) to amend the Endangered Species Act of 1973 to require publication on the Internet of the basis for determinations that species are endangered species or threatened species, and for other purposes",Passed,224,0,0,9,0,192,0,7,0,0,0,0,224,192,0,16
459,R,113,H RES 693,29-Jul-2014,1:39 PM,On Agreeing to the Resolution,"Providing for consideration of the bill (H.R. 4315) to amend the Endangered Species Act of 1973 to require publication on the Internet of the basis for determinations that species are endangered species or threatened species, and for other purposes",Passed,223,0,0,10,2,192,0,5,0,0,0,0,225,192,0,15
460,R,113,H R 4315,29-Jul-2014,5:12 PM,On Agreeing to the Amendment,None,Failed,0,224,0,9,188,3,0,8,0,0,0,0,188,227,0,17
461,R,113,H R 4315,29-Jul-2014,5:17 PM,On Agreeing to the Amendment,None,Failed,10,213,0,10,194,2,0,3,0,0,0,0,204,215,0,13
462,R,113,H R 4315,29-Jul-2014,5:34 PM,On Motion to Recommit with Instructions,21st Century Endangered Species Transparency Act,Failed,1,225,0,7,196,0,0,3,0,0,0,0,197,225,0,10
463,R,113,H R 4315,29-Jul-2014,5:41 PM,On Passage,21st Century Endangered Species Transparency Act,Passed,219,8,0,6,14,182,0,3,0,0,0,0,233,190,0,9
464,R,113,H R 4809,29-Jul-2014,5:48 PM,"On Motion to Suspend the Rules and Pass, as Amended","To reauthorize the Defense Production Act, to improve the Defense Production Act Committee, and for other purposes",Passed,193,30,0,10,193,2,0,4,0,0,0,0,386,32,0,14
465,R,113,H RES 694,30-Jul-2014,4:23 PM,On Ordering the Previous Question,"Providing for consideration of H.Res. 676, providing for authority to initiate litigation for actions by the President or other executive branch officials inconsistent with their duties under the Constitution of the United States and H.R. 935, Reducing Regulatory Burdens Act of 2013; and for other purposes",Passed,227,0,0,6,0,195,0,4,0,0,0,0,227,195,0,10
466,R,113,H RES 694,30-Jul-2014,4:33 PM,On Agreeing to the Resolution,"Providing for consideration of H.Res. 676, providing for authority to initiate litigation for actions by the President or other executive branch officials inconsistent with their duties under the Constitution of the United States and H.R. 935, Reducing Regulatory Burdens Act of 2013; and for other purposes",Passed,227,1,0,5,0,195,0,4,0,0,0,0,227,196,0,9
467,R,113,H R 3230,30-Jul-2014,4:40 PM,On Motion to Suspend the Rules and Agree to the Conference Report,"Veterans’ Access to Care through Choice, Accountability, and Transparency Act of 2014",Passed,225,5,0,3,195,0,0,4,0,0,0,0,420,5,0,7
468,R,113,H RES 676,30-Jul-2014,6:28 PM,"On Agreeing to the Resolution, as Amended",Providing for authority to initiate litigation for actions by the President or other executive branch officials inconsistent with their duties under the Constitution of the United States,Passed,225,5,0,3,0,196,0,3,0,0,0,0,225,201,0,6
469,R,113,H R 935,31-Jul-2014,11:20 AM,On Motion to Recommit with Instructions,"To amend the Federal Insecticide, Fungicide, and Rodenticide Act and the Federal Water Pollution Control Act to clarify Congressional intent regarding the regulation of the use of pesticides in or near navigable waters, and for other purposes",Failed,0,230,0,3,195,3,0,1,0,0,0,0,195,233,0,4
470,R,113,H R 935,31-Jul-2014,11:42 AM,On Passage,"To amend the Federal Insecticide, Fungicide, and Rodenticide Act and the Federal Water Pollution Control Act to clarify Congressional intent regarding the regulation of the use of pesticides in or near navigable waters, and for other purposes",Passed,230,0,0,3,37,161,0,1,0,0,0,0,267,161,0,4
471,R,113,H RES 696,31-Jul-2014,11:49 AM,On Ordering the Previous Question,"Providing for consideration of H.R. 5230, making supplemental appropriations for the fiscal year ending September 30, 2014, H.R. 5272, to prohibit certain actions with respect to deferred action for aliens not lawfully present in the United States, and H.R. 5021, the Highway and Transportation Funding Act",Passed,224,2,0,7,2,196,0,1,0,0,0,0,226,198,0,8
472,R,113,H RES 696,31-Jul-2014,11:56 AM,On Agreeing to the Resolution,"Providing for consideration of H.R. 5230, making supplemental appropriations for the fiscal year ending September 30, 2014, H.R. 5272, to prohibit certain actions with respect to deferred action for aliens not lawfully present in the United States, and H.R. 5021, the Highway and Transportation Funding Act",Passed,220,7,0,6,0,198,0,1,0,0,0,0,220,205,0,7
473,R,113,H R 5021,31-Jul-2014,2:24 PM,On Motion to Disagree to the Senate Amendment,"To provide an extension of Federal-aid highway, highway safety, motor carrier safety, transit, and other programs funded out of the Highway Trust Fund, and for other purposes.",Passed,227,2,0,4,45,148,0,6,0,0,0,0,272,150,0,10
474,R,113,H RES 700,1-Aug-2014,11:54 AM,On Ordering the Previous Question,"Waiving a requirement of clause 6(a) of rule XIII with respect to consideration of certain resolutions reported from the Committee on Rules, and providing for consideration of motions to suspend the rules",Passed,226,0,0,7,0,184,0,15,0,0,0,0,226,184,0,22
475,R,113,H RES 700,1-Aug-2014,12:02 PM,On Agreeing to the Resolution,"Waiving a requirement of clause 6(a) of rule XIII with respect to consideration of certain resolutions reported from the Committee on Rules, and providing for consideration of motions to suspend the rules",Passed,219,6,0,8,0,184,0,15,0,0,0,0,219,190,0,23
476,R,113,H RES 710,1-Aug-2014,6:58 PM,On Ordering the Previous Question,"Providing for further consideration of the bill (H.R. 5230) making supplemental appropriations for the fiscal year ending September 30, 2014, and for other purposes; providing for consideration of the bill (H.R. 5272) to prohibit certain actions with respect to deferred action for aliens not lawfully present in the U.S",Passed,226,0,0,7,0,183,0,16,0,0,0,0,226,183,0,23
477,R,113,H RES 710,1-Aug-2014,7:07 PM,On Agreeing to the Resolution,"Providing for further consideration of the bill (H.R. 5230) making supplemental appropriations for the fiscal year ending September 30, 2014, and for other purposes; providing for consideration of the bill (H.R. 5272) to prohibit certain actions with respect to deferred action for aliens not lawfully present in the U.S",Passed,218,6,0,9,0,185,0,14,0,0,0,0,218,191,0,23
478,R,113,H R 5230,1-Aug-2014,8:37 PM,On Passage,"Supplemental Appropriations, FY 2014",Passed,222,4,0,7,1,185,0,13,0,0,0,0,223,189,0,20
479,R,113,H R 5272,1-Aug-2014,9:55 PM,On Passage,"To prohibit certain actions with respect to deferred action for aliens not lawfully present in the United States, and for other purposes.",Passed,212,11,0,10,4,181,1,13,0,0,0,0,216,192,1,23
480,R,113,H J RES 76,1-Aug-2014,10:03 PM,On Motion to Concur in the Senate Amendments,"Making continuing appropriations for the National Security Administration for fiscal year 2014, and for other purposes.",Passed,214,4,0,15,181,4,0,14,0,0,0,0,395,8,0,29
481,R,113,H R 5089,8-Sep-2014,6:56 PM,On Motion to Suspend the Rules and Pass,"To designate the facility of the United States Postal Service located at 2000 Mulford Road in Mulberry, Florida, as the “Sergeant First Class Daniel M. Ferguson Post Office”.",Passed,222,0,0,10,179,0,0,20,0,0,0,0,401,0,0,30
482,R,113,H R 5019,8-Sep-2014,7:03 PM,On Motion to Suspend the Rules and Pass,"To designate the facility of the United States Postal Service located at 1335 Jefferson Road in Rochester, New York, as the “Specialist Theodore Matthew Glende Post Office”.",Passed,222,0,0,10,177,0,0,22,0,0,0,0,399,0,0,32
483,R,113,H R 4283,8-Sep-2014,7:13 PM,"On Motion to Suspend the Rules and Pass, as Amended","To amend the Wild and Scenic Rivers Act to authorize the Secretary of the Interior to maintain or replace certain facilities and structures for commercial recreation services at Smith Gulch in Idaho, and for other purposes",Passed,218,1,0,13,180,0,0,19,0,0,0,0,398,1,0,32
484,R,113,H RES 715,9-Sep-2014,1:52 PM,On Agreeing to the Resolution,"Providing for consideration of the bill (H.R. 5078) Waters of the United States Regulatory Overreach Protection Act and providing for consideration of the resolution (H.Res. 644) relating to the release of individuals detained at United States Naval Station, Guantanamo Bay, Cuba",Passed,222,0,0,10,7,179,0,13,0,0,0,0,229,179,0,23
485,R,113,H RES 644,9-Sep-2014,4:55 PM,On Agreeing to the Resolution,"Condemning the Obama administration’s failure to comply with the lawful statutory requirement to notify Congress before releasing individuals detained at Guantanamo Bay, Cuba, and expressing national security concerns over the release of five Taliban leaders and the repercussions of negotiating with terrorists",Passed,227,0,0,5,22,163,0,14,0,0,0,0,249,163,0,19
486,R,113,H R 5078,9-Sep-2014,5:02 PM,On Agreeing to the Amendment,None,Failed,2,226,0,4,161,22,0,16,0,0,0,0,163,248,0,20
487,R,113,H R 5078,9-Sep-2014,5:07 PM,On Agreeing to the Amendment,None,Failed,0,228,0,4,170,12,0,17,0,0,0,0,170,240,0,21
488,R,113,H R 5078,9-Sep-2014,5:24 PM,On Motion to Recommit with Instructions,Waters of the United States Regulatory Overreach Protection Act,Failed,0,227,0,5,177,8,0,14,0,0,0,0,177,235,0,19
489,R,113,H R 5078,9-Sep-2014,5:31 PM,On Passage,Waters of the United States Regulatory Overreach Protection Act,Passed,227,1,0,4,35,151,0,13,0,0,0,0,262,152,0,17
490,R,113,H RES 717,10-Sep-2014,3:34 PM,On Ordering the Previous Question,"Providing for consideration of H.R. 3522, Employee Health Care Protection Act of 2013",Passed,227,0,0,5,0,196,0,3,0,0,0,0,227,196,0,8
491,R,113,H RES 717,10-Sep-2014,3:42 PM,On Agreeing to the Resolution,"Providing for consideration of H.R. 3522, Employee Health Care Protection Act of 2013",Passed,228,0,0,4,5,187,0,7,0,0,0,0,233,187,0,11
492,R,113,H R 2678,10-Sep-2014,3:51 PM,On Motion to Suspend the Rules and Pass,"To designate the facility of the United States Postal Service located at 10360 Southwest 186th Street in Miami, Florida, as the “Larcenia J. Bullard Post Office Building”.",Passed,227,2,0,3,195,0,0,4,0,0,0,0,422,2,0,7
493,R,113,H R 4751,10-Sep-2014,3:59 PM,On Motion to Suspend the Rules and Pass,"To make technical corrections to Public Law 110-229 to reflect the renaming of the Bainbridge Island Japanese American Exclusion Memorial, and for other purposes",Passed,228,0,0,4,194,0,0,5,0,0,0,0,422,0,0,9
494,R,113,H R 3522,11-Sep-2014,1:05 PM,On Motion to Recommit with Instructions,"To authorize health insurance issuers to continue to offer for sale current group health insurance coverage in satisfaction of the minimum essential health insurance coverage requirement, and for other purposes",Failed,2,220,0,10,185,3,0,11,0,0,0,0,187,223,0,21
495,R,113,H R 3522,11-Sep-2014,1:12 PM,On Passage,"To authorize health insurance issuers to continue to offer for sale current group health insurance coverage in satisfaction of the minimum essential health insurance coverage requirement, and for other purposes",Passed,222,0,0,10,25,167,0,7,0,0,0,0,247,167,0,17
496,R,113,H R 5161,11-Sep-2014,1:22 PM,On Motion to Suspend the Rules and Pass,E-LABEL Act,Passed,215,0,0,17,187,0,0,12,0,0,0,0,402,0,0,29
497,R,113,H R 5108,15-Sep-2014,6:57 PM,"On Motion to Suspend the Rules and Pass, as Amended","To establish the Law School Clinic Certification Program of the United States Patent and Trademark Office, and for other purposes.",Passed,173,22,0,37,154,0,0,45,0,0,0,0,327,22,0,82
498,R,113,H RES 722,16-Sep-2014,2:02 PM,On Ordering the Previous Question,"Providing for consideration of the joint resolution (H.J.Res. 124) making continuing appropriations for fiscal year 2015, and for other purposes",Passed,222,0,0,10,2,188,0,9,0,0,0,0,224,188,0,19
499,R,113,H RES 722,16-Sep-2014,2:12 PM,On Agreeing to the Resolution,"Providing for consideration of the joint resolution (H.J.Res. 124) making continuing appropriations for fiscal year 2015, and for other purposes",Passed,216,6,0,10,5,186,0,8,0,0,0,0,221,192,0,18
500,R,113,S 2154,16-Sep-2014,2:19 PM,On Motion to Suspend the Rules and Pass,Emergency Medical Services for Children Reauthorization Act of 2014,Passed,219,4,0,9,191,0,0,8,0,0,0,0,410,4,0,17
501,R,113,H R 5405,16-Sep-2014,6:41 PM,"On Motion to Suspend the Rules and Pass, as Amended","To make technical corrections to the Dodd-Frank Wall Street Reform and Consumer Protection Act, to enhance the ability of small and emerging growth companies to access capital through public and private markets, to reduce regulatory burdens, and for other purposes",Passed,225,1,0,6,95,101,0,3,0,0,0,0,320,102,0,9
502,R,113,H R 5461,16-Sep-2014,6:49 PM,On Motion to Suspend the Rules and Pass,"To clarify the application of certain leverage and risk-based requirements under the Dodd-Frank Wall Street Reform and Consumer Protection Act, to improve upon the definitions provided for points and fees in connection with a mortgage transaction, and for other purposes",Passed,227,1,0,4,100,96,0,3,0,0,0,0,327,97,0,7
503,R,113,S 1603,16-Sep-2014,6:57 PM,On Motion to Suspend the Rules and Pass,Gun Lake Trust Land Reaffirmation Act,Passed,166,61,0,5,193,3,0,3,0,0,0,0,359,64,0,8
504,R,113,H R 24,17-Sep-2014,1:43 PM,"On Motion to Suspend the Rules and Pass, as Amended","To require a full audit of the Board of Governors of the Federal Reserve System and the Federal reserve banks by the Comptroller General of the United States, and for other purposes",Passed,227,1,0,4,106,91,0,2,0,0,0,0,333,92,0,6
505,R,113,H R 5462,17-Sep-2014,1:51 PM,On Motion to Suspend the Rules and Pass,"To amend title 49, United States Code, to provide for limitations on the fees charged to passengers of air carriers.",Passed,226,0,0,6,197,0,0,2,0,0,0,0,423,0,0,8
506,R,113,S 476,17-Sep-2014,1:59 PM,On Motion to Suspend the Rules and Pass,To amend the Chesapeake and Ohio Canal Development Act to extend to the Chesapeake and Ohio Canal National Historical Park Commission.,Passed,224,0,0,8,195,0,0,4,0,0,0,0,419,0,0,12
507,R,113,H J RES 124,17-Sep-2014,5:07 PM,On Agreeing to the Amendment,None,Agreed to,159,71,0,3,114,85,0,0,0,0,0,0,273,156,0,3
508,R,113,H J RES 124,17-Sep-2014,5:23 PM,On Motion to Recommit with Instructions,"Making continuing appropriations for fiscal year 2015, and for other purposes",Failed,0,228,0,4,199,0,0,0,0,0,0,0,199,228,0,4
509,R,113,H J RES 124,17-Sep-2014,5:31 PM,On Passage,"Making continuing appropriations for fiscal year 2015, and for other purposes",Passed,176,53,0,3,143,55,0,1,0,0,0,0,319,108,0,4
510,R,113,H RES 727,18-Sep-2014,1:59 PM,On Ordering the Previous Question,"Providing for consideration of H.R. 2, the American Energy Solutions for Lower Costs and More American Jobs Act; H.R. 4, the Jobs for America Act; and providing for proceedings during the period from September 22, 2014, through November 11, 2014.",Passed,226,0,0,6,0,195,0,4,0,0,0,0,226,195,0,10
511,R,113,H RES 727,18-Sep-2014,2:08 PM,On Agreeing to the Resolution,"Providing for consideration of H.R. 2, the American Energy Solutions for Lower Costs and More American Jobs Act; H.R. 4, the Jobs for America Act; and providing for proceedings during the period from September 22, 2014, through November 11, 2014.",Passed,225,0,0,7,2,193,0,4,0,0,0,0,227,193,0,11
512,R,113,H R 4,18-Sep-2014,6:37 PM,On Motion to Recommit with Instructions,Jobs for America Act,Failed,0,217,0,15,191,1,0,7,0,0,0,0,191,218,0,22
513,R,113,H R 4,18-Sep-2014,6:44 PM,On Passage,Jobs for America Act,Passed,221,1,0,10,32,162,0,5,0,0,0,0,253,163,0,15
514,R,113,H R 2,18-Sep-2014,6:53 PM,On Motion to Recommit with Instructions,American Energy Solutions for Lower Costs and More American Jobs Act,Failed,0,222,0,10,193,0,0,6,0,0,0,0,193,222,0,16
515,R,113,H R 2,18-Sep-2014,7:00 PM,On Passage,American Energy Solutions for Lower Costs and More American Jobs Act,Passed,217,7,0,8,9,184,0,6,0,0,0,0,226,191,0,14
516,R,113,H R 4194,12-Nov-2014,6:54 PM,On Motion to Suspend the Rules and Concur in the Senate Amendment,Government Reports Elimination Act of 2014,Passed,209,0,0,23,173,0,0,26,0,0,0,0,382,0,0,49
517,R,113,H RES 748,13-Nov-2014,5:45 PM,On Agreeing to the Resolution,Providing for consideration of the bill (H.R. 5682) to approve the Keystone XL Pipeline,Passed,225,0,0,8,8,185,0,8,0,0,0,0,233,185,0,16
518,R,113,H R 5682,14-Nov-2014,12:42 PM,On Motion to Recommit with Instructions,To approve the Keystone XL Pipeline,Failed,0,224,0,9,192,0,0,9,0,0,0,0,192,224,0,18
519,R,113,H R 5682,14-Nov-2014,12:52 PM,On Passage,To approve the Keystone XL Pipeline,Passed,221,0,1,11,31,161,0,9,0,0,0,0,252,161,1,20
520,R,113,H R 5162,17-Nov-2014,6:54 PM,On Motion to Suspend the Rules and Pass,"An Act to allow a certain parcel of land in Rockingham County, Virginia, to be used for a child care center",Passed,207,1,0,25,171,0,0,30,0,0,0,0,378,1,0,55
521,R,113,H RES 756,18-Nov-2014,1:22 PM,On Ordering the Previous Question,Providing for consideration of the bill (H.R. 1422) EPA Science Advisory Board Reform Act; providing for consideration of the bill (H.R. 4012) Secret Science Reform Act; and providing for consideration of the bill (H.R. 4795) Promoting New Manufacturing Act,Passed,225,0,0,8,0,190,0,11,0,0,0,0,225,190,0,19
522,R,113,H RES 756,18-Nov-2014,1:30 PM,On Agreeing to the Resolution,Providing for consideration of the bill (H.R. 1422) EPA Science Advisory Board Reform Act; providing for consideration of the bill (H.R. 4012) Secret Science Reform Act; and providing for consideration of the bill (H.R. 4795) Promoting New Manufacturing Act,Passed,227,0,0,6,0,192,0,9,0,0,0,0,227,192,0,15
523,R,113,H R 1422,18-Nov-2014,5:33 PM,On Agreeing to the Amendment,None,Agreed to,223,0,0,10,9,184,0,8,0,0,0,0,232,184,0,18
524,R,113,H R 1422,18-Nov-2014,5:52 PM,On Motion to Recommit with Instructions,EPA Science Advisory Board Reform Act,Failed,1,224,0,8,194,1,0,6,0,0,0,0,195,225,0,14
525,R,113,H R 1422,18-Nov-2014,6:01 PM,On Passage,EPA Science Advisory Board Reform Act,Passed,225,1,0,7,4,190,0,7,0,0,0,0,229,191,0,14
526,R,113,H R 4012,19-Nov-2014,2:51 PM,On Agreeing to the Amendment,None,Failed,1,229,0,3,193,1,0,7,0,0,0,0,194,230,0,10
527,R,113,H R 4012,19-Nov-2014,3:13 PM,On Motion to Recommit with Instructions,Secret Science Reform Act of 2014,Failed,0,230,0,3,196,0,0,5,0,0,0,0,196,230,0,8
528,R,113,H R 4012,19-Nov-2014,3:21 PM,On Passage,Secret Science Reform Act of 2014,Passed,229,1,0,3,8,189,0,4,0,0,0,0,237,190,0,7
529,R,113,H R 4795,20-Nov-2014,10:30 AM,On Agreeing to the Amendment,None,Failed,1,222,0,10,182,3,0,16,0,0,0,0,183,225,0,26
530,R,113,H R 4795,20-Nov-2014,10:50 AM,On Motion to Recommit with Instructions,Promoting New Manufacturing Act,Failed,0,223,0,10,189,0,0,12,0,0,0,0,189,223,0,22
531,R,113,H R 4795,20-Nov-2014,10:58 AM,On Passage,Promoting New Manufacturing Act,Passed,222,0,0,11,16,172,0,13,0,0,0,0,238,172,0,24
532,R,113,H R 5629,1-Dec-2014,6:55 PM,"On Motion to Suspend the Rules and Pass, as Amended","To amend the Homeland Security Act of 2002 to strengthen the Domestic Nuclear Detection Office, and for other purposes",Passed,201,11,0,21,173,0,0,28,0,0,0,0,374,11,0,49
533,R,113,H R 3438,1-Dec-2014,7:04 PM,On Motion to Suspend the Rules and Pass,To amend the Homeland Security Act of 2002 to authorize use of grants under the Urban Area Security Initiative and the State Homeland Security Grant Program to work in conjunction with a Department of Energy national laboratory,Passed,214,0,0,19,172,0,0,29,0,0,0,0,386,0,0,48
534,R,113,S 2040,2-Dec-2014,1:24 PM,On Motion to Suspend the Rules and Pass,"To exchange trust and fee land to resolve land disputes created by the realignment of the Blackfoot River along the boundary of the Fort Hall Indian Reservation, and for other purposes",Passed,224,0,0,9,190,0,0,11,0,0,0,0,414,0,0,20
535,R,113,H R 5050,2-Dec-2014,1:33 PM,On Motion to Suspend the Rules and Pass,"To repeal the Act of May 31, 1918, and for other purposes",Passed,226,0,0,7,192,0,0,9,0,0,0,0,418,0,0,16
536,R,113,H R 3572,2-Dec-2014,1:40 PM,"On Motion to Suspend the Rules and Pass, as Amended",To revise the boundaries of certain John H. Chafee Coastal Barrier Resources System units in North Carolina,Passed,219,7,0,7,191,0,0,10,0,0,0,0,410,7,0,17
537,R,113,H R 5739,2-Dec-2014,4:03 PM,On Motion to Suspend the Rules and Pass,No Social Security for Nazis Act,Passed,228,0,0,5,192,0,0,9,0,0,0,0,420,0,0,14
538,R,113,H R 3240,2-Dec-2014,4:10 PM,On Motion to Suspend the Rules and Pass,"To instruct the Comptroller General of the United States to study the impact of Regulation D, and for other purposes",Passed,229,0,0,4,193,0,0,8,0,0,0,0,422,0,0,12
539,R,113,H R 2366,2-Dec-2014,4:17 PM,"On Motion to Suspend the Rules and Pass, as Amended",To require the Secretary of the Treasury to mint coins in commemoration of the centennial of World War I,Passed,226,3,0,4,192,0,0,9,0,0,0,0,418,3,0,13
540,R,113,H RES 766,3-Dec-2014,3:10 PM,On Agreeing to the Resolution,"Providing for consideration of H.R. 5771, to amend the Internal Revenue Code of 1986 to extend certain expiring provisions, and H.R. 647, to amend the Internal Revenue Code of 1986 to provide for the tax treatment of ABLE accounts established under State Programs for the care of family members with disabilities",Passed,224,3,0,6,7,189,0,5,0,0,0,0,231,192,0,11
541,R,113,H R 5769,3-Dec-2014,3:17 PM,On Motion to Suspend the Rules and Pass,"To authorize appropriations for the Coast Guard for fiscal year 2015, and for other purposes",Passed,222,0,0,11,191,3,0,7,0,0,0,0,413,3,0,18
542,R,113,JOURNAL,3-Dec-2014,3:24 PM,On Approving the Journal,None,Passed,154,69,1,9,121,68,1,11,0,0,0,0,275,137,2,20
543,R,113,H R 5771,3-Dec-2014,5:37 PM,On Motion to Recommit with Instructions,Tax Increase Prevention Act,Failed,2,223,0,8,195,0,0,6,0,0,0,0,197,223,0,14
544,R,113,H R 5771,3-Dec-2014,5:45 PM,On Passage,Tax Increase Prevention Act,Passed,202,26,0,5,176,20,0,5,0,0,0,0,378,46,0,10
545,R,113,H R 647,3-Dec-2014,5:55 PM,On Passage,Achieving a Better Life Experience Act,Passed,221,5,0,7,183,12,0,6,0,0,0,0,404,17,0,13
546,R,113,H RES 770,4-Dec-2014,10:52 AM,On Ordering the Previous Question,"Providing for consideration of the Senate amendment to H.R. 3979, an Act to amend the Internal Revenue Code of 1986; providing for consideration of H.R. 5759, Executive Amnesty Prevention Act of 2014; and providing for consideration of H.R. 5781, to provide short-term water supplies to drought-stricken CA",Passed,227,0,0,6,0,191,0,10,0,0,0,0,227,191,0,16
547,R,113,H RES 770,4-Dec-2014,11:01 AM,"On Agreeing to the Resolution, as Amended","Providing for consideration of the Senate amendment to H.R. 3979, an Act to amend the Internal Revenue Code of 1986; providing for consideration of H.R. 5759, Executive Amnesty Prevention Act of 2014; and providing for consideration of H.R. 5781, to provide short-term water supplies to drought-stricken CA",Passed,227,1,0,5,5,190,0,6,0,0,0,0,232,191,0,11
548,R,113,H RES 758,4-Dec-2014,11:10 AM,"On Motion to Suspend the Rules and Agree, as Amended","Strongly condemning the actions of the Russian Federation, under President Vladimir Putin, which has carried out a policy of aggression against neighboring countries aimed at political and economic domination",Passed,222,5,0,6,189,5,0,7,0,0,0,0,411,10,0,13
549,R,113,H R 5759,4-Dec-2014,2:19 PM,On Motion to Recommit with Instructions,To establish a rule of construction clarifying the limitations on executive authority to provide certain forms of immigration relief,Failed,0,225,0,8,194,0,0,7,0,0,0,0,194,225,0,15
550,R,113,H R 5759,4-Dec-2014,2:28 PM,On Passage,To establish a rule of construction clarifying the limitations on executive authority to provide certain forms of immigration relief,Passed,216,7,3,7,3,190,0,8,0,0,0,0,219,197,3,15
551,R,113,H R 3979,4-Dec-2014,2:37 PM,On Motion to Concur in the Senate Amendment with an Amendment,Protecting Volunteer Firefighters and Emergency Responders Act of 2014,Passed,194,32,0,7,106,87,0,8,0,0,0,0,300,119,0,15
552,R,113,H R 5781,9-Dec-2014,1:43 PM,On Motion to Recommit with Instructions,California Emergency Drought Relief Act 2014,Failed,0,225,0,8,182,3,0,16,0,0,0,0,182,228,0,24
553,R,113,H R 5781,9-Dec-2014,1:52 PM,On Passage,California Emergency Drought Relief Act 2014,Passed,224,0,0,9,6,182,0,13,0,0,0,0,230,182,0,22
554,R,113,H RES 775,10-Dec-2014,2:27 PM,On Agreeing to the Resolution,"Providing for consideration of S. 2244, the Terrorism Risk Insurance Program Reauthorization Act of 2014; and for other purposes",Passed,226,0,0,7,5,189,0,7,0,0,0,0,231,189,0,14
555,R,113,S 1000,10-Dec-2014,2:36 PM,On Motion to Suspend the Rules and Pass,Chesapeake Bay Accountability and Recovery Act of 2014,Passed,226,0,0,7,190,0,0,11,0,0,0,0,416,0,0,18
556,R,113,JOURNAL,10-Dec-2014,2:47 PM,On Approving the Journal,None,Passed,141,84,0,8,120,71,1,9,0,0,0,0,261,155,1,17
557,R,113,S 2244,10-Dec-2014,4:56 PM,On Passage,"To extend the termination date of the Terrorism Insurance Program established under the Terrorism Risk Insurance Act of 2002, and for other purposes",Passed,221,7,0,5,196,0,0,5,0,0,0,0,417,7,0,10
558,R,113,H R 4681,10-Dec-2014,5:04 PM,On Motion to Suspend the Rules and Concur in the Senate Amendment,Intelligence Authorization Act for Fiscal Years 2014 and 2015,Passed,184,45,0,4,141,55,0,5,0,0,0,0,325,100,0,9
559,R,113,H R 2719,10-Dec-2014,5:12 PM,On Motion to Suspend the Rules and Concur in the Senate Amendment,"To require the Transportation Security Administration to implement best practices and improve transparency with regard to technology acquisition programs, and for other purposes",Passed,229,0,0,4,196,0,0,5,0,0,0,0,425,0,0,9
560,R,113,H R 1204,10-Dec-2014,5:19 PM,On Motion to Suspend the Rules and Concur in the Senate Amendment,"To amend title 49, United States Code, to direct the Assistant Secretary of Homeland Security (Transportation Security Administration) to establish an Aviation Security Advisory Committee, and for other purposes",Passed,222,4,0,7,194,1,0,6,0,0,0,0,416,5,0,13
561,R,113,H RES 776,11-Dec-2014,12:15 PM,On Agreeing to the Resolution,"Providing for consideration of the Senate amendment to H.R. 83, to require the Secretary of the Interior to assemble a team of experts to address the energy needs of the insular areas of the United States and Freely Associated States through the development of energy action plans aimed at promoting access to energy",Passed,214,16,0,4,0,196,0,5,0,0,0,0,214,212,0,9
562,R,113,H R 5806,11-Dec-2014,12:26 PM,On Motion to Suspend the Rules and Pass,Supporting America’s Charities Act,Failed,228,0,0,5,47,149,0,5,0,0,0,0,275,149,0,10
563,R,113,H R 83,11-Dec-2014,9:37 PM,On Motion to Concur in the Senate Amendment with an Amendment,An Act to require the Secretary of the Interior to assemble a team of experts to address the energy needs of the insular areas of the United States and Freely Associated States through the development of energy action plans aimed at promoting access to energy,Passed,162,67,0,5,57,139,0,5,0,0,0,0,219,206,0,10
564,R,113,H R 5699,11-Dec-2014,9:49 PM,"On Motion to Suspend the Rules and Pass, as Amended",John Muir National Historic Site Expansion Act,Passed,175,38,0,20,186,1,0,14,0,0,0,0,361,39,0,34
