Roll Call,Majority,Congress Num,Legislation Number,Date,Time,Question,Description,Result,Republican Yes,Republican No,Republican Present,Republican Not Voting,Democrat Yes,Democrat No,Democrat Present,Democrat Not Voting,Independent Yes,Independent No,Independent Present,Independent Not Voting,Total Yes,Total No,Total Present,Total Not Voting
1,R,114,QUORUM,6-Jan-2015,12:36 PM,Call by States,None,Passed,0,0,238,8,0,0,163,25,0,0,0,0,0,0,401,33
2
3,R,114,H RES 5,6-Jan-2015,3:07 PM,Table Motion to Refer,Adopting rules for the One Hundred Fourteenth Congress,Passed,230,0,0,11,0,160,0,10,0,0,0,0,230,160,0,21
4,R,114,H RES 5,6-Jan-2015,4:52 PM,On Ordering the Previous Question,Adopting rules for the One Hundred Fourteenth Congress,Passed,239,1,0,2,0,167,0,6,0,0,0,0,239,168,0,8
5,R,114,H RES 5,6-Jan-2015,5:14 PM,On Motion to Commit with Instructions,Adopting rules for the One Hundred Fourteenth Congress,Failed,0,239,0,3,168,4,0,1,0,0,0,0,168,243,0,4
6,R,114,H RES 5,6-Jan-2015,5:30 PM,On Agreeing to the Resolution,Adopting rules for the One Hundred Fourteenth Congress,Passed,234,4,1,3,0,168,0,5,0,0,0,0,234,172,1,8
7,R,114,H R 22,6-Jan-2015,6:31 PM,On Motion to Suspend the Rules and Pass,Hire More Heroes Act of 2015,Passed,240,0,0,2,172,0,0,1,0,0,0,0,412,0,0,3
8,R,114,H R 26,7-Jan-2015,3:07 PM,On Motion to Suspend the Rules and Pass,Terrorism Risk Insurance Program Reauthorization Act,Passed,237,5,0,0,179,0,1,5,0,0,0,0,416,5,1,5
9,R,114,H R 37,7-Jan-2015,3:23 PM,On Motion to Suspend the Rules and Pass,Promoting Job Creation and Reducing Small Business Burdens Act,Failed,241,1,0,0,35,145,0,5,0,0,0,0,276,146,0,5
10,R,114,H R 23,7-Jan-2015,3:32 PM,On Motion to Suspend the Rules and Pass,National Windstorm Impact Reduction Act Reauthorization,Passed,201,39,0,2,180,0,0,5,0,0,0,0,381,39,0,7
11,R,114,H RES 19,8-Jan-2015,1:53 PM,On Ordering the Previous Question,"Providing for consideration of the bill (H.R. 3) to approve the Keystone XL Pipeline, and providing for consideration of the bill (H.R. 30) the “Save American Workers Act of 2015”",Passed,239,0,0,3,1,180,0,6,0,0,0,0,240,180,0,9
12,R,114,H RES 19,8-Jan-2015,2:10 PM,On Agreeing to the Resolution,"Providing for consideration of the bill (H.R. 3) to approve the Keystone XL Pipeline, and providing for consideration of the bill (H.R. 30) the “Save American Workers Act of 2015”",Passed,241,0,0,1,3,181,0,3,0,0,0,0,244,181,0,4
13,R,114,H R 30,8-Jan-2015,4:07 PM,On Motion to Recommit with Instructions,Save American Workers Act of 2015,Failed,0,240,0,2,179,4,0,4,0,0,0,0,179,244,0,6
14,R,114,H R 30,8-Jan-2015,4:16 PM,On Passage,Save American Workers Act of 2015,Passed,240,0,0,2,12,172,0,3,0,0,0,0,252,172,0,5
15,R,114,H R 3,9-Jan-2015,12:56 PM,On Motion to Recommit with Instructions,Keystone XL Pipeline Act,Failed,0,237,0,5,180,0,0,7,0,0,0,0,180,237,0,12
16,R,114,H R 3,9-Jan-2015,1:05 PM,On Passage,Keystone XL Pipeline Act,Passed,238,0,1,3,28,153,0,6,0,0,0,0,266,153,1,9
17,R,114,H R 203,12-Jan-2015,7:00 PM,On Motion to Suspend the Rules and Pass,Clay Hunt Suicide Prevention for American Veterans Act,Passed,234,0,0,10,169,0,0,19,0,0,0,0,403,0,0,29
18,R,114,H R 33,12-Jan-2015,7:09 PM,On Motion to Suspend the Rules and Pass,Protecting Volunteer Firefighters and Emergency Responders Act,Passed,232,0,0,12,169,0,0,19,0,0,0,0,401,0,0,31
19,R,114,JOURNAL,12-Jan-2015,7:16 PM,On Approving the Journal,None,Passed,152,75,0,17,105,53,0,30,0,0,0,0,257,128,0,47
20,R,114,H RES 27,13-Jan-2015,2:21 PM,On Ordering the Previous Question,"Providing for consideration of H.R. 37, the Promoting Job Creation and Reducing Small Business Burdens Act; H.R. 185, the Regulatory Accountability Act of 2015; and H.R. 240, Making appropriations for the Department of Homeland Security for the fiscal year ending September 30, 2015, and for other purposes",Passed,242,0,0,3,0,181,0,7,0,0,0,0,242,181,0,10
21,R,114,H RES 27,13-Jan-2015,2:30 PM,On Agreeing to the Resolution,"Providing for consideration of H.R. 37, the Promoting Job Creation and Reducing Small Business Burdens Act; H.R. 185, the Regulatory Accountability Act of 2015; and H.R. 240, Making appropriations for the Department of Homeland Security for the fiscal year ending September 30, 2015, and for other purposes",Passed,241,0,0,4,1,180,0,7,0,0,0,0,242,180,0,11
22,R,114,JOURNAL,13-Jan-2015,2:37 PM,On Approving the Journal,None,Passed,153,88,1,3,108,72,0,8,0,0,0,0,261,160,1,11
23,R,114,H R 185,13-Jan-2015,4:49 PM,On Agreeing to the Amendment,None,Agreed to,241,0,0,4,13,168,0,7,0,0,0,0,254,168,0,11
24,R,114,H R 185,13-Jan-2015,4:56 PM,On Agreeing to the Amendment,None,Failed,1,241,0,3,177,6,0,5,0,0,0,0,178,247,0,8
25,R,114,H R 185,13-Jan-2015,5:00 PM,On Agreeing to the Amendment,None,Failed,0,242,0,3,176,7,0,5,0,0,0,0,176,249,0,8
26,R,114,H R 185,13-Jan-2015,5:05 PM,On Agreeing to the Amendment,None,Failed,1,242,0,2,177,6,0,5,0,0,0,0,178,248,0,7
27,R,114,H R 185,13-Jan-2015,5:21 PM,On Motion to Recommit with Instructions,To reform the process by which Federal agencies analyze and formulate new regulations and guidance documents.,Failed,0,243,0,2,180,2,0,6,0,0,0,0,180,245,0,8
28,R,114,H R 185,13-Jan-2015,5:29 PM,On Passage,To reform the process by which Federal agencies analyze and formulate new regulations and guidance documents.,Passed,242,0,0,3,8,175,0,5,0,0,0,0,250,175,0,8
29,R,114,H R 240,14-Jan-2015,11:15 AM,On Agreeing to the Amendment,None,Agreed to,237,7,0,1,0,183,0,5,0,0,0,0,237,190,0,6
30,R,114,H R 240,14-Jan-2015,11:24 AM,On Agreeing to the Amendment,None,Agreed to,218,26,0,1,0,183,0,5,0,0,0,0,218,209,0,6
31,R,114,H R 240,14-Jan-2015,11:28 AM,On Agreeing to the Amendment,None,Agreed to,243,1,0,1,35,148,0,5,0,0,0,0,278,149,0,6
32,R,114,H R 240,14-Jan-2015,11:33 AM,On Agreeing to the Amendment,None,Agreed to,239,2,0,4,14,169,0,5,0,0,0,0,253,171,0,9
33,R,114,H R 240,14-Jan-2015,11:38 AM,On Agreeing to the Amendment,None,Agreed to,243,1,0,1,17,166,0,5,0,0,0,0,260,167,0,6
34,R,114,H R 240,14-Jan-2015,11:57 AM,On Motion to Recommit with Instructions,"Making appropriations for the Department of Homeland Security for the fiscal year ending September 30, 2015, and for other purposes",Failed,0,244,0,1,184,0,0,4,0,0,0,0,184,244,0,5
35,R,114,H R 240,14-Jan-2015,12:04 PM,On Passage,"Making appropriations for the Department of Homeland Security for the fiscal year ending September 30, 2015, and for other purposes",Passed,234,10,0,1,2,181,0,5,0,0,0,0,236,191,0,6
36,R,114,H R 37,14-Jan-2015,12:20 PM,On Motion to Recommit with Instructions,Promoting Job Creation and Reducing Small Business Burdens Act,Failed,1,242,0,2,182,0,0,6,0,0,0,0,183,242,0,8
37,R,114,H R 37,14-Jan-2015,12:26 PM,On Passage,Promoting Job Creation and Reducing Small Business Burdens Act,Passed,242,1,0,2,29,153,0,6,0,0,0,0,271,154,0,8
38,R,114,H RES 38,21-Jan-2015,2:04 PM,On Ordering the Previous Question,"Providing for consideration of H.R. 161, the Natural Gas Pipeline Permitting Reform Act; and providing for consideration of H.R. 36, the Pain-Capable Unborn Child Protection Act",Passed,238,0,0,7,0,182,0,6,0,0,0,0,238,182,0,13
39,R,114,H RES 38,21-Jan-2015,2:13 PM,On Agreeing to the Resolution,"Providing for consideration of H.R. 161, the Natural Gas Pipeline Permitting Reform Act; and providing for consideration of H.R. 36, the Pain-Capable Unborn Child Protection Act",Passed,237,0,0,8,1,181,0,6,0,0,0,0,238,181,0,14
40,R,114,H R 161,21-Jan-2015,3:32 PM,On Motion to Recommit with Instructions,Natural Gas Pipeline Permitting Reform Act,Failed,1,240,0,4,181,1,0,6,0,0,0,0,182,241,0,10
41,R,114,H R 161,21-Jan-2015,3:42 PM,On Passage,Natural Gas Pipeline Permitting Reform Act,Passed,239,0,0,6,14,169,0,5,0,0,0,0,253,169,0,11
42,R,114,H RES 42,22-Jan-2015,10:56 AM,On Ordering the Previous Question,Providing for consideration of the bill (H.R. 7) to prohibit taxpayer funded abortions,Passed,239,0,0,6,0,183,0,5,0,0,0,0,239,183,0,11
43,R,114,H RES 42,22-Jan-2015,11:04 AM,On Agreeing to the Resolution,Providing for consideration of the bill (H.R. 7) to prohibit taxpayer funded abortions,Passed,240,0,0,5,2,179,0,7,0,0,0,0,242,179,0,12
44,R,114,H R 7,22-Jan-2015,1:07 PM,On Motion to Recommit with Instructions,To prohibit taxpayer funded abortions.,Failed,0,239,0,6,177,1,0,10,0,0,0,0,177,240,0,16
45,R,114,H R 7,22-Jan-2015,1:15 PM,On Passage,To prohibit taxpayer funded abortions.,Passed,239,1,0,5,3,178,0,7,0,0,0,0,242,179,0,12
46,R,114,H RES 48,27-Jan-2015,4:06 PM,On Agreeing to the Resolution,"Providing for consideration of the bill (H.R. 351) to provide for expedited approval of exportation of natural gas, and for other purposes",Passed,236,0,0,9,5,169,0,14,0,0,0,0,241,169,0,23
47,R,114,H R 469,27-Jan-2015,4:16 PM,On Motion to Suspend the Rules and Pass,Strengthening Child Welfare Response to Trafficking Act of 2015,Passed,236,0,0,9,174,0,0,14,0,0,0,0,410,0,0,23
48,R,114,H R 246,27-Jan-2015,4:23 PM,On Motion to Suspend the Rules and Pass,To improve the response to victims of child sex trafficking,Passed,237,0,0,8,174,0,0,14,0,0,0,0,411,0,0,22
49,R,114,H R 351,28-Jan-2015,10:50 AM,On Motion to Recommit with Instructions,LNG Permitting Certainty and Transparency Act,Failed,1,237,0,7,174,0,0,14,0,0,0,0,175,237,0,21
50,R,114,H R 351,28-Jan-2015,10:57 AM,On Passage,LNG Permitting Certainty and Transparency Act,Passed,236,1,0,8,41,132,0,15,0,0,0,0,277,133,0,23
51,R,114,H R 361,2-Feb-2015,6:58 PM,On Motion to Suspend the Rules and Pass,Medical Preparedness Allowable Use Act,Passed,221,2,0,22,156,0,0,32,0,0,0,0,377,2,0,54
52,R,114,H R 615,2-Feb-2015,7:06 PM,On Motion to Suspend the Rules and Pass,Department of Homeland Security Interoperable Communications Act,Passed,223,0,0,22,156,0,0,32,0,0,0,0,379,0,0,54
53,R,114,H R 623,2-Feb-2015,7:15 PM,On Motion to Suspend the Rules and Pass,Social Media Working Group Act,Passed,173,50,0,22,155,1,0,32,0,0,0,0,328,51,0,54
54,R,114,H RES 70,3-Feb-2015,2:05 PM,On Ordering the Previous Question,"Providing for consideration of the bill (H.R. 596) to repeal the Patient Protection and Affordable Care Act and health care-related provisions in the Health Care and Education Reconciliation Act of 2010, and for other purposes",Passed,242,0,0,3,0,176,0,12,0,0,0,0,242,176,0,15
55,R,114,H RES 70,3-Feb-2015,2:13 PM,On Agreeing to the Resolution,"Providing for consideration of the bill (H.R. 596) to repeal the Patient Protection and Affordable Care Act and health care-related provisions in the Health Care and Education Reconciliation Act of 2010, and for other purposes",Passed,242,0,0,3,0,178,0,10,0,0,0,0,242,178,0,13
56,R,114,JOURNAL,3-Feb-2015,2:20 PM,On Approving the Journal,None,Passed,158,81,1,5,109,67,0,12,0,0,0,0,267,148,1,17
57,R,114,H R 596,3-Feb-2015,4:57 PM,On Motion to Recommit with Instructions,"To repeal the Patient Protection and Affordable Care Act and health care-related provisions in the Health Care and Education Reconciliation Act of 2010, and for other purposes",Failed,0,240,0,5,179,1,0,8,0,0,0,0,179,241,0,13
58,R,114,H R 596,3-Feb-2015,5:05 PM,On Passage,"To repeal the Patient Protection and Affordable Care Act and health care-related provisions in the Health Care and Education Reconciliation Act of 2010, and for other purposes",Passed,239,3,0,3,0,183,0,5,0,0,0,0,239,186,0,8
59,R,114,H RES 78,4-Feb-2015,1:39 PM,On Ordering the Previous Question,Providing for consideration of the bill (H.R. 527) Small Business Regulatory Flexibility Improvements Act of 2015 and providing for consideration of the bill (H.R. 50) Unfunded Mandates Information and Transparency Act of 2015.,Passed,241,0,0,4,1,174,0,13,0,0,0,0,242,174,0,17
60,R,114,H RES 78,4-Feb-2015,1:48 PM,On Agreeing to the Resolution,Providing for consideration of the bill (H.R. 527) Small Business Regulatory Flexibility Improvements Act of 2015 and providing for consideration of the bill (H.R. 50) Unfunded Mandates Information and Transparency Act of 2015.,Passed,240,0,0,5,3,179,0,6,0,0,0,0,243,179,0,11
61,R,114,H R 50,4-Feb-2015,3:43 PM,On Agreeing to the Amendment,None,Failed,1,241,0,3,178,4,0,6,0,0,0,0,179,245,0,9
62,R,114,H R 50,4-Feb-2015,3:48 PM,On Agreeing to the Amendment,None,Failed,0,240,0,5,173,9,0,6,0,0,0,0,173,249,0,11
63,R,114,H R 50,4-Feb-2015,4:06 PM,On Motion to Recommit with Instructions,Unfunded Mandates Information and Transparency Act of 2015,Failed,2,239,0,4,182,0,0,6,0,0,0,0,184,239,0,10
64,R,114,H R 50,4-Feb-2015,4:15 PM,On Passage,Unfunded Mandates Information and Transparency Act of 2015,Passed,241,0,0,4,9,173,0,6,0,0,0,0,250,173,0,10
65,R,114,H R 527,5-Feb-2015,11:11 AM,On Agreeing to the Amendment,None,Failed,3,234,0,8,181,0,0,7,0,0,0,0,184,234,0,15
66,R,114,H R 527,5-Feb-2015,11:16 AM,On Agreeing to the Amendment,None,Failed,0,240,0,5,172,8,0,8,0,0,0,0,172,248,0,13
67,R,114,H R 527,5-Feb-2015,11:35 AM,On Motion to Recommit with Instructions,Small Business Regulatory Flexibility Improvements Act of 2015,Failed,1,240,0,4,181,0,0,7,0,0,0,0,182,240,0,11
68,R,114,H R 527,5-Feb-2015,11:43 AM,On Passage,Small Business Regulatory Flexibility Improvements Act of 2015,Passed,241,0,0,4,19,163,0,6,0,0,0,0,260,163,0,10
69,R,114,H R 719,10-Feb-2015,6:57 PM,On Motion to Suspend the Rules and Pass,TSA Office of Inspection Accountability Act of 2015,Passed,235,0,0,9,179,0,0,9,0,0,0,0,414,0,0,18
70,R,114,H R 720,10-Feb-2015,7:06 PM,On Motion to Suspend the Rules and Pass,Gerardo Hernandez Airport Security Act of 2015,Passed,233,1,0,10,178,0,0,10,0,0,0,0,411,1,0,20
71,R,114,H RES 100,11-Feb-2015,3:00 PM,On Ordering the Previous Question,"Providing for consideration of S. 1, the Keystone XL Pipeline Approval Act",Passed,242,0,0,2,0,183,0,5,0,0,0,0,242,183,0,7
72,R,114,H RES 100,11-Feb-2015,3:08 PM,On Agreeing to the Resolution,"Providing for consideration of S. 1, the Keystone XL Pipeline Approval Act",Passed,242,0,0,2,6,177,0,5,0,0,0,0,248,177,0,7
73,R,114,JOURNAL,11-Feb-2015,3:18 PM,On Approving the Journal,None,Passed,160,80,1,3,103,76,0,9,0,0,0,0,263,156,1,12
74,R,114,S 1,11-Feb-2015,5:04 PM,On Motion to Commit with Instructions,Keystone XL Pipeline Approval Act,Failed,2,240,0,2,179,1,0,8,0,0,0,0,181,241,0,10
75,R,114,S 1,11-Feb-2015,5:13 PM,On Passage,Keystone XL Pipeline Approval Act,Passed,241,1,0,2,29,151,0,8,0,0,0,0,270,152,0,10
76,R,114,H R 431,11-Feb-2015,5:24 PM,On Motion to Suspend the Rules and Pass,"To award a Congressional Gold Medal to the Foot Soldiers who participated in Bloody Sunday, Turnaround Tuesday, or the final Selma to Montgomery Voting Rights March in March of 1965, which served as a catalyst for the Voting Rights Act of 1965",Passed,239,0,0,5,181,0,0,7,0,0,0,0,420,0,0,12
77,R,114,H RES 101,12-Feb-2015,2:28 PM,On Ordering the Previous Question,"Providing for consideration of H.R. 644, the Fighting Hunger Incentive Act of 2015 and H.R. 636, to amend the Internal Revenue Code of 1986 to permanently extend increased expensing limitations",Passed,232,0,0,12,0,164,0,24,0,0,0,0,232,164,0,36
78,R,114,H RES 101,12-Feb-2015,2:38 PM,On Agreeing to the Resolution,"Providing for consideration of H.R. 644, the Fighting Hunger Incentive Act of 2015 and H.R. 636, to amend the Internal Revenue Code of 1986 to permanently extend increased expensing limitations",Passed,232,0,0,12,1,163,0,24,0,0,0,0,233,163,0,36
79,R,114,H R 644,12-Feb-2015,4:59 PM,On Motion to Recommit with Instructions,Fighting Hunger Incentive Act,Failed,0,241,0,3,168,4,0,16,0,0,0,0,168,245,0,19
80,R,114,H R 644,12-Feb-2015,5:07 PM,On Passage,Fighting Hunger Incentive Act,Passed,240,1,0,3,39,136,0,13,0,0,0,0,279,137,0,16
81,R,114,H R 636,13-Feb-2015,11:06 AM,On Motion to Recommit with Instructions,America’s Small Business Tax Relief Act of 2015,Failed,0,239,0,5,173,2,0,13,0,0,0,0,173,241,0,18
82,R,114,H R 636,13-Feb-2015,11:13 AM,On Passage,America’s Small Business Tax Relief Act of 2015,Passed,239,1,0,4,33,141,0,14,0,0,0,0,272,142,0,18
83,R,114,JOURNAL,13-Feb-2015,11:22 AM,On Approving the Journal,None,Passed,136,87,0,21,97,71,1,19,0,0,0,0,233,158,1,40
84,R,114,H R 212,24-Feb-2015,6:57 PM,"On Motion to Suspend the Rules and Pass, as Amended","To amend the Safe Drinking Water Act to provide for the assessment and management of the risk of cyanotoxins in drinking water, and for other purposes.",Passed,199,37,0,8,176,0,0,12,0,0,0,0,375,37,0,20
85,R,114,H R 734,24-Feb-2015,7:06 PM,On Motion to Suspend the Rules and Pass,Federal Communications Commission Consolidated Reporting Act,Passed,236,0,0,8,175,0,0,13,0,0,0,0,411,0,0,21
86,R,114,H RES 121,25-Feb-2015,2:11 PM,On Ordering the Previous Question,"Providing for consideration of H.R. 529, to amend the Internal Revenue Code of 1986 to improve 529 plans; and providing for consideration of H.R. 5, the Student Success Act",Passed,241,0,0,3,0,181,0,7,0,0,0,0,241,181,0,10
87,R,114,H RES 121,25-Feb-2015,2:18 PM,On Agreeing to the Resolution,"Providing for consideration of H.R. 529, to amend the Internal Revenue Code of 1986 to improve 529 plans; and providing for consideration of H.R. 5, the Student Success Act",Passed,241,0,0,3,2,178,0,8,0,0,0,0,243,178,0,11
88,R,114,H R 1020,25-Feb-2015,2:29 PM,On Motion to Suspend the Rules and Pass,STEM Education Act,Passed,232,8,0,4,180,0,0,8,0,0,0,0,412,8,0,12
89,R,114,H R 529,25-Feb-2015,3:41 PM,On Motion to Recommit with Instructions,To amend the Internal Revenue Code of 1986 to improve 529 plans,Failed,1,240,0,3,175,3,0,10,0,0,0,0,176,243,0,13
90,R,114,H R 529,25-Feb-2015,3:52 PM,On Passage,To amend the Internal Revenue Code of 1986 to improve 529 plans,Passed,240,1,0,3,161,19,0,8,0,0,0,0,401,20,0,11
91,R,114,H RES 125,26-Feb-2015,1:20 PM,On Consideration of the Resolution,"Providing for further consideration of H.R. 5, the Student Success Act",Passed,223,0,0,21,1,167,0,20,0,0,0,0,224,167,0,41
92,R,114,H RES 125,26-Feb-2015,3:02 PM,On Ordering the Previous Question,"Providing for further consideration of H.R. 5, the Student Success Act",Passed,234,0,0,10,0,177,0,11,0,0,0,0,234,177,0,21
93,R,114,H RES 125,26-Feb-2015,3:10 PM,On Agreeing to the Resolution,"Providing for further consideration of H.R. 5, the Student Success Act",Passed,234,1,0,9,0,183,0,5,0,0,0,0,234,184,0,14
94,R,114,JOURNAL,26-Feb-2015,3:17 PM,On Approving the Journal,None,Passed,143,91,1,9,103,77,0,8,0,0,0,0,246,168,1,17
95,R,114,H R 5,26-Feb-2015,7:10 PM,On Agreeing to the Amendment,None,Failed,24,217,0,3,180,0,0,8,0,0,0,0,204,217,0,11
96,R,114,H R 5,26-Feb-2015,7:16 PM,On Agreeing to the Amendment,None,Failed,96,145,0,3,18,166,0,4,0,0,0,0,114,311,0,7
97,R,114,H R 5,26-Feb-2015,7:24 PM,On Agreeing to the Amendment,None,Failed,2,239,0,3,180,4,0,4,0,0,0,0,182,243,0,7
98,R,114,H R 5,26-Feb-2015,7:28 PM,On Agreeing to the Amendment,None,Agreed to,35,201,0,8,183,0,0,5,0,0,0,0,218,201,0,13
99,R,114,H R 5,26-Feb-2015,7:33 PM,On Agreeing to the Amendment,None,Failed,2,238,0,4,183,1,0,4,0,0,0,0,185,239,0,8
100,R,114,H RES 129,27-Feb-2015,10:49 AM,On Ordering the Previous Question,"Providing for consideration of the joint resolution (H.J.Res. 35) making further continuing appropriations for fiscal year 2015, and for other purposes",Passed,240,0,0,4,0,183,0,5,0,0,0,0,240,183,0,9
101,R,114,H RES 129,27-Feb-2015,10:56 AM,On Agreeing to the Resolution,"Providing for consideration of the joint resolution (H.J.Res. 35) making further continuing appropriations for fiscal year 2015, and for other purposes",Passed,240,0,0,4,0,183,0,5,0,0,0,0,240,183,0,9
102,R,114,H R 240,27-Feb-2015,2:43 PM,On Motion to Request a Conference,"Making appropriations for the Department of Homeland Security for the fiscal year ending September 30, 2015, and for other purposes",Passed,228,12,0,4,0,179,0,9,0,0,0,0,228,191,0,13
103,R,114,JOURNAL,27-Feb-2015,2:56 PM,On Approving the Journal,None,Passed,136,100,1,7,90,86,0,12,0,0,0,0,226,186,1,19
104,R,114,H J RES 35,27-Feb-2015,5:13 PM,On Passage,"Making further continuing appropriations for fiscal year 2015, and for other purposes",Failed,191,52,0,2,12,172,0,4,0,0,0,0,203,224,0,6
105,R,114,H R 240,27-Feb-2015,5:23 PM,On Motion to Instruct Conferees,"Making appropriations for the Department of Homeland Security for the fiscal year ending September 30, 2015, and for other purposes",Failed,21,218,0,5,180,0,0,8,0,0,0,0,201,218,0,13
106,R,114,H R 33,27-Feb-2015,9:59 PM,On Motion to Suspend the Rules and Concur in the Senate Amendment,Protecting Volunteer Firefighters and Emergency Responders Act,Passed,183,55,0,6,174,5,0,9,0,0,0,0,357,60,0,15
107,R,114,H R 294,2-Mar-2015,6:56 PM,"On Motion to Suspend the Rules and Pass, as Amended",Long-Term Care Veterans Choice Act,Passed,232,0,0,12,173,0,0,15,0,0,0,0,405,0,0,27
108,R,114,H R 240,3-Mar-2015,2:05 PM,On Motion to Table the Senate Amendment,"Making appropriations for the Department of Homeland Security for the fiscal year ending September 30, 2015, and for other purposes",Failed,140,98,0,6,0,180,0,8,0,0,0,0,140,278,0,14
109,R,114,H R 240,3-Mar-2015,3:14 PM,On Motion to Recede and Concur in the Senate Amendment,"Making appropriations for the Department of Homeland Security for the fiscal year ending September 30, 2015, and for other purposes",Passed,75,167,0,3,182,0,0,6,0,0,0,0,257,167,0,9
110,R,114,H R 749,4-Mar-2015,2:40 PM,On Agreeing to the Amendment,None,Failed,147,89,0,8,0,183,0,5,0,0,0,0,147,272,0,13
111,R,114,H R 749,4-Mar-2015,2:57 PM,On Motion to Recommit with Instructions,To reauthorize Federal support for passenger rail programs and for other purposes,Failed,1,232,0,11,183,0,0,5,0,0,0,0,184,232,0,16
112,R,114,H R 749,4-Mar-2015,3:05 PM,On Passage,To reauthorize Federal support for passenger rail programs and for other purposes,Passed,132,101,0,11,184,0,0,4,0,0,0,0,316,101,0,15
113,R,114,H R 647,16-Mar-2015,6:55 PM,On Motion to Suspend the Rules and Pass,Access to Life-Saving Trauma Care for All Americans Act,Passed,221,10,0,13,168,0,0,20,0,0,0,0,389,10,0,33
114,R,114,H R 648,16-Mar-2015,7:03 PM,On Motion to Suspend the Rules and Pass,Trauma Systems and Regionalization of Emergency Care Reauthorization Act,Passed,214,15,0,15,168,0,0,20,0,0,0,0,382,15,0,35
115,R,114,H R 876,16-Mar-2015,7:10 PM,"On Motion to Suspend the Rules and Pass, as Amended",Notice of Observation Treatment and Implication for Care Eligibility Act,Passed,229,0,0,15,166,0,0,22,0,0,0,0,395,0,0,37
116,R,114,H RES 138,17-Mar-2015,1:48 PM,On Ordering the Previous Question,"Providing for consideration of the bill (H.R. 1029) EPA Science Advisory Board Reform Act, and providing for consideration of the bill (H.R. 1030) Secret Science Reform Act",Passed,232,0,0,12,0,181,0,7,0,0,0,0,232,181,0,19
117,R,114,H RES 138,17-Mar-2015,1:55 PM,On Agreeing to the Resolution,"Providing for consideration of the bill (H.R. 1029) EPA Science Advisory Board Reform Act, and providing for consideration of the bill (H.R. 1030) Secret Science Reform Act",Passed,233,0,0,11,3,180,0,5,0,0,0,0,236,180,0,16
118,R,114,H R 1191,17-Mar-2015,2:02 PM,"On Motion to Suspend the Rules and Pass, as Amended",Protecting Volunteer Firefighters and Emergency Responders Act,Passed,234,0,0,10,181,0,0,7,0,0,0,0,415,0,0,17
119,R,114,H R 1029,17-Mar-2015,3:38 PM,On Agreeing to the Amendment,None,Agreed to,232,4,0,8,10,171,0,7,0,0,0,0,242,175,0,15
120,R,114,H R 1029,17-Mar-2015,3:57 PM,On Motion to Recommit with Instructions,EPA Science Advisory Board Reform Act of 2015,Failed,0,235,0,9,179,2,0,7,0,0,0,0,179,237,0,16
121,R,114,H R 1029,17-Mar-2015,4:07 PM,On Passage,EPA Science Advisory Board Reform Act of 2015,Passed,234,1,0,9,2,180,0,6,0,0,0,0,236,181,0,15
122,R,114,H R 1030,18-Mar-2015,2:08 PM,On Agreeing to the Amendment,None,Failed,0,237,0,7,164,17,0,7,0,0,0,0,164,254,0,14
123,R,114,H R 1030,18-Mar-2015,2:12 PM,On Agreeing to the Amendment,None,Failed,3,231,0,10,181,0,0,7,0,0,0,0,184,231,0,17
124,R,114,H R 1030,18-Mar-2015,2:32 PM,On Motion to Recommit with Instructions,"To prohibit the Environmental Protection Agency from proposing, finalizing, or disseminating regulations or assessments based upon science that is not transparent or reproducible.",Failed,1,238,0,5,180,1,0,7,0,0,0,0,181,239,0,12
125,R,114,H R 1030,18-Mar-2015,2:39 PM,On Passage,"To prohibit the Environmental Protection Agency from proposing, finalizing, or disseminating regulations or assessments based upon science that is not transparent or reproducible.",Passed,237,1,0,6,4,174,0,10,0,0,0,0,241,175,0,16
126,R,114,H RES 152,19-Mar-2015,10:33 AM,On Ordering the Previous Question,"Providing for consideration of H.Res. 132, House Committee Funding Resolution, 114th Congress, and S.J. Res. 8, congressional disapproval under chapter 8 of title 5, United States Code, of the rule submitted by the National Labor Relations Board relating to representation case procedures.",Passed,233,0,0,11,0,181,0,7,0,0,0,0,233,181,0,18
127,R,114,H RES 152,19-Mar-2015,10:40 AM,On Agreeing to the Resolution,"Providing for consideration of H.Res. 132, House Committee Funding Resolution, 114th Congress, and S.J. Res. 8, congressional disapproval under chapter 8 of title 5, United States Code, of the rule submitted by the National Labor Relations Board relating to representation case procedures.",Passed,232,0,0,12,1,181,0,6,0,0,0,0,233,181,0,18
128,R,114,S J RES 8,19-Mar-2015,12:08 PM,On Passage,"Providing for congressional disapproval under chapter 8 of title 5, United States Code, of the rule submitted by the National Labor Relations Board relating to representation case procedures.",Passed,232,3,0,9,0,183,0,5,0,0,0,0,232,186,0,14
129,R,114,JOURNAL,19-Mar-2015,12:15 PM,On Approving the Journal,None,Passed,139,83,1,21,94,76,0,18,0,0,0,0,233,159,1,39
130,R,114,H R 360,23-Mar-2015,6:57 PM,"On Motion to Suspend the Rules and Pass, as Amended","To reauthorize the Native American Housing Assistance and Self-Determination Act of 1996, and for other purposes.",Passed,128,95,0,21,169,3,0,16,0,0,0,0,297,98,0,37
131,R,114,H RES 162,23-Mar-2015,7:08 PM,On Motion to Suspend the Rules and Agree,Calling on the President to provide Ukraine with military assistance to defend its sovereignty and territorial integrity.,Passed,214,10,0,20,134,38,0,16,0,0,0,0,348,48,0,36
132,R,114,H RES 163,24-Mar-2015,2:02 PM,On Ordering the Previous Question,Providing for consideration of the concurrent resolution (H. Con. Res. 27) establishing the budget for the United States Government for fiscal year 2016 and setting forth appropriate budgetary levels for fiscal years 2017 through 2025.,Passed,238,0,0,6,0,180,0,8,0,0,0,0,238,180,0,14
133,R,114,H RES 163,24-Mar-2015,2:10 PM,On Agreeing to the Resolution,Providing for consideration of the concurrent resolution (H. Con. Res. 27) establishing the budget for the United States Government for fiscal year 2016 and setting forth appropriate budgetary levels for fiscal years 2017 through 2025.,Passed,237,1,1,5,0,179,0,9,0,0,0,0,237,180,1,14
134,R,114,H R 216,24-Mar-2015,2:17 PM,"On Motion to Suspend the Rules and Pass, as Amended",Department of Veterans Affairs Budget Planning Reform Act of 2015,Passed,239,0,0,5,181,0,0,7,0,0,0,0,420,0,0,12
135,R,114,JOURNAL,24-Mar-2015,2:24 PM,On Approving the Journal,None,Passed,147,89,1,7,107,67,1,13,0,0,0,0,254,156,2,20
136,R,114,H CON RES 27,25-Mar-2015,4:24 PM,On Agreeing to the Amendment,None,Failed,0,244,0,0,96,86,0,6,0,0,0,0,96,330,0,6
137,R,114,H CON RES 27,25-Mar-2015,4:34 PM,On Agreeing to the Amendment,None,Failed,0,244,0,0,120,62,0,6,0,0,0,0,120,306,0,6
138,R,114,H CON RES 27,25-Mar-2015,4:41 PM,On Agreeing to the Amendment,None,Failed,132,112,0,0,0,182,0,6,0,0,0,0,132,294,0,6
139,R,114,H CON RES 27,25-Mar-2015,4:52 PM,On Agreeing to the Amendment,None,Failed,0,242,0,2,160,22,0,6,0,0,0,0,160,264,0,8
140,R,114,H CON RES 27,25-Mar-2015,6:16 PM,On Agreeing to the Amendment,None,Failed,105,139,0,0,0,180,0,8,0,0,0,0,105,319,0,8
141,R,114,H CON RES 27,25-Mar-2015,6:25 PM,On Agreeing to the Amendment,None,Agreed to,219,26,0,0,0,182,0,6,0,0,0,0,219,208,0,6
142,R,114,H CON RES 27,25-Mar-2015,6:54 PM,"On Agreeing to the Resolution, as Amended",Establishing the budget for the United States Government for fiscal year 2016 and setting forth appropriate budgetary levels for fiscal years 2017 through 2025,Passed,228,17,0,0,0,182,0,6,0,0,0,0,228,199,0,6
143,R,114,H RES 173,26-Mar-2015,10:11 AM,On Agreeing to the Resolution,"Providing for consideration of H. R. 2, Medicare Access and CHIP Reauthorization Act of 2015",Passed,230,5,5,4,172,7,0,9,0,0,0,0,402,12,5,13
144,R,114,H R 2,26-Mar-2015,12:07 PM,On Passage,Medicare Access and CHIP Reauthorization Act of 2015,Passed,212,33,0,0,180,4,0,4,0,0,0,0,392,37,0,4
145,R,114,H R 1259,13-Apr-2015,7:00 PM,On Motion to Suspend the Rules and Pass,Helping Expand Lending Practices in Rural Communities Act,Passed,230,0,0,13,171,1,0,16,0,0,0,0,401,1,0,29
146,R,114,H R 1265,13-Apr-2015,7:07 PM,On Motion to Suspend the Rules and Pass,Bureau Advisory Commission Transparancy Act,Passed,230,0,0,13,171,2,0,15,0,0,0,0,401,2,0,28
147,R,114,H R 1480,13-Apr-2015,7:15 PM,On Motion to Suspend the Rules and Pass,SAFE Act Confidentiality and Privilege Enhancement Act,Passed,230,0,0,13,171,0,0,17,0,0,0,0,401,0,0,30
148,R,114,H RES 189,14-Apr-2015,1:33 PM,On Ordering the Previous Question,"Providing for consideration of H.R. 650, Preserving Access to Manufactured Housing Act of 2015; providing for consideration of H.R. 685, Mortgage Choice Act of 2015; and providing for adoption of S. Con. Res. 11, Congressional budget for the United States Government, FY 2016",Passed,239,1,0,3,0,182,0,6,0,0,0,0,239,183,0,9
149,R,114,H RES 189,14-Apr-2015,1:53 PM,On Agreeing to the Resolution,"Providing for consideration of H.R. 650, Preserving Access to Manufactured Housing Act of 2015; providing for consideration of H.R. 685, Mortgage Choice Act of 2015; and providing for adoption of S. Con. Res. 11, Congressional budget for the United States Government, FY 2016",Passed,237,2,0,4,0,183,0,5,0,0,0,0,237,185,0,9
150,R,114,H R 650,14-Apr-2015,5:48 PM,On Motion to Recommit with Instructions,Preserving Access to Manufactured Housing Act,Failed,1,239,0,3,183,0,0,5,0,0,0,0,184,239,0,8
151,R,114,H R 650,14-Apr-2015,5:55 PM,On Passage,Preserving Access to Manufactured Housing Act,Passed,241,1,0,1,22,161,0,5,0,0,0,0,263,162,0,6
152,R,114,H R 685,14-Apr-2015,6:03 PM,On Passage,Mortgage Choice Act of 2015,Passed,241,1,0,1,45,139,0,4,0,0,0,0,286,140,0,5
153,R,114,S CON RES 11,14-Apr-2015,6:12 PM,On Motion to Instruct Conferees,Setting forth the congressional budget for the United States Government for fiscal year 2016 and setting forth the appropriate budgetary levels for fiscal years 2017 through 2015,Failed,3,238,0,2,184,1,0,3,0,0,0,0,187,239,0,5
154,R,114,H RES 200,15-Apr-2015,5:00 PM,On Ordering the Previous Question,"Providing for consideration of H.R. 622, State and Local Sales Tax Deduction Fairness Act of 2015; providing for consideration of H.R. 1105, Death Tax Repeal Act of 2015, and providing for consideration of H.R. 1195, Bureau of Consumer Financial Protection Advisory Boards Act of 2015",Passed,240,0,0,3,0,183,0,5,0,0,0,0,240,183,0,8
155,R,114,H RES 200,15-Apr-2015,5:06 PM,On Agreeing to the Resolution,"Providing for consideration of H.R. 622, State and Local Sales Tax Deduction Fairness Act of 2015; providing for consideration of H.R. 1105, Death Tax Repeal Act of 2015, and providing for consideration of H.R. 1195, Bureau of Consumer Financial Protection Advisory Boards Act of 2015",Passed,240,0,0,3,2,182,0,4,0,0,0,0,242,182,0,7
156,R,114,H R 1562,15-Apr-2015,5:16 PM,On Motion to Suspend the Rules and Pass,Contracting and Tax Accountability Act of 2015,Passed,241,0,0,2,183,0,0,5,0,0,0,0,424,0,0,7
157,R,114,H R 1563,15-Apr-2015,5:23 PM,"On Motion to Suspend the Rules and Pass, as Amended",Federal Employee Tax Accountability Act of 2015,Failed,239,3,0,1,27,157,0,4,0,0,0,0,266,160,0,5
158,R,114,H R 622,16-Apr-2015,11:45 AM,On Motion to Recommit with Instructions,State and Local Sales Tax Deduction Fairness Act,Failed,1,237,0,5,178,6,0,4,0,0,0,0,179,243,0,9
159,R,114,H R 622,16-Apr-2015,11:54 AM,On Passage,State and Local Sales Tax Deduction Fairness Act,Passed,238,1,0,4,34,151,0,3,0,0,0,0,272,152,0,7
160,R,114,H R 1105,16-Apr-2015,12:01 PM,On Motion to Recommit with Instructions,Death Tax Repeal Act,Failed,1,232,0,10,185,0,0,3,0,0,0,0,186,232,0,13
161,R,114,H R 1105,16-Apr-2015,12:10 PM,On Passage,Death Tax Repeal Act,Passed,233,3,0,7,7,176,0,5,0,0,0,0,240,179,0,12
162,R,114,H CON RES 25,21-Apr-2015,6:55 PM,On Motion to Suspend the Rules and Agree,Authorizing the use of the Capitol Grounds for the National Peace Officers Memorial Service and the National Honor Guard and Pipe Band Exhibition,Passed,231,0,0,12,179,0,0,9,0,0,0,0,410,0,0,21
163,R,114,H RES 212,22-Apr-2015,1:49 PM,On Ordering the Previous Question,"Providing for consideration of H.R. 1560, the Protecting Cyber Networks Act and H.R. 1731, the National Cybersecurity Protection Advancement Act of 2015",Passed,237,0,0,6,0,179,0,9,0,0,0,0,237,179,0,15
164,R,114,H RES 212,22-Apr-2015,1:56 PM,On Agreeing to the Resolution,"Providing for consideration of H.R. 1560, the Protecting Cyber Networks Act and H.R. 1731, the National Cybersecurity Protection Advancement Act of 2015",Passed,234,4,0,5,4,178,0,6,0,0,0,0,238,182,0,11
165,R,114,H R 1195,22-Apr-2015,2:05 PM,On Agreeing to the Amendment,None,Agreed to,64,172,0,7,180,1,0,7,0,0,0,0,244,173,0,14
166,R,114,H R 1195,22-Apr-2015,2:24 PM,On Motion to Recommit with Instructions,Bureau of Consumer Financial Protection Advisory Boards Act,Failed,2,234,0,7,182,0,0,6,0,0,0,0,184,234,0,13
167,R,114,H R 1195,22-Apr-2015,2:32 PM,On Passage,Bureau of Consumer Financial Protection Advisory Boards Act,Passed,231,5,0,7,4,178,0,6,0,0,0,0,235,183,0,13
168,R,114,H R 1560,22-Apr-2015,4:20 PM,On Agreeing to the Amendment,None,Agreed to,137,102,0,4,176,8,0,4,0,0,0,0,313,110,0,8
169,R,114,H R 1560,22-Apr-2015,4:35 PM,On Motion to Recommit with Instructions,Protecting Cyber Networks Act,Failed,0,238,0,5,183,1,0,4,0,0,0,0,183,239,0,9
170,R,114,H R 1560,22-Apr-2015,4:42 PM,On Passage,Protecting Cyber Networks Act,Passed,202,37,0,4,105,79,0,4,0,0,0,0,307,116,0,8
171,R,114,H R 1731,23-Apr-2015,11:30 AM,On Agreeing to the Amendment,None,Agreed to,231,8,0,4,174,0,0,14,0,0,0,0,405,8,0,18
172,R,114,H R 1731,23-Apr-2015,11:53 AM,On Motion to Recommit with Instructions,National Cybersecurity Protection Advancement Act of 2015,Failed,1,238,0,4,179,0,0,9,0,0,0,0,180,238,0,13
173,R,114,H R 1731,23-Apr-2015,12:03 PM,On Passage,National Cybersecurity Protection Advancement Act of 2015,Passed,220,19,0,4,135,44,0,9,0,0,0,0,355,63,0,13
174,R,114,H R 373,28-Apr-2015,6:58 PM,"On Motion to Suspend the Rules and Pass, as Amended",Good Samaritan Search and Recovery Act,Passed,239,0,0,4,174,0,0,14,0,0,0,0,413,0,0,18
175,R,114,H R 1324,28-Apr-2015,7:07 PM,On Motion to Suspend the Rules and Pass,Arapaho National Forest Boundary Adjustment Act of 2015,Passed,209,30,0,4,172,0,0,16,0,0,0,0,381,30,0,20
176,R,114,H RES 223,29-Apr-2015,2:15 PM,On Agreeing to the Resolution,"Consideration of (H.R. 2028) making appropriations for energy and water development and related agencies for FY ending Sept. 30, 2016 and providing for consideration of (H.R. 2029) making appropriations for military construction, the Dept. of Veterans Affairs, and related agencies for FY ending Sept. 30, 2016",Passed,240,1,0,2,0,185,0,3,0,0,0,0,240,186,0,5
177,R,114,H R 651,29-Apr-2015,2:25 PM,On Motion to Suspend the Rules and Pass,Sister Ann Keefe Post Office,Passed,240,0,0,3,183,0,0,5,0,0,0,0,423,0,0,8
178,R,114,H R 2029,29-Apr-2015,3:45 PM,On Sustaining the Ruling of the Chair,"Making appropriations for military construction, the Department of Veterans Affairs, and related agencies for the fiscal year ending September 30, 2016, and for other purposes",Passed,237,1,0,5,0,179,0,9,0,0,0,0,237,180,0,14
179,R,114,H RES 231,30-Apr-2015,1:12 PM,On Consideration of the Resolution,Providing for consideration of the bill (H.R. 1732); providing for consideration of the conference report to accompany the concurrent resolution (S.Con.Res. 11); and providing for consideration of the joint resolution (H.J.Res. 43),Passed,238,0,0,5,2,174,0,12,0,0,0,0,240,174,0,17
180,R,114,H RES 231,30-Apr-2015,2:55 PM,On Ordering the Previous Question,Providing for consideration of the bill (H.R. 1732); providing for consideration of the conference report to accompany the concurrent resolution (S.Con.Res. 11); and providing for consideration of the joint resolution (H.J.Res. 43),Passed,241,0,0,2,0,181,0,7,0,0,0,0,241,181,0,9
181,R,114,H RES 231,30-Apr-2015,3:04 PM,On Agreeing to the Resolution,Providing for consideration of the bill (H.R. 1732); providing for consideration of the conference report to accompany the concurrent resolution (S.Con.Res. 11); and providing for consideration of the joint resolution (H.J.Res. 43),Passed,242,0,0,1,0,181,0,7,0,0,0,0,242,181,0,8
182,R,114,JOURNAL,30-Apr-2015,3:12 PM,On Approving the Journal,None,Passed,145,94,1,3,91,81,1,15,0,0,0,0,236,175,2,18
183,R,114,S CON RES 11,30-Apr-2015,6:15 PM,On Agreeing to the Conference Report,Setting forth the congressional budget for the United States Government for fiscal year 2016 and setting forth the appropriate budgetary levels for fiscal years 2017 through 2025,Passed,226,14,0,4,0,183,0,5,0,0,0,0,226,197,0,9
184,R,114,H R 2029,30-Apr-2015,6:22 PM,On Agreeing to the Amendment,None,Failed,27,210,1,5,164,19,0,5,0,0,0,0,191,229,1,10
185,R,114,H R 2029,30-Apr-2015,6:27 PM,On Agreeing to the Amendment,None,Failed,29,209,1,4,163,20,0,5,0,0,0,0,192,229,1,9
186,R,114,H R 2029,30-Apr-2015,6:31 PM,On Agreeing to the Amendment,None,Failed,29,210,1,3,161,21,0,6,0,0,0,0,190,231,1,9
187,R,114,H R 2029,30-Apr-2015,6:34 PM,On Agreeing to the Amendment,None,Failed,4,236,0,3,163,18,0,7,0,0,0,0,167,254,0,10
188,R,114,H R 2029,30-Apr-2015,6:39 PM,On Agreeing to the Amendment,None,Failed,35,205,0,3,175,8,0,5,0,0,0,0,210,213,0,8
189,R,114,H R 2029,30-Apr-2015,6:42 PM,On Agreeing to the Amendment,None,Failed,3,237,0,3,183,0,0,5,0,0,0,0,186,237,0,8
190,R,114,H R 2029,30-Apr-2015,6:46 PM,On Agreeing to the Amendment,None,Failed,190,49,0,4,0,183,0,5,0,0,0,0,190,232,0,9
191,R,114,H R 2029,30-Apr-2015,6:49 PM,On Agreeing to the Amendment,None,Failed,186,52,0,5,0,183,0,5,0,0,0,0,186,235,0,10
192,R,114,H R 2029,30-Apr-2015,7:08 PM,On Motion to Recommit with Instructions,"Making appropriations for military construction, the Department of Veterans Affairs, and related agencies for the fiscal year ending September 30, 2016, and for other purposes",Failed,0,236,0,7,181,0,0,7,0,0,0,0,181,236,0,14
193,R,114,H R 2029,30-Apr-2015,7:14 PM,On Passage,"Making appropriations for military construction, the Department of Veterans Affairs, and related agencies for the fiscal year ending September 30, 2016, and for other purposes",Passed,236,4,0,3,19,159,0,10,0,0,0,0,255,163,0,13
194,R,114,H J RES 43,30-Apr-2015,11:08 PM,On Passage,Disapproving the action of the District of Columbia Council in approving the Reproductive Health Non-Discrimination Amendment Act of 2014,Passed,225,13,0,5,3,179,0,6,0,0,0,0,228,192,0,11
195,R,114,H R 2028,30-Apr-2015,11:14 PM,On Agreeing to the Amendment,None,Failed,126,113,0,4,0,182,0,6,0,0,0,0,126,295,0,10
196,R,114,H R 2028,30-Apr-2015,11:17 PM,On Agreeing to the Amendment,None,Failed,11,228,0,4,161,21,0,6,0,0,0,0,172,249,0,10
197,R,114,H R 2028,30-Apr-2015,11:20 PM,On Agreeing to the Amendment,None,Failed,175,64,0,4,2,180,0,6,0,0,0,0,177,244,0,10
198,R,114,H R 2028,30-Apr-2015,11:24 PM,On Agreeing to the Amendment,None,Failed,9,230,0,4,164,18,0,6,0,0,0,0,173,248,0,10
199,R,114,H R 2028,30-Apr-2015,11:27 PM,On Agreeing to the Amendment,None,Failed,139,100,0,4,0,182,0,6,0,0,0,0,139,282,0,10
200,R,114,H R 2028,30-Apr-2015,11:30 PM,On Agreeing to the Amendment,None,Failed,110,129,0,4,0,182,0,6,0,0,0,0,110,311,0,10
201,R,114,H R 2028,30-Apr-2015,11:32 PM,On Agreeing to the Amendment,None,Failed,42,197,0,4,133,49,0,6,0,0,0,0,175,246,0,10
202,R,114,H R 2028,30-Apr-2015,11:35 PM,On Agreeing to the Amendment,None,Failed,26,213,0,4,176,6,0,6,0,0,0,0,202,219,0,10
203,R,114,H R 2028,30-Apr-2015,11:39 PM,On Agreeing to the Amendment,None,Failed,15,224,0,4,149,33,0,6,0,0,0,0,164,257,0,10
204,R,114,H R 2028,30-Apr-2015,11:42 PM,On Agreeing to the Amendment,None,Failed,13,226,0,4,136,46,0,6,0,0,0,0,149,272,0,10
205,R,114,H R 2028,30-Apr-2015,11:45 PM,On Agreeing to the Amendment,None,Failed,143,96,0,4,0,182,0,6,0,0,0,0,143,278,0,10
206,R,114,H R 2028,30-Apr-2015,11:47 PM,On Agreeing to the Amendment,None,Failed,171,68,0,4,0,182,0,6,0,0,0,0,171,250,0,10
207,R,114,H R 2028,30-Apr-2015,11:50 PM,On Agreeing to the Amendment,None,Agreed to,231,8,0,4,1,181,0,6,0,0,0,0,232,189,0,10
208,R,114,H R 2028,1-May-2015,9:57 AM,On Agreeing to the Amendment,None,Agreed to,230,3,0,10,2,169,0,17,0,0,0,0,232,172,0,27
209,R,114,H R 2028,1-May-2015,10:02 AM,On Agreeing to the Amendment,None,Agreed to,223,10,0,10,1,174,0,13,0,0,0,0,224,184,0,23
210,R,114,H R 2028,1-May-2015,10:06 AM,On Agreeing to the Amendment,None,Failed,156,77,0,10,3,171,0,14,0,0,0,0,159,248,0,24
211,R,114,H R 2028,1-May-2015,10:10 AM,On Agreeing to the Amendment,None,Agreed to,226,9,0,8,2,174,0,12,0,0,0,0,228,183,0,20
212,R,114,H R 2028,1-May-2015,10:15 AM,On Agreeing to the Amendment,None,Agreed to,229,5,0,9,10,169,0,9,0,0,0,0,239,174,0,18
213,R,114,H R 2028,1-May-2015,10:18 AM,On Agreeing to the Amendment,None,Agreed to,225,10,0,8,3,173,0,12,0,0,0,0,228,183,0,20
214,R,114,H R 2028,1-May-2015,10:39 AM,On Motion to Recommit with Instructions,"Making appropriations for energy and water development and related agencies for the fiscal year ending September 30, 2016, and for other purposes",Failed,0,235,0,8,180,0,0,8,0,0,0,0,180,235,0,16
215,R,114,H R 2028,1-May-2015,10:44 AM,On Passage,"Making appropriations for energy and water development and related agencies for the fiscal year ending September 30, 2016, and for other purposes",Passed,230,7,0,6,10,170,0,8,0,0,0,0,240,177,0,14
216,R,114,H R 606,12-May-2015,6:57 PM,On Motion to Suspend the Rules and Pass,Don’t Tax Our Fallen Public Safety Heroes Act,Passed,235,0,0,8,178,0,0,10,0,0,0,0,413,0,0,18
217,R,114,H R 1732,12-May-2015,7:10 PM,On Agreeing to the Amendment,None,Failed,0,237,0,7,167,11,0,10,0,0,0,0,167,248,0,17
218,R,114,H R 1732,12-May-2015,7:26 PM,On Motion to Recommit with Instructions,Regulatory Integrity Protection Act,Failed,0,237,0,7,175,4,0,9,0,0,0,0,175,241,0,16
219,R,114,H R 1732,12-May-2015,7:32 PM,On Passage,Regulatory Integrity Protection Act,Passed,237,0,0,7,24,155,0,9,0,0,0,0,261,155,0,16
220,R,114,H R 2146,12-May-2015,7:41 PM,"On Motion to Suspend the Rules and Pass, as Amended",Defending Public Safety Employees’ Retirement Act,Passed,230,5,0,9,177,0,0,11,0,0,0,0,407,5,0,20
221,R,114,H RES 255,13-May-2015,2:16 PM,On Agreeing to the Resolution,"Providing for consideration of the bill (H.R. 1735), to authorize FY 2016 appropriations for the Department of Defense; providing for consideration of the bill (H.R. 36), the Pain-Capable Unborn Child Protection Act; and providing for consideration of the bill (H.R. 2048), the USA FREEDOM Act of 2015.",Passed,240,2,0,2,0,184,0,4,0,0,0,0,240,186,0,6
222,R,114,H R 36,13-May-2015,5:21 PM,On Motion to Recommit with Instructions,Pain-Capable Unborn Child Protection Act,Failed,0,243,0,1,181,3,0,4,0,0,0,0,181,246,0,5
223,R,114,H R 36,13-May-2015,5:32 PM,On Passage,Pain-Capable Unborn Child Protection Act,Passed,238,4,1,1,4,180,0,4,0,0,0,0,242,184,1,5
224,R,114,H R 2048,13-May-2015,5:46 PM,On Passage,Uniting and Strengthening America by Fulfilling Rights and Ensuring Effective Discipline Over Monitoring Act of 2015 or the USA FREEDOM Act,Passed,196,47,0,1,142,41,0,5,0,0,0,0,338,88,0,6
225,R,114,H RES 260,14-May-2015,4:00 PM,On Agreeing to the Resolution,"Providing for further consideration of H.R. 1735, National Defense Authorization Act for Fiscal Year 2016",Passed,241,1,0,2,2,180,0,6,0,0,0,0,243,181,0,8
226,R,114,H R 1191,14-May-2015,4:11 PM,On Motion to Suspend the Rules and Concur in the Senate Amendments,Protecting Volunteer Firefighters and Emergency Responders Act,Passed,223,19,0,2,177,6,0,5,0,0,0,0,400,25,0,7
227,R,114,H R 2297,14-May-2015,4:17 PM,On Motion to Suspend the Rules and Pass,Hezbollah International Financing Prevention Act of 2015,Passed,240,0,0,4,183,0,0,5,0,0,0,0,423,0,0,9
228,R,114,H R 1735,14-May-2015,6:59 PM,On Agreeing to the Amendment,None,Failed,4,236,0,4,56,127,0,5,0,0,0,0,60,363,0,9
229,R,114,H R 1735,14-May-2015,7:03 PM,On Agreeing to the Amendment,None,Agreed to,221,20,0,3,0,182,0,6,0,0,0,0,221,202,0,9
230,R,114,H R 1735,14-May-2015,7:07 PM,On Agreeing to the Amendment,None,Agreed to,234,7,0,3,9,173,0,6,0,0,0,0,243,180,0,9
231,R,114,H R 1735,14-May-2015,7:12 PM,On Agreeing to the Amendment,None,Failed,5,236,0,3,169,13,0,6,0,0,0,0,174,249,0,9
232,R,114,H R 1735,14-May-2015,7:17 PM,On Agreeing to the Amendment,None,Agreed to,235,4,0,5,18,162,0,8,0,0,0,0,253,166,0,13
233,R,114,H R 1735,15-May-2015,10:19 AM,On Agreeing to the Amendment,None,Agreed to,236,0,0,8,177,1,2,8,0,0,0,0,413,1,2,16
234,R,114,H R 1735,15-May-2015,10:23 AM,On Agreeing to the Amendment,None,Agreed to,231,4,0,9,4,178,0,6,0,0,0,0,235,182,0,15
235,R,114,H R 1735,15-May-2015,10:27 AM,On Agreeing to the Amendment,None,Failed,4,231,0,9,39,144,0,5,0,0,0,0,43,375,0,14
236,R,114,H R 1735,15-May-2015,10:30 AM,On Agreeing to the Amendment,None,Agreed to,225,10,0,9,4,180,0,4,0,0,0,0,229,190,0,13
237,R,114,H R 1735,15-May-2015,10:34 AM,On Agreeing to the Amendment,None,Failed,3,233,0,8,175,9,0,4,0,0,0,0,178,242,0,12
238,R,114,H R 1735,15-May-2015,10:54 AM,On Motion to Recommit with Instructions,"To authorize appropriations for fiscal year 2016 for military activites of the Department of Defense and for military construction, to prescribe military personnel strengths for such fiscal year, and for other purposes",Failed,1,234,0,9,183,0,0,5,0,0,0,0,184,234,0,14
239,R,114,H R 1735,15-May-2015,11:01 AM,On Passage,"To authorize appropriations for fiscal year 2016 for military activites of the Department of Defense and for military construction, to prescribe military personnel strengths for such fiscal year, and for other purposes",Passed,228,8,0,8,41,143,0,4,0,0,0,0,269,151,0,12
240,R,114,H R 91,18-May-2015,6:57 PM,"On Motion to Suspend the Rules and Pass, as Amended",Veteran’s I.D. Card Act,Passed,234,0,0,10,168,0,0,20,0,0,0,0,402,0,0,30
241,R,114,H R 1313,18-May-2015,7:07 PM,On Motion to Suspend the Rules and Pass,Service Disabled Veteran Owned Small Business Relief Act,Passed,233,0,0,11,170,0,0,18,0,0,0,0,403,0,0,29
242,R,114,H R 1382,18-May-2015,7:14 PM,"On Motion to Suspend the Rules and Pass, as Amended",Boosting Rates of American Veteran Employment Act (BRAVE Act),Passed,234,0,0,10,170,0,0,18,0,0,0,0,404,0,0,28
243,R,114,H RES 271,19-May-2015,1:59 PM,On Agreeing to the Resolution,"Providing for consideration of the bill (H.R. 1806) America COMPETES Reauthorization Act; providing for consideration of the bill (H.R. 2250) Making appropriations for the Legislative Branch for the FY ending Sept. 30, 2016; and providing for consideration of the bill (H.R. 2353) Highway and Transportation Funding Act",Passed,241,0,0,3,1,179,0,8,0,0,0,0,242,179,0,11
244,R,114,S 178,19-May-2015,2:07 PM,On Motion to Suspend the Rules and Pass,Justice for Victims of Trafficking Act of 2015,Passed,241,1,0,2,179,2,0,7,0,0,0,0,420,3,0,9
245,R,114,H R 2250,19-May-2015,5:00 PM,On Agreeing to the Amendment,None,Agreed to,219,23,0,2,5,176,0,7,0,0,0,0,224,199,0,9
246,R,114,H R 2250,19-May-2015,5:07 PM,On Agreeing to the Amendment,None,Failed,169,72,0,3,3,178,0,7,0,0,0,0,172,250,0,10
247,R,114,H R 2250,19-May-2015,5:16 PM,On Passage,"Making appropriations for the Legislative Branch for the fiscal year ending September 30, 2016, and for other purposes",Passed,237,5,0,2,120,62,0,6,0,0,0,0,357,67,0,8
248,R,114,H R 2353,19-May-2015,5:23 PM,On Motion to Recommit with Instructions,Highway and Transportation Funding Act of 2015,Failed,0,241,0,3,182,0,0,6,0,0,0,0,182,241,0,9
249,R,114,H R 2353,19-May-2015,5:31 PM,On Passage,Highway and Transportation Funding Act of 2015,Passed,228,12,1,3,159,23,0,6,0,0,0,0,387,35,1,9
250,R,114,H RES 273,20-May-2015,1:49 PM,On Ordering the Previous Question,"Providing for consideration of H.R. 2262, to facilitate a pro-growth environment for the developing commercial space industry; H.R. 880, American Research and Competitiveness Act of 2015; motions to suspend the rules; and proceedings of the House from May 22, 2015 to May 29, 2015",Passed,241,0,0,3,0,183,0,5,0,0,0,0,241,183,0,8
251,R,114,H RES 273,20-May-2015,2:02 PM,On Agreeing to the Resolution,"Providing for consideration of H.R. 2262, to facilitate a pro-growth environment for the developing commercial space industry; H.R. 880, American Research and Competitiveness Act of 2015; motions to suspend the rules; and proceedings of the House from May 22, 2015 to May 29, 2015",Passed,238,4,0,2,2,181,0,5,0,0,0,0,240,185,0,7
252,R,114,H R 1806,20-May-2015,6:27 PM,On Agreeing to the Amendment,None,Failed,4,234,0,6,173,9,0,6,0,0,0,0,177,243,0,12
253,R,114,H R 1806,20-May-2015,6:31 PM,On Agreeing to the Amendment,None,Agreed to,234,3,0,7,0,180,0,8,0,0,0,0,234,183,0,15
254,R,114,H R 1806,20-May-2015,6:35 PM,On Agreeing to the Amendment,None,Failed,5,235,0,4,182,1,0,5,0,0,0,0,187,236,0,9
255,R,114,H R 1806,20-May-2015,6:40 PM,On Agreeing to the Amendment,None,Failed,25,215,0,4,183,0,0,5,0,0,0,0,208,215,0,9
256,R,114,H R 1806,20-May-2015,6:44 PM,On Agreeing to the Amendment,None,Failed,7,232,0,5,183,0,0,5,0,0,0,0,190,232,0,10
257,R,114,H R 1806,20-May-2015,6:48 PM,On Agreeing to the Amendment,None,Failed,0,239,0,5,179,0,0,9,0,0,0,0,179,239,0,14
258,R,114,H R 1806,20-May-2015,6:58 PM,On Passage,America COMPETES Reauthorization Act of 2015,Passed,217,23,0,4,0,182,0,6,0,0,0,0,217,205,0,10
259,R,114,H R 880,20-May-2015,7:09 PM,On Motion to Recommit with Instructions,American Research and Competitiveness Act of 2015,Failed,0,240,0,4,181,0,0,7,0,0,0,0,181,240,0,11
260,R,114,H R 880,20-May-2015,7:16 PM,On Passage,American Research and Competitiveness Act of 2015,Passed,237,1,0,6,37,144,0,7,0,0,0,0,274,145,0,13
261,R,114,H R 2262,21-May-2015,12:33 PM,On Agreeing to the Amendment,None,Failed,3,233,0,8,170,3,0,15,0,0,0,0,173,236,0,23
262,R,114,H R 2262,21-May-2015,12:43 PM,On Passage,"To facilitate a pre-growth environment for the developing commercial space industry by encouraging private sector investment and creating more stable and predictable regulatory conditions, and for other purposes",Passed,236,3,0,5,48,130,0,10,0,0,0,0,284,133,0,15
263,R,114,H RES 274,21-May-2015,12:52 PM,On Agreeing to the Resolution,"Providing for consideration of the bill (H.R. 1335) to amend the Magnuson-Stevens Fishery Conservation and Management Act to provide flexibility for fishery managers and stability for fishermen, and for other purposes",Passed,236,1,0,7,1,173,0,14,0,0,0,0,237,174,0,21
264,R,114,H R 1335,1-Jun-2015,7:02 PM,On Agreeing to the Amendment,None,Failed,0,222,0,22,155,1,0,32,0,0,0,0,155,223,0,54
265,R,114,H R 1335,1-Jun-2015,7:12 PM,On Agreeing to the Amendment,None,Failed,0,222,0,22,149,5,0,34,0,0,0,0,149,227,0,56
266,R,114,H R 1335,1-Jun-2015,7:31 PM,On Motion to Recommit with Instructions,"To amend the Magnuson-Stevens Fishery Conservation and Management Act to provide flexibility for fishery managers and stability for fisherman, and for other purposes.",Failed,0,223,0,21,155,0,0,33,0,0,0,0,155,223,0,54
267,R,114,H R 1335,1-Jun-2015,7:41 PM,On Passage,"To amend the Magnuson-Stevens Fishery Conservation and Management Act to provide flexibility for fishery managers and stability for fisherman, and for other purposes.",Passed,220,3,0,21,5,149,0,34,0,0,0,0,225,152,0,55
268,R,114,H RES 287,2-Jun-2015,1:53 PM,On Agreeing to the Resolution,"Providing for consideration of the bill (H.R. 2577) making appropriations for the Dept. of Transportation, and Housing and Urban Development for FY ending Sept. 30, 2016 and providing for consideration of the bill (H.R. 2578) making appropriations for the Dept. Commerce and Justice, Science for FY ending Sept. 30, 2016",Passed,239,0,0,5,3,180,0,5,0,0,0,0,242,180,0,10
269,R,114,JOURNAL,2-Jun-2015,2:01 PM,On Approving the Journal,None,Passed,140,94,1,9,100,76,1,11,0,0,0,0,240,170,2,20
270,R,114,H R 2578,2-Jun-2015,6:38 PM,On Agreeing to the Amendment,None,Failed,154,86,0,4,0,177,0,11,0,0,0,0,154,263,0,15
271,R,114,H R 2578,2-Jun-2015,6:46 PM,On Agreeing to the Amendment,None,Failed,32,211,0,1,181,3,0,4,0,0,0,0,213,214,0,5
272,R,114,H R 2578,2-Jun-2015,6:52 PM,On Agreeing to the Amendment,None,Agreed to,233,10,0,1,184,0,0,4,0,0,0,0,417,10,0,5
273,R,114,H R 2578,2-Jun-2015,6:56 PM,On Agreeing to the Amendment,None,Agreed to,228,14,0,2,0,184,0,4,0,0,0,0,228,198,0,6
274,R,114,H RES 288,3-Jun-2015,1:40 PM,On Agreeing to the Resolution,Providing for consideration of the bill (H.R. 2289) Commodity End-User Relief Act,Passed,241,0,0,3,2,182,0,4,0,0,0,0,243,182,0,7
275,R,114,H R 2578,3-Jun-2015,1:47 PM,On Agreeing to the Amendment,None,Failed,160,82,0,2,3,181,0,4,0,0,0,0,163,263,0,6
276,R,114,H R 2578,3-Jun-2015,1:51 PM,On Agreeing to the Amendment,None,Failed,5,238,0,1,165,18,0,5,0,0,0,0,170,256,0,6
277,R,114,H R 2578,3-Jun-2015,1:55 PM,On Agreeing to the Amendment,None,Failed,2,241,0,1,151,32,0,5,0,0,0,0,153,273,0,6
278,R,114,H R 2578,3-Jun-2015,1:58 PM,On Agreeing to the Amendment,None,Failed,166,77,0,1,2,180,0,6,0,0,0,0,168,257,0,7
279,R,114,H R 2578,3-Jun-2015,2:03 PM,On Agreeing to the Amendment,None,Failed,97,145,0,2,98,87,0,3,0,0,0,0,195,232,0,5
280,R,114,H R 2578,3-Jun-2015,2:07 PM,On Agreeing to the Amendment,None,Agreed to,101,142,0,1,181,4,0,3,0,0,0,0,282,146,0,4
281,R,114,H R 2578,3-Jun-2015,2:13 PM,On Agreeing to the Amendment,None,Failed,1,242,0,1,183,2,0,3,0,0,0,0,184,244,0,4
282,R,114,H R 2578,3-Jun-2015,2:16 PM,On Agreeing to the Amendment,None,Failed,19,224,0,1,8,175,1,4,0,0,0,0,27,399,1,5
283,R,114,H R 2578,3-Jun-2015,2:20 PM,On Agreeing to the Amendment,None,Agreed to,67,176,0,1,175,10,0,3,0,0,0,0,242,186,0,4
284,R,114,H R 2578,3-Jun-2015,2:24 PM,On Agreeing to the Amendment,None,Agreed to,71,171,0,2,174,11,0,3,0,0,0,0,245,182,0,5
285,R,114,H R 2578,3-Jun-2015,2:29 PM,On Agreeing to the Amendment,None,Failed,45,198,0,1,161,24,0,3,0,0,0,0,206,222,0,4
286,R,114,H R 2578,3-Jun-2015,2:33 PM,On Agreeing to the Amendment,None,Agreed to,118,125,0,1,179,5,0,4,0,0,0,0,297,130,0,5
287,R,114,H R 2578,3-Jun-2015,2:38 PM,On Agreeing to the Amendment,None,Agreed to,232,11,0,1,0,185,0,3,0,0,0,0,232,196,0,4
288,R,114,H R 2578,3-Jun-2015,6:12 PM,On Agreeing to the Amendment,None,Agreed to,117,122,0,5,172,10,0,6,0,0,0,0,289,132,0,11
289,R,114,H R 2578,3-Jun-2015,6:18 PM,On Agreeing to the Amendment,None,Agreed to,238,2,0,4,12,169,0,7,0,0,0,0,250,171,0,11
290,R,114,H R 2578,3-Jun-2015,6:25 PM,On Agreeing to the Amendment,None,Agreed to,236,5,0,3,147,38,0,3,0,0,0,0,383,43,0,6
291,R,114,H R 2578,3-Jun-2015,6:28 PM,On Agreeing to the Amendment,None,Agreed to,234,7,0,3,2,183,0,3,0,0,0,0,236,190,0,6
292,R,114,H R 2578,3-Jun-2015,6:31 PM,On Agreeing to the Amendment,None,Failed,134,107,0,3,0,183,0,5,0,0,0,0,134,290,0,8
293,R,114,H R 2578,3-Jun-2015,6:35 PM,On Agreeing to the Amendment,None,Agreed to,222,19,0,3,0,185,0,3,0,0,0,0,222,204,0,6
294,R,114,H R 2578,3-Jun-2015,6:38 PM,On Agreeing to the Amendment,None,Agreed to,227,14,0,3,0,184,0,4,0,0,0,0,227,198,0,7
295,R,114,H R 2578,3-Jun-2015,6:41 PM,On Agreeing to the Amendment,None,Agreed to,239,2,0,3,6,179,0,3,0,0,0,0,245,181,0,6
296,R,114,H R 2578,3-Jun-2015,6:59 PM,On Motion to Recommit with Instructions,"Making appropriations for Commerce and Justice, Science, and Related Agencies, FY 2016",Failed,0,240,0,4,184,0,0,4,0,0,0,0,184,240,0,8
297,R,114,H R 2578,3-Jun-2015,7:05 PM,On Passage,"Making appropriations for Commerce and Justice, Science, and Related Agencies, FY 2016",Passed,230,10,0,4,12,173,0,3,0,0,0,0,242,183,0,7
298,R,114,H R 2577,4-Jun-2015,11:51 AM,On Agreeing to the Amendment,None,Failed,158,82,0,4,8,173,0,7,0,0,0,0,166,255,0,11
299,R,114,H R 2577,4-Jun-2015,11:57 AM,On Agreeing to the Amendment,None,Agreed to,228,12,0,4,7,177,0,4,0,0,0,0,235,189,0,8
300,R,114,,4-Jun-2015,,,This vote was vacated by unanimous consent on 4-Jun-2015.,,0,0,0,0,0,0,0,0,0,0,0,0,0,0,0,0
301,R,114,H R 2577,4-Jun-2015,12:03 PM,On Agreeing to the Amendment,None,Failed,10,229,0,5,166,18,0,4,0,0,0,0,176,247,0,9
302,R,114,H R 2577,4-Jun-2015,12:07 PM,On Agreeing to the Amendment,None,Failed,149,92,0,3,11,174,0,3,0,0,0,0,160,266,0,6
303,R,114,H R 2577,4-Jun-2015,12:11 PM,On Agreeing to the Amendment,None,Failed,142,99,0,3,1,184,0,3,0,0,0,0,143,283,0,6
304,R,114,H R 2577,4-Jun-2015,12:14 PM,On Agreeing to the Amendment,None,Failed,139,101,0,4,0,185,0,3,0,0,0,0,139,286,0,7
305,R,114,H R 2577,4-Jun-2015,12:19 PM,On Agreeing to the Amendment,None,Failed,24,216,0,4,178,6,0,4,0,0,0,0,202,222,0,8
306,R,114,H R 2577,4-Jun-2015,12:25 PM,On Agreeing to the Amendment,None,Failed,18,221,0,5,158,26,1,3,0,0,0,0,176,247,1,8
307,R,114,H R 2577,4-Jun-2015,12:28 PM,On Agreeing to the Amendment,None,Agreed to,224,16,0,4,0,182,0,6,0,0,0,0,224,198,0,10
308,R,114,H R 2577,4-Jun-2015,12:37 PM,On Agreeing to the Amendment,None,Failed,20,215,0,9,164,15,0,9,0,0,0,0,184,230,0,18
309,R,114,H R 2289,9-Jun-2015,6:57 PM,On Passage,Commodity End-User Relief Act,Passed,237,1,0,6,9,170,0,9,0,0,0,0,246,171,0,15
310,R,114,H R 2577,9-Jun-2015,7:11 PM,On Agreeing to the Amendment,None,Failed,161,79,0,5,2,180,0,6,0,0,0,0,163,259,0,11
311,R,114,H R 2577,9-Jun-2015,7:16 PM,On Agreeing to the Amendment,None,Agreed to,229,11,0,5,0,182,0,6,0,0,0,0,229,193,0,11
312,R,114,H R 2577,9-Jun-2015,7:19 PM,On Agreeing to the Amendment,None,Failed,136,103,0,6,0,183,0,5,0,0,0,0,136,286,0,11
313,R,114,H R 2577,9-Jun-2015,7:23 PM,On Agreeing to the Amendment,None,Failed,162,78,0,5,1,182,0,5,0,0,0,0,163,260,0,10
314,R,114,H R 2577,9-Jun-2015,7:26 PM,On Agreeing to the Amendment,None,Failed,205,35,0,5,0,183,0,5,0,0,0,0,205,218,0,10
315,R,114,H R 2577,9-Jun-2015,7:30 PM,On Agreeing to the Amendment,None,Failed,186,54,0,5,0,183,0,5,0,0,0,0,186,237,0,10
316,R,114,H R 2577,9-Jun-2015,7:34 PM,On Agreeing to the Amendment,None,Failed,14,226,0,5,143,40,0,5,0,0,0,0,157,266,0,10
317,R,114,H R 2577,9-Jun-2015,7:39 PM,On Agreeing to the Amendment,None,Failed,147,93,0,5,1,182,0,5,0,0,0,0,148,275,0,10
318,R,114,H R 2577,9-Jun-2015,7:44 PM,On Agreeing to the Amendment,None,Failed,134,105,0,6,0,182,0,6,0,0,0,0,134,287,0,12
319,R,114,H R 2577,9-Jun-2015,10:37 PM,On Agreeing to the Amendment,None,Agreed to,240,3,0,2,4,178,0,6,0,0,0,0,244,181,0,8
320,R,114,H R 2577,9-Jun-2015,10:42 PM,On Agreeing to the Amendment,None,Agreed to,241,3,0,1,5,177,0,6,0,0,0,0,246,180,0,7
321,R,114,H R 2577,9-Jun-2015,10:47 PM,On Agreeing to the Amendment,None,Agreed to,206,38,0,1,34,148,0,6,0,0,0,0,240,186,0,7
322,R,114,H R 2577,9-Jun-2015,10:51 PM,On Agreeing to the Amendment,None,Failed,184,60,0,1,15,167,0,6,0,0,0,0,199,227,0,7
323,R,114,H R 2577,9-Jun-2015,10:54 PM,On Agreeing to the Amendment,None,Agreed to,231,13,0,1,0,182,0,6,0,0,0,0,231,195,0,7
324,R,114,H R 2577,9-Jun-2015,10:57 PM,On Agreeing to the Amendment,None,Failed,1,242,0,2,181,1,0,6,0,0,0,0,182,243,0,8
325,R,114,H R 2577,9-Jun-2015,11:01 PM,On Agreeing to the Amendment,None,Failed,212,32,0,1,0,182,0,6,0,0,0,0,212,214,0,7
326,R,114,H R 2577,9-Jun-2015,11:05 PM,On Agreeing to the Amendment,None,Agreed to,60,184,0,1,181,0,1,6,0,0,0,0,241,184,1,7
327,R,114,H R 2577,9-Jun-2015,11:09 PM,On Agreeing to the Amendment,None,Agreed to,225,19,0,1,72,110,0,6,0,0,0,0,297,129,0,7
328,R,114,H R 2577,9-Jun-2015,11:29 PM,On Motion to Recommit with Instructions,"Making appropriations for the Departments of Transportation, and Housing and Urban Development, and related agencies for the fiscal year ending September 30, 2016, and for other purposes",Failed,0,244,0,1,181,0,0,7,0,0,0,0,181,244,0,8
329,R,114,H R 2577,9-Jun-2015,11:35 PM,On Passage,"Making appropriations for the Departments of Transportation, and Housing and Urban Development, and related agencies for the fiscal year ending September 30, 2016, and for other purposes",Passed,213,31,0,1,3,179,0,6,0,0,0,0,216,210,0,7
330,R,114,H RES 303,10-Jun-2015,2:11 PM,On Agreeing to the Resolution,"Providing for consideration of the bill (H.R. 2685) making appropriations for the Department of Defense for the fiscal year ending Sept. 30, 2016, and providing for consideration of the bill (H.R. 2393) Country of Origin Labeling Amendments Act",Passed,242,2,0,1,2,185,0,1,0,0,0,0,244,187,0,2
331,R,114,H RES 295,10-Jun-2015,2:21 PM,On Motion to Suspend the Rules and Agree,"Suporting local law enforcement agencies in their continued work to serve our communities, and supporting their use of body worn cameras to promote transparency to protect both citizens and officers alike.",Passed,234,6,1,4,187,0,0,1,0,0,0,0,421,6,1,5
332,R,114,JOURNAL,10-Jun-2015,2:33 PM,On Approving the Journal,None,Passed,147,94,1,3,109,74,1,4,0,0,0,0,256,168,2,7
333,R,114,H R 2393,10-Jun-2015,10:05 PM,On Passage,Country of Origin Labeling Amendments Act of 2015,Passed,234,10,0,1,66,121,0,1,0,0,0,0,300,131,0,2
334,R,114,H R 2685,10-Jun-2015,10:11 PM,On Agreeing to the Amendment,None,Failed,19,225,0,1,176,12,0,0,0,0,0,0,195,237,0,1
335,R,114,H R 2685,10-Jun-2015,10:16 PM,On Agreeing to the Amendment,None,Agreed to,88,156,0,1,164,23,0,1,0,0,0,0,252,179,0,2
336,R,114,H R 2685,10-Jun-2015,10:19 PM,On Agreeing to the Amendment,None,Failed,4,240,0,1,170,17,0,1,0,0,0,0,174,257,0,2
337,R,114,H R 2685,10-Jun-2015,10:22 PM,On Agreeing to the Amendment,None,Failed,4,240,0,1,169,19,0,0,0,0,0,0,173,259,0,1
338,R,114,H R 2685,10-Jun-2015,10:25 PM,On Agreeing to the Amendment,None,Failed,6,238,0,1,175,13,0,0,0,0,0,0,181,251,0,1
339,R,114,H R 2685,10-Jun-2015,10:30 PM,On Agreeing to the Amendment,None,Agreed to,181,63,0,1,140,48,0,0,0,0,0,0,321,111,0,1
340,R,114,H R 2685,10-Jun-2015,10:33 PM,On Agreeing to the Amendment,None,Failed,95,149,0,1,22,166,0,0,0,0,0,0,117,315,0,1
341,R,114,H R 2685,10-Jun-2015,10:37 PM,On Agreeing to the Amendment,None,Agreed to,144,100,0,1,89,99,0,0,0,0,0,0,233,199,0,1
342,R,114,H R 2685,10-Jun-2015,10:39 PM,On Agreeing to the Amendment,None,Failed,14,229,0,2,42,146,0,0,0,0,0,0,56,375,0,2
343,R,114,H R 2685,10-Jun-2015,10:42 PM,On Agreeing to the Amendment,None,Failed,56,186,0,3,51,137,0,0,0,0,0,0,107,323,0,3
344,R,114,H R 2685,10-Jun-2015,10:45 PM,On Agreeing to the Amendment,None,Failed,98,146,0,1,16,172,0,0,0,0,0,0,114,318,0,1
345,R,114,H R 1295,11-Jun-2015,1:55 PM,Concurring in Senate amendments with amendment,Trade Preferences Extension Act of 2015,Passed,212,31,0,2,185,1,0,2,0,0,0,0,397,32,0,4
346,R,114,H R 2685,11-Jun-2015,2:00 PM,On Agreeing to the Amendment,None,Failed,33,208,0,4,163,23,0,2,0,0,0,0,196,231,0,6
347,R,114,H R 2685,11-Jun-2015,2:03 PM,On Agreeing to the Amendment,None,Failed,13,229,0,3,144,41,0,3,0,0,0,0,157,270,0,6
348,R,114,H R 2685,11-Jun-2015,2:07 PM,On Agreeing to the Amendment,None,Failed,14,228,0,3,151,36,0,1,0,0,0,0,165,264,0,4
349,R,114,H R 2685,11-Jun-2015,2:10 PM,On Agreeing to the Amendment,None,Failed,7,235,0,3,166,21,0,1,0,0,0,0,173,256,0,4
350,R,114,H R 2685,11-Jun-2015,2:14 PM,On Agreeing to the Amendment,None,Failed,51,192,0,2,30,155,0,3,0,0,0,0,81,347,0,5
351,R,114,H R 2685,11-Jun-2015,2:17 PM,On Agreeing to the Amendment,None,Failed,18,225,0,2,147,40,0,1,0,0,0,0,165,265,0,3
352,R,114,H R 2685,11-Jun-2015,2:21 PM,On Agreeing to the Amendment,None,Failed,47,195,0,3,4,183,0,1,0,0,0,0,51,378,0,4
353,R,114,H R 2685,11-Jun-2015,2:24 PM,On Agreeing to the Amendment,None,Failed,17,225,0,3,149,37,0,2,0,0,0,0,166,262,0,5
354,R,114,H R 2685,11-Jun-2015,2:27 PM,On Agreeing to the Amendment,None,Failed,1,241,0,3,186,1,0,1,0,0,0,0,187,242,0,4
355,R,114,H R 2685,11-Jun-2015,2:31 PM,On Agreeing to the Amendment,None,Failed,132,111,0,2,1,186,0,1,0,0,0,0,133,297,0,3
356,R,114,H R 2685,11-Jun-2015,2:35 PM,On Agreeing to the Amendment,None,Agreed to,109,134,0,2,146,40,0,2,0,0,0,0,255,174,0,4
357,R,114,H R 2685,11-Jun-2015,2:51 PM,On Motion to Recommit with Instructions,"Making appropriations for the Department of Defense for the fiscal year ending September 30, 2016, and for other purposes.",Failed,0,240,0,5,186,0,0,2,0,0,0,0,186,240,0,7
358,R,114,H R 2685,11-Jun-2015,2:59 PM,On Passage,"Making appropriations for the Department of Defense for the fiscal year ending September 30, 2016, and for other purposes.",Passed,235,5,0,5,43,144,0,1,0,0,0,0,278,149,0,6
359,R,114,H RES 305,11-Jun-2015,4:50 PM,On Agreeing to the Resolution,"Providing for consideration of the Senate Amendment to H.R. 1314, to provide for a right to an administrative appeal relating to adverse determinations of tax exempt status of certain organizations; and for consideration of the Senate Amendments to H.R. 644, Fighting Hunger Incentive Act",Passed,209,34,0,3,8,178,0,2,0,0,0,0,217,212,0,5
360,R,114,JOURNAL,11-Jun-2015,4:57 PM,On Approving the Journal,None,Passed,143,92,1,9,96,80,0,12,0,0,0,0,239,172,1,21
361,R,114,H R 1314,12-Jun-2015,1:47 PM,Concurring in portion of Senate Amdt comprising title II (except section 212),Trade Act of 2015,Failed,86,158,0,2,40,144,0,4,0,0,0,0,126,302,0,6
362,R,114,H R 1314,12-Jun-2015,1:54 PM,Concurring in portion of senate amendment preceding title II,Trade Act of 2015,Passed,191,54,0,1,28,157,0,3,0,0,0,0,219,211,0,4
363,R,114,H R 644,12-Jun-2015,2:14 PM,Concurring in Senate amendments with amendment,Trade Facilitation and Trade Enforcement Act of 2015,Passed,228,17,0,1,12,173,0,3,0,0,0,0,240,190,0,4
364,R,114,H RES 233,15-Jun-2015,6:58 PM,On Motion to Suspend the Rules and Agree,"Expressing the sense of the House of Representatives that Iran should immediately release the three United States citizens that it holds, as well as provide all known information on any United States citizens that have disappeared within its borders",Passed,225,0,0,20,166,0,0,22,0,0,0,0,391,0,0,42
365,R,114,H R 2559,15-Jun-2015,7:06 PM,On Motion to Suspend the Rules and Pass,To designate the “PFC Milton A. Lee Medal of Honor Memorial Highway” in the State of Texas,Passed,224,0,0,21,165,0,0,23,0,0,0,0,389,0,0,44
366,R,114,H RES 315,16-Jun-2015,1:56 PM,On Agreeing to the Resolution,"Providing for consideration of the bill (H.R. 2596) to authorize appropriations for fiscal year 2016 for intelligence and intelligence-related activities of the United States Government, the Community Management Account, and the Central Intelligence Agency Retirement and Disability System, and for other purposes",Passed,233,6,0,6,3,183,0,2,0,0,0,0,236,189,0,8
367,R,114,H R 2596,16-Jun-2015,5:30 PM,On Agreeing to the Amendment,None,Failed,5,235,0,5,171,11,0,6,0,0,0,0,176,246,0,11
368,R,114,H R 2596,16-Jun-2015,5:46 PM,On Motion to Recommit with Instructions,Intelligence Authorization Act,Failed,0,240,0,5,183,0,0,5,0,0,0,0,183,240,0,10
369,R,114,H R 2596,16-Jun-2015,5:53 PM,On Passage,Intelligence Authorization Act,Passed,216,25,0,4,31,153,0,4,0,0,0,0,247,178,0,8
370,R,114,H CON RES 55,17-Jun-2015,4:06 PM,On Agreeing to the Resolution,"Directing the President, pursuant to section 5(c) of the War Powers Resolution, to remove United States Armed Forces deployed to Iraq or Syria on or after August 7, 2014, other than Armed Forces required to protect United States diplomatic facilities and personnel, from Iraq and Syria",Failed,19,222,1,3,120,66,0,2,0,0,0,0,139,288,1,5
371,R,114,H RES 319,17-Jun-2015,4:14 PM,On Ordering the Previous Question,"Providing for consideration of H.R. 160, the Protect Medical Innovation Act of 2015; and providing for consideration of H.R. 1190, the Protecting Seniors’ Access to Medicare Act of 2015",Passed,241,0,0,4,0,186,0,2,0,0,0,0,241,186,0,6
372,R,114,H RES 319,17-Jun-2015,4:20 PM,On Agreeing to the Resolution,"Providing for consideration of H.R. 160, the Protect Medical Innovation Act of 2015; and providing for consideration of H.R. 1190, the Protecting Seniors’ Access to Medicare Act of 2015",Passed,241,0,0,4,0,186,0,2,0,0,0,0,241,186,0,6
373,R,114,H RES 321,18-Jun-2015,11:08 AM,On Agreeing to the Resolution,"Providing for consideration of the Senate Amendment to the bill (H.R. 2146) to amend the Internal Revenue Code of 1986 to allow Federal law enforcement officers, firefighters, and air traffic controllers to make penalty-free withdrawals from governmental plans after age 50, and for other purposes",Passed,237,1,0,7,7,180,0,1,0,0,0,0,244,181,0,8
374,R,114,H R 2146,18-Jun-2015,12:25 PM,On Motion to Concur in Senate Amendment With Amendment,"To amend the Internal Revenue Code of 1986 to allow Federal law enforcement officers, firefighters, and air traffic controllers to make penalty-free withdrawals from governmental plans after age 50, and for other purposes",Passed,190,50,0,6,28,158,0,2,0,0,0,0,218,208,0,8
375,R,114,H R 160,18-Jun-2015,12:33 PM,On Passage,Protect Medical Innovation Act,Passed,234,0,0,11,46,140,0,2,0,0,0,0,280,140,0,13
376,R,114,H R 1190,23-Jun-2015,6:56 PM,On Passage,Protecting Seniors’ Access to Medicare Act of 2015,Passed,233,0,0,12,11,154,0,23,0,0,0,0,244,154,0,35
377,R,114,H R 805,23-Jun-2015,7:09 PM,"On Motion to Suspend the Rules and Pass, as Amended",Domain Openness Through Continued Oversight Matters Act of 2015 (DOTCOM Act of 2015).,Passed,211,24,0,10,167,1,0,20,0,0,0,0,378,25,0,30
378,R,114,H R 2576,23-Jun-2015,7:16 PM,"On Motion to Suspend the Rules and Pass, as Amended",TSCA Modernization Act of 2015,Passed,231,1,0,13,167,0,0,21,0,0,0,0,398,1,0,34
379,R,114,H RES 333,24-Jun-2015,2:08 PM,On Ordering the Previous Question,"Providing for consideration of the bill (H.R. 2822) making appropriations for the Department of the Interior, environment, and related agencies for the fiscal year ending September 30, 2016; providing for consideration of the bill (H.R. 2042) Ratepayer Protection Act",Passed,243,0,0,2,0,181,0,7,0,0,0,0,243,181,0,9
380,R,114,H RES 333,24-Jun-2015,2:22 PM,On Agreeing to the Resolution,"Providing for consideration of the bill (H.R. 2822) making appropriations for the Department of the Interior, environment, and related agencies for the fiscal year ending September 30, 2016; providing for consideration of the bill (H.R. 2042) Ratepayer Protection Act",Passed,243,0,0,2,1,178,0,9,0,0,0,0,244,178,0,11
381,R,114,H R 2042,24-Jun-2015,4:49 PM,On Agreeing to the Amendment,None,Failed,2,241,0,2,179,4,0,5,0,0,0,0,181,245,0,7
382,R,114,H R 2042,24-Jun-2015,4:55 PM,On Agreeing to the Amendment,None,Failed,5,238,0,2,177,5,0,6,0,0,0,0,182,243,0,8
383,R,114,H R 2042,24-Jun-2015,5:01 PM,On Agreeing to the Amendment,None,Failed,0,243,0,2,177,7,0,4,0,0,0,0,177,250,0,6
384,R,114,H R 2042,24-Jun-2015,5:19 PM,On Passage,Ratepayer Protection Act of 2015,Passed,239,4,0,2,8,176,0,4,0,0,0,0,247,180,0,6
385,R,114,H RES 341,25-Jun-2015,10:38 AM,On Motion to Refer,Raising a question of the privileges of the House.,Passed,240,1,0,4,0,183,0,5,0,0,0,0,240,184,0,9
386,R,114,H RES 338,25-Jun-2015,10:46 AM,On Agreeing to the Resolution,"Providing for consideration of the Senate amendment to the House amendment to the Senate amendment to the bill (H.R. 1295) to extend the African Growth and Opportunity Act, the Generalized System of Preferences, the preferential duty treatment for Haiti, and for other purposes.",Passed,240,2,0,3,11,174,0,3,0,0,0,0,251,176,0,6
387,R,114,H R 1615,25-Jun-2015,10:57 AM,"On Motion to Suspend the Rules and Pass, as Amended",DHS FOIA Efficiency Act of 2015,Passed,242,0,0,3,181,0,0,7,0,0,0,0,423,0,0,10
388,R,114,H R 1295,25-Jun-2015,12:38 PM,On Motion to Concur in Senate Amendment to House Amendment to Senate Amendment,"To extend the African Growth and Opportunity Act, the Generalized System of Preferences, the preferential duty treatment program for Haiti, and for other purposes.",Passed,111,132,0,2,175,6,0,7,0,0,0,0,286,138,0,9
389,R,114,H R 2200,25-Jun-2015,12:46 PM,"On Motion to Suspend the Rules and Pass, as Amended",CBRN Intelligence and Information Sharing Act,Passed,239,1,0,5,181,1,0,6,0,0,0,0,420,2,0,11
390,R,114,H R 1735,7-Jul-2015,6:55 PM,Authorizing Conferees to Close Meetings,"To authorize appropriations for fiscal year 2016 for military activites of the Department of Defense and for military construction, to prescribe military personnel strengths for such fiscal year, and for other purposes",Passed,233,7,0,5,169,5,0,14,0,0,0,0,402,12,0,19
391,R,114,H R 91,7-Jul-2015,7:06 PM,On Motion to Suspend the Rules and Concur in the Senate Amendment,Veteran’s I.D. Card Act of 2015,Passed,238,0,0,7,173,0,0,15,0,0,0,0,411,0,0,22
392,R,114,H RES 347,8-Jul-2015,2:18 PM,On Agreeing to the Resolution,"Providing for further consideration of H.R. 5, the Student Success Act and H.R. 2647, the Resilient Federal Forests Act of 2015",Passed,242,0,0,3,0,185,0,3,0,0,0,0,242,185,0,6
393,R,114,H R 2822,8-Jul-2015,2:29 PM,On Agreeing to the Amendment,None,Failed,16,227,0,2,165,17,0,6,0,0,0,0,181,244,0,8
394,R,114,H R 2822,8-Jul-2015,2:33 PM,On Agreeing to the Amendment,None,Failed,6,236,0,3,178,7,0,3,0,0,0,0,184,243,0,6
395,R,114,H R 2822,8-Jul-2015,2:36 PM,On Agreeing to the Amendment,None,Failed,8,235,0,2,175,10,0,3,0,0,0,0,183,245,0,5
396,R,114,H R 2822,8-Jul-2015,2:39 PM,On Agreeing to the Amendment,None,Failed,10,233,0,2,178,6,0,4,0,0,0,0,188,239,0,6
397,R,114,H R 2822,8-Jul-2015,2:42 PM,On Agreeing to the Amendment,None,Failed,7,235,0,3,182,4,0,2,0,0,0,0,189,239,0,5
398,R,114,H R 2822,8-Jul-2015,2:46 PM,On Agreeing to the Amendment,None,Failed,5,238,0,2,186,0,0,2,0,0,0,0,191,238,0,4
399,R,114,H R 2822,8-Jul-2015,2:49 PM,On Agreeing to the Amendment,None,Failed,0,243,0,2,178,8,0,2,0,0,0,0,178,251,0,4
400,R,114,H R 2822,8-Jul-2015,2:53 PM,On Agreeing to the Amendment,None,Failed,5,238,0,2,181,5,0,2,0,0,0,0,186,243,0,4
401,R,114,H R 2822,8-Jul-2015,2:56 PM,On Agreeing to the Amendment,None,Failed,0,243,0,2,180,6,0,2,0,0,0,0,180,249,0,4
402,R,114,H R 2822,8-Jul-2015,2:59 PM,On Agreeing to the Amendment,None,Failed,1,242,0,2,178,8,0,2,0,0,0,0,179,250,0,4
403,R,114,H R 2822,8-Jul-2015,3:03 PM,On Agreeing to the Amendment,None,Failed,8,235,0,2,184,2,0,2,0,0,0,0,192,237,0,4
404,R,114,H R 2822,8-Jul-2015,3:06 PM,On Agreeing to the Amendment,None,Failed,9,234,0,2,177,9,0,2,0,0,0,0,186,243,0,4
405,R,114,H R 2822,8-Jul-2015,3:09 PM,On Agreeing to the Amendment,None,Failed,6,235,0,4,177,9,0,2,0,0,0,0,183,244,0,6
406,R,114,H R 2822,8-Jul-2015,3:12 PM,On Agreeing to the Amendment,None,Failed,8,233,0,4,181,4,0,3,0,0,0,0,189,237,0,7
407,R,114,H R 2822,8-Jul-2015,3:15 PM,On Agreeing to the Amendment,None,Failed,167,74,0,4,1,184,0,3,0,0,0,0,168,258,0,7
408,R,114,H R 2822,8-Jul-2015,3:18 PM,On Agreeing to the Amendment,None,Agreed to,230,13,0,2,1,185,0,2,0,0,0,0,231,198,0,4
409,R,114,H R 2822,8-Jul-2015,3:22 PM,On Agreeing to the Amendment,None,Agreed to,221,21,0,3,1,185,0,2,0,0,0,0,222,206,0,5
410,R,114,H R 5,8-Jul-2015,5:40 PM,On Agreeing to the Amendment,None,Agreed to,244,0,0,1,129,57,0,2,0,0,0,0,373,57,0,3
411,R,114,H R 5,8-Jul-2015,5:43 PM,On Agreeing to the Amendment,None,Agreed to,241,0,0,4,183,2,0,3,0,0,0,0,424,2,0,7
412,R,114,H R 5,8-Jul-2015,5:46 PM,On Agreeing to the Amendment,None,Failed,18,223,0,4,181,5,0,2,0,0,0,0,199,228,0,6
413,R,114,H R 5,8-Jul-2015,5:50 PM,On Agreeing to the Amendment,None,Failed,6,237,0,2,186,0,0,2,0,0,0,0,192,237,0,4
414,R,114,H R 5,8-Jul-2015,5:54 PM,On Agreeing to the Amendment,None,Failed,0,244,0,1,186,1,0,1,0,0,0,0,186,245,0,2
415,R,114,H R 5,8-Jul-2015,5:57 PM,On Agreeing to the Amendment,None,Failed,5,238,0,2,186,1,0,1,0,0,0,0,191,239,0,3
416,R,114,H R 5,8-Jul-2015,6:01 PM,On Agreeing to the Amendment,None,Agreed to,31,213,0,1,187,0,0,1,0,0,0,0,218,213,0,2
417,R,114,H R 5,8-Jul-2015,6:04 PM,On Agreeing to the Amendment,None,Failed,18,224,0,3,187,0,0,1,0,0,0,0,205,224,0,4
418,R,114,H R 5,8-Jul-2015,6:08 PM,On Agreeing to the Amendment,None,Failed,2,241,0,2,187,0,0,1,0,0,0,0,189,241,0,3
419,R,114,H R 5,8-Jul-2015,6:11 PM,On Agreeing to the Amendment,None,Failed,195,49,0,1,0,186,0,2,0,0,0,0,195,235,0,3
420,R,114,H R 5,8-Jul-2015,6:14 PM,On Agreeing to the Amendment,None,Agreed to,232,11,0,2,19,167,0,2,0,0,0,0,251,178,0,4
421,R,114,H R 5,8-Jul-2015,6:19 PM,On Agreeing to the Amendment,None,Failed,0,244,0,1,187,0,0,1,0,0,0,0,187,244,0,2
422,R,114,H R 5,8-Jul-2015,6:38 PM,On Motion to Recommit with Instructions,Student Success Act,Failed,0,244,0,1,185,0,0,3,0,0,0,0,185,244,0,4
423,R,114,H R 5,8-Jul-2015,6:48 PM,On Passage,Student Success Act,Passed,218,27,0,1,0,186,0,2,0,0,0,0,218,213,0,3
424,R,114,ADJOURN,9-Jul-2015,1:13 PM,On Motion to Adjourn,None,Failed,0,237,0,8,13,165,0,10,0,0,0,0,13,402,0,18
425,R,114,H RES 355,9-Jul-2015,1:56 PM,Ordering the Previous Question on the Motion to Refer,Raising a question of the privileges of the House,Passed,238,1,0,6,0,184,0,4,0,0,0,0,238,185,0,10
426,R,114,H RES 355,9-Jul-2015,2:04 PM,On Motion to Refer,Raising a question of the privileges of the House,Passed,238,1,0,6,0,175,0,13,0,0,0,0,238,176,0,19
427,R,114,H R 2647,9-Jul-2015,5:36 PM,On Agreeing to the Amendment,None,Failed,1,243,0,1,180,4,0,4,0,0,0,0,181,247,0,5
428,R,114,H R 2647,9-Jul-2015,5:45 PM,On Passage,Resilient Federal Forests Act of 2015,Passed,243,1,0,1,19,166,0,3,0,0,0,0,262,167,0,4
429,R,114,H RES 350,9-Jul-2015,5:53 PM,On Ordering the Previous Question,"Providing for consideration of H.R. 6, 21st Century Cures Act",Passed,242,0,0,3,0,185,0,3,0,0,0,0,242,185,0,6
430,R,114,H RES 350,9-Jul-2015,6:01 PM,On Agreeing to the Resolution,"Providing for consideration of H.R. 6, 21st Century Cures Act",Passed,242,0,0,3,2,183,0,3,0,0,0,0,244,183,0,6
431,R,114,H R 6,10-Jul-2015,11:07 AM,On Agreeing to the Amendment,None,Failed,141,100,0,4,0,181,0,7,0,0,0,0,141,281,0,11
432,R,114,H R 6,10-Jul-2015,11:15 AM,On Agreeing to the Amendment,None,Failed,0,240,0,5,176,5,0,7,0,0,0,0,176,245,0,12
433,R,114,H R 6,10-Jul-2015,11:26 AM,On Passage,21st Century Cures Act,Passed,170,70,0,5,174,7,0,7,0,0,0,0,344,77,0,12
434,R,114,H R 2499,13-Jul-2015,6:56 PM,"On Motion to Suspend the Rules and Pass, as Amended",Veterans Entrepeneurship Act of 2015,Passed,235,1,0,9,175,0,0,13,0,0,0,0,410,1,0,22
435,R,114,H R 251,14-Jul-2015,3:36 PM,On Motion to Suspend the Rules and Pass,Homes for Heroes Act of 2015,Passed,243,1,0,1,169,0,0,19,0,0,0,0,412,1,0,20
436,R,114,H R 2997,14-Jul-2015,3:45 PM,On Motion to Suspend the Rules and Pass,Private Investment in Housing Act of 2015,Passed,213,28,0,4,182,0,0,6,0,0,0,0,395,28,0,10
437,R,114,H R 1723,14-Jul-2015,3:53 PM,On Motion to Suspend the Rules and Pass,Small Company Simple Registration Act,Passed,244,0,0,1,182,0,0,6,0,0,0,0,426,0,0,7
438,R,114,H RES 362,15-Jul-2015,2:22 PM,On Ordering the Previous Question,"Providing for consideration of H.R. 2898, Western Water and American Food Security Act of 2015; and providing for consideration of H.R. 3038, Highway and Transportation Funding Act of 2015, Part II",Passed,243,0,0,2,2,182,0,4,0,0,0,0,245,182,0,6
439,R,114,H RES 362,15-Jul-2015,2:30 PM,On Agreeing to the Resolution,"Providing for consideration of H.R. 2898, Western Water and American Food Security Act of 2015; and providing for consideration of H.R. 3038, Highway and Transportation Funding Act of 2015, Part II",Passed,244,0,0,1,1,183,0,4,0,0,0,0,245,183,0,5
440,R,114,H R 3038,15-Jul-2015,4:13 PM,On Motion to Recommit with Instructions,"Highway Transportation Funding Act of 2015, Part II",Failed,1,243,0,1,184,1,0,3,0,0,0,0,185,244,0,4
441,R,114,H R 3038,15-Jul-2015,4:20 PM,On Passage,"Highway Transportation Funding Act of 2015, Part II",Passed,180,65,0,0,132,54,0,2,0,0,0,0,312,119,0,2
442,R,114,H R 2722,15-Jul-2015,4:28 PM,"On Motion to Suspend the Rules and Pass, as Amended",Breast Cancer Awareness Commemorative Coin Act,Passed,235,9,1,0,186,0,0,2,0,0,0,0,421,9,1,2
443,R,114,H R 2898,16-Jul-2015,12:06 PM,On Agreeing to the Amendment,None,Failed,2,236,0,7,180,0,0,8,0,0,0,0,182,236,0,15
444,R,114,H R 2898,16-Jul-2015,12:10 PM,On Agreeing to the Amendment,None,Agreed to,238,0,0,7,8,172,0,8,0,0,0,0,246,172,0,15
445,R,114,H R 2898,16-Jul-2015,12:14 PM,On Agreeing to the Amendment,None,Failed,1,238,0,6,178,4,0,6,0,0,0,0,179,242,0,12
446,R,114,H R 2898,16-Jul-2015,12:33 PM,On Motion to Recommit with Instructions,Western Water and American Food Security Act,Failed,0,239,0,6,183,0,0,5,0,0,0,0,183,239,0,11
447,R,114,H R 2898,16-Jul-2015,12:39 PM,On Passage,Western Water and American Food Security Act,Passed,240,1,0,4,5,175,0,8,0,0,0,0,245,176,0,12
448,R,114,H R 1557,21-Jul-2015,6:56 PM,On Motion to Suspend the Rules and Pass,Federal Employee Antidiscrimination Act,Passed,233,0,0,12,170,0,0,18,0,0,0,0,403,0,0,30
449,R,114,H R 2256,21-Jul-2015,7:10 PM,"On Motion to Suspend the Rules and Pass, as Amended",Veterans Information Modernization Act,Passed,236,0,0,9,172,0,0,16,0,0,0,0,408,0,0,25
450,R,114,H RES 369,22-Jul-2015,1:52 PM,On Ordering the Previous Question,"Providing for consideration of the bill (H.R. 1599) Safe and Accurate Food Labeling Act, and providing for consideration of the bill (H.R. 1734) Improving Coal Combustion Residuals Regulation Act",Passed,239,0,0,6,0,167,0,21,0,0,0,0,239,167,0,27
451,R,114,H RES 369,22-Jul-2015,2:01 PM,On Agreeing to the Resolution,"Providing for consideration of the bill (H.R. 1599) Safe and Accurate Food Labeling Act, and providing for consideration of the bill (H.R. 1734) Improving Coal Combustion Residuals Regulation Act",Passed,240,0,0,5,2,175,0,11,0,0,0,0,242,175,0,16
452,R,114,JOURNAL,22-Jul-2015,2:08 PM,On Approving the Journal,None,Passed,146,94,1,4,103,75,1,9,0,0,0,0,249,169,2,13
453,R,114,H R 1734,22-Jul-2015,6:10 PM,On Agreeing to the Amendment,None,Failed,0,240,0,5,177,4,0,7,0,0,0,0,177,244,0,12
454,R,114,H R 1734,22-Jul-2015,6:15 PM,On Agreeing to the Amendment,None,Failed,0,240,0,5,177,5,0,6,0,0,0,0,177,245,0,11
455,R,114,H R 1734,22-Jul-2015,6:20 PM,On Agreeing to the Amendment,None,Failed,13,228,0,4,179,3,0,6,0,0,0,0,192,231,0,10
456,R,114,H R 1734,22-Jul-2015,6:25 PM,On Agreeing to the Amendment,None,Failed,1,238,0,6,179,2,0,7,0,0,0,0,180,240,0,13
457,R,114,H R 1734,22-Jul-2015,6:42 PM,On Motion to Recommit with Instructions,Improving Coal Combustion Residuals Regulation Act of 2015,Failed,0,240,0,5,184,0,0,4,0,0,0,0,184,240,0,9
458,R,114,H R 1734,22-Jul-2015,6:49 PM,On Passage,Improving Coal Combustion Residuals Regulation Act of 2015,Passed,239,1,0,5,19,165,0,4,0,0,0,0,258,166,0,9
459,R,114,H R 1599,23-Jul-2015,1:32 PM,On Agreeing to the Amendment,None,Failed,1,242,0,2,122,61,0,5,0,0,0,0,123,303,0,7
460,R,114,H R 1599,23-Jul-2015,1:38 PM,On Agreeing to the Amendment,None,Failed,21,219,0,5,175,8,0,5,0,0,0,0,196,227,0,10
461,R,114,H R 1599,23-Jul-2015,1:42 PM,On Agreeing to the Amendment,None,Failed,10,232,0,3,153,30,0,5,0,0,0,0,163,262,0,8
462,R,114,H R 1599,23-Jul-2015,1:50 PM,On Passage,Safe and Accurate Food Labeling Act of 2015,Passed,230,12,0,3,45,138,0,5,0,0,0,0,275,150,0,8
463,R,114,H R 1599,23-Jul-2015,2:07 PM,On agreeing to the Polis of Colorado Amendment to the title,Safe and Accurate Food Labeling Act of 2015,Failed,1,241,0,3,86,96,0,6,0,0,0,0,87,337,0,9
464,R,114,H RES 370,23-Jul-2015,2:16 PM,On Agreeing to the Resolution,"Providing for consideration of H.R. 3009, Enforce the Law for Sanctuary Cities Act",Passed,243,0,0,2,0,174,0,14,0,0,0,0,243,174,0,16
465,R,114,H R 3009,23-Jul-2015,4:07 PM,On Motion to Recommit with Instructions,Enforce the Law for Sanctuary Cities Act,Failed,0,239,0,6,181,0,0,7,0,0,0,0,181,239,0,13
466,R,114,H R 3009,23-Jul-2015,4:19 PM,On Passage,Enforce the Law for Sanctuary Cities Act,Passed,235,5,0,5,6,174,0,8,0,0,0,0,241,179,0,13
467,R,114,S 1482,27-Jul-2015,6:57 PM,On Motion to Suspend the Rules and Pass,Need-Based Educational Aid Act of 2015,Passed,224,0,0,21,154,0,0,34,0,0,0,0,378,0,0,55
468,R,114,H R 1656,27-Jul-2015,7:09 PM,"On Motion to Suspend the Rules and Pass, as Amended",Secret Service Improvements Act of 2015,Passed,210,15,0,20,155,1,0,32,0,0,0,0,365,16,0,52
469,R,114,H R 2770,27-Jul-2015,7:15 PM,"On Motion to Suspend the Rules and Pass, as Amended",Keeping our Travelers Safe and Secure Act,Passed,224,0,0,21,156,0,0,32,0,0,0,0,380,0,0,53
470,R,114,H RES 380,28-Jul-2015,1:53 PM,On Ordering the Previous Question,"Providing for consideration of the bill H.R. 427, the Regulations from the Executive in Need of Scrutiny Act of 2015 (REINS Act), and providing for proceedings during the period from July 30, 2015, through September 7, 2015, and for other purposes.",Passed,240,0,0,5,0,167,0,21,0,0,0,0,240,167,0,26
471,R,114,H RES 380,28-Jul-2015,2:03 PM,On Agreeing to the Resolution,"Providing for consideration of the bill H.R. 427, the Regulations from the Executive in Need of Scrutiny Act of 2015 (REINS Act), and providing for proceedings during the period from July 30, 2015, through September 7, 2015, and for other purposes.",Passed,240,0,0,5,0,167,0,21,0,0,0,0,240,167,0,26
472,R,114,H R 675,28-Jul-2015,2:09 PM,"On Motion to Suspend the Rules and Pass, as Amended",Veterans’ Compensation Cost-of-Living Adjustment Act of 2015,Passed,242,0,0,3,167,0,0,21,0,0,0,0,409,0,0,24
473,R,114,H R 427,28-Jul-2015,5:27 PM,On Agreeing to the Amendment,None,Agreed to,242,0,0,3,8,159,0,21,0,0,0,0,250,159,0,24
474,R,114,H R 427,28-Jul-2015,5:36 PM,On Agreeing to the Amendment,None,Agreed to,240,1,0,4,2,166,0,20,0,0,0,0,242,167,0,24
475,R,114,H R 427,28-Jul-2015,5:40 PM,On Agreeing to the Amendment,None,Failed,0,241,0,4,163,5,0,20,0,0,0,0,163,246,0,24
476,R,114,H R 427,28-Jul-2015,5:44 PM,On Agreeing to the Amendment,None,Failed,0,242,0,3,166,2,0,20,0,0,0,0,166,244,0,23
477,R,114,H R 427,28-Jul-2015,5:48 PM,On Agreeing to the Amendment,None,Failed,0,240,0,5,166,2,0,20,0,0,0,0,166,242,0,25
478,R,114,H R 427,28-Jul-2015,5:52 PM,On Agreeing to the Amendment,None,Failed,0,242,0,3,167,1,0,20,0,0,0,0,167,243,0,23
479,R,114,H R 427,28-Jul-2015,5:55 PM,On Agreeing to the Amendment,None,Failed,2,239,0,4,165,2,0,21,0,0,0,0,167,241,0,25
480,R,114,H R 427,28-Jul-2015,5:59 PM,On Agreeing to the Amendment,None,Failed,1,238,0,6,166,1,0,21,0,0,0,0,167,239,0,27
481,R,114,H R 427,28-Jul-2015,6:17 PM,On Motion to Recommit with Instructions,Regulations from the Executive in Need of Scrutiny Act of 2015,Failed,1,241,0,3,166,0,0,22,0,0,0,0,167,241,0,25
482,R,114,H R 427,28-Jul-2015,6:24 PM,On Passage,Regulations from the Executive in Need of Scrutiny Act of 2015,Passed,241,0,0,4,2,165,0,21,0,0,0,0,243,165,0,25
483,R,114,H RES 388,29-Jul-2015,2:16 PM,On Ordering the Previous Question,"Providing for consideration of the bill (H.R. 1994), the VA Accountability Act of 2015, and providing for consideration of the bill (H.R. 3236), the Surface Transportation and Veterans Health Care Choice Improvement Act of 2015.",Passed,242,0,0,3,0,180,0,8,0,0,0,0,242,180,0,11
484,R,114,H RES 388,29-Jul-2015,2:27 PM,On Agreeing to the Resolution,"Providing for consideration of the bill (H.R. 1994), the VA Accountability Act of 2015, and providing for consideration of the bill (H.R. 3236), the Surface Transportation and Veterans Health Care Choice Improvement Act of 2015.",Passed,242,0,0,3,1,183,0,4,0,0,0,0,243,183,0,7
485,R,114,H R 1300,29-Jul-2015,2:35 PM,"On Motion to Suspend the Rules and Pass, as Amended",First Responder Anthrax Preparedness Act,Passed,241,0,0,4,183,0,0,5,0,0,0,0,424,0,0,9
486,R,114,H R 3236,29-Jul-2015,5:31 PM,On Passage,Surface Transportation and Veterans Health Care Choice Improvement Act of 2015,Passed,215,25,0,5,170,9,1,8,0,0,0,0,385,34,1,13
487,R,114,H R 1994,29-Jul-2015,5:37 PM,On Agreeing to the Amendment,None,Failed,8,231,0,6,183,2,0,3,0,0,0,0,191,233,0,9
488,R,114,H R 1994,29-Jul-2015,5:54 PM,On Motion to Recommit with Instructions,VA Accountability Act,Failed,0,241,0,4,184,0,0,4,0,0,0,0,184,241,0,8
489,R,114,H R 1994,29-Jul-2015,6:01 PM,On Passage,VA Accountability Act,Passed,240,1,0,4,16,169,0,3,0,0,0,0,256,170,0,7
490,R,114,S 1359,8-Sep-2015,6:57 PM,On Motion to Suspend the Rules and Pass,E-Warranty Act of 2015,Passed,224,2,0,19,164,0,0,24,0,0,0,0,388,2,0,43
491,R,114,H RES 412,10-Sep-2015,2:16 PM,On Agreeing to the Resolution,"Providing for consideration of H.Res. 411, finding that the President has not complied with section 2 of the Iran Nuclear Agreement Review Act of 2015; H.R. 3461, to approve the Joint Comprehensive Plan of Action; H.R. 3460, to suspend until January 21, 2017, the authority of the President to releive Iran sanctions",Passed,243,0,0,2,0,186,0,2,0,0,0,0,243,186,0,4
492,R,114,H RES 411,10-Sep-2015,5:22 PM,On Agreeing to the Resolution,Finding that the President has not complied with section 2 of the Iran Nuclear Agreement Review Act of 2015,Passed,245,0,0,0,0,186,0,2,0,0,0,0,245,186,0,2
493,R,114,H R 3461,11-Sep-2015,12:31 PM,On Passage,"To approve the Joint Comprehensive Plan of Action, signed at Vienna on July 14, 2015, relating to the nuclear program of Iran.",Failed,0,244,1,0,162,25,0,1,0,0,0,0,162,269,1,1
494,R,114,H R 3460,11-Sep-2015,12:45 PM,On Passage,"To suspend until January 21, 2017, the authority of the President to waive, suspend, reduce, provide relief from, or otherwise limit the application of sanctions pursuant to an agreement related to the nuclear program of Iran",Passed,245,0,0,0,2,186,0,0,0,0,0,0,247,186,0,0
495,R,114,H R 1214,16-Sep-2015,7:15 PM,"On Motion to Suspend the Rules and Pass, as Amended",National Forest Small Tracts Act Amendments Act of 2015,Passed,229,0,0,16,174,0,0,14,0,0,0,0,403,0,0,30
496,R,114,H R 1949,16-Sep-2015,7:22 PM,"On Motion to Suspend the Rules and Pass, as Amended",National Liberty Memorial Clarification Act of 2015,Passed,229,0,0,16,173,0,0,15,0,0,0,0,402,0,0,31
497,R,114,H RES 420,17-Sep-2015,2:58 PM,On Ordering the Previous Question,Providing for consideration of the bill (H.R. 348) RAPID Act; providing for consideration of the bill (H.R. 758) Lawsuit Abuse Reduction Act; and providing for consideration of motions to suspend the rules.,Passed,238,0,0,7,0,179,0,9,0,0,0,0,238,179,0,16
498,R,114,H RES 420,17-Sep-2015,3:17 PM,On Agreeing to the Amendment,None,Agreed to,237,4,0,5,0,183,0,5,0,0,0,0,237,187,0,10
499,R,114,H RES 420,17-Sep-2015,3:24 PM,"On Agreeing to the Resolution, As Amended",Providing for consideration of the bill (H.R. 348) RAPID Act; providing for consideration of the bill (H.R. 758) Lawsuit Abuse Reduction Act; and providing for consideration of motions to suspend the rules.,Passed,238,3,0,5,0,180,0,8,0,0,0,0,238,183,0,13
500,R,114,H R 758,17-Sep-2015,5:02 PM,On Motion to Recommit with Instructions,"To amend Rule 11 of the Federal Rules of Civil Procedure to improve attorney accountability, and for other purposes.",Failed,0,239,0,7,179,0,0,9,0,0,0,0,179,239,0,16
501,R,114,H R 758,17-Sep-2015,5:11 PM,On Passage,"To amend Rule 11 of the Federal Rules of Civil Procedure to improve attorney accountability, and for other purposes.",Passed,238,5,0,3,3,180,0,5,0,0,0,0,241,185,0,8
502,R,114,H RES 421,17-Sep-2015,5:19 PM,On Ordering the Previous Question,Providing for consideration of the bill (H.R. 3134) Defund Planned Parenthood Act and; providing for consideration of the bill (H.R.3504) Born-Alive Abortion Survivors Protection Act.,Passed,243,0,0,3,0,183,0,5,0,0,0,0,243,183,0,8
503,R,114,H RES 421,17-Sep-2015,5:28 PM,On Agreeing to the Resolution,Providing for consideration of the bill (H.R. 3134) Defund Planned Parenthood Act and; providing for consideration of the bill (H.R.3504) Born-Alive Abortion Survivors Protection Act.,Passed,243,0,0,3,3,179,0,6,0,0,0,0,246,179,0,9
504,R,114,H R 3134,18-Sep-2015,12:39 PM,On Motion to Recommit with Instructions,Defund Planned Parenthood Act of 2015,Failed,0,243,0,3,183,2,0,3,0,0,0,0,183,245,0,6
505,R,114,H R 3134,18-Sep-2015,12:47 PM,On Passage,Defund Planned Parenthood Act of 2015,Passed,239,3,1,3,2,184,0,2,0,0,0,0,241,187,1,5
506,R,114,H R 3504,18-Sep-2015,12:54 PM,On Passage,Born-Alive Abortion Survivors Protection Act,Passed,243,0,0,3,5,177,1,5,0,0,0,0,248,177,1,8
507,R,114,H R 322,24-Sep-2015,3:11 PM,On Motion to Suspend the Rules and Pass,“Sgt. Zachary M. Fisher Post Office”,Passed,226,0,0,20,179,0,0,9,0,0,0,0,405,0,0,29
508,R,114,H R 348,25-Sep-2015,11:06 AM,On Agreeing to the Amendment,None,Failed,4,225,0,17,166,3,0,19,0,0,0,0,170,228,0,36
509,R,114,H R 348,25-Sep-2015,11:14 AM,On Agreeing to the Amendment,None,Agreed to,142,88,0,16,178,0,0,10,0,0,0,0,320,88,0,26
510,R,114,H R 348,25-Sep-2015,11:19 AM,On Agreeing to the Amendment,None,Failed,5,226,0,15,174,4,0,10,0,0,0,0,179,230,0,25
511,R,114,H R 348,25-Sep-2015,11:24 AM,On Agreeing to the Amendment,None,Failed,0,232,0,14,173,5,0,10,0,0,0,0,173,237,0,24
512,R,114,H R 348,25-Sep-2015,11:28 AM,On Agreeing to the Amendment,None,Failed,8,223,0,15,179,0,0,9,0,0,0,0,187,223,0,24
513,R,114,H R 348,25-Sep-2015,11:31 AM,On Agreeing to the Amendment,None,Failed,5,226,0,15,174,3,0,11,0,0,0,0,179,229,0,26
514,R,114,H R 348,25-Sep-2015,11:35 AM,On Agreeing to the Amendment,None,Agreed to,220,11,0,15,3,175,0,10,0,0,0,0,223,186,0,25
515,R,114,H R 348,25-Sep-2015,11:39 AM,On Agreeing to the Amendment,None,Failed,1,230,0,15,175,2,0,11,0,0,0,0,176,232,0,26
516,R,114,H R 348,25-Sep-2015,11:42 AM,On Agreeing to the Amendment,None,Failed,3,228,0,15,173,4,0,11,0,0,0,0,176,232,0,26
517,R,114,H R 348,25-Sep-2015,12:00 PM,On Motion to Recommit with Instructions,Responsibly And Professionally Invigorating Development Act of 2015 (RAPID Act),Failed,0,228,0,18,175,1,0,12,0,0,0,0,175,229,0,30
518,R,114,H R 348,25-Sep-2015,12:06 PM,On Passage,Responsibly And Professionally Invigorating Development Act of 2015 (RAPID Act),Passed,226,0,0,20,7,170,0,11,0,0,0,0,233,170,0,31
519,R,114,H R 2835,28-Sep-2015,6:55 PM,"On Motion to Suspend the Rules and Pass, as Amended",Border Jobs for Veterans Act of 2015,Passed,239,0,0,7,171,0,0,17,0,0,0,0,410,0,0,24
520,R,114,H R 2786,28-Sep-2015,7:04 PM,On Motion to Suspend the Rules and Pass,Cross-Border Rail Security Act of 2015,Passed,240,0,0,6,172,0,0,16,0,0,0,0,412,0,0,22
521,R,114,H RES 444,29-Sep-2015,1:49 PM,On Ordering the Previous Question,"Providing for consideration of H.R. 3495, the Women’s Public Health and Safety Act and waiving a requirement of clause 6(a) of rule XIII with respect to consideration of certain resolutions reported from the Committee on Rules",Passed,243,0,0,3,0,182,0,6,0,0,0,0,243,182,0,9
522,R,114,H RES 444,29-Sep-2015,1:57 PM,On Agreeing to the Resolution,"Providing for consideration of H.R. 3495, the Women’s Public Health and Safety Act and waiving a requirement of clause 6(a) of rule XIII with respect to consideration of certain resolutions reported from the Committee on Rules",Passed,240,2,0,4,2,181,0,5,0,0,0,0,242,183,0,9
523,R,114,H R 3495,29-Sep-2015,4:18 PM,On Motion to Recommit with Instructions,Women’s Public Health and Safety Act,Failed,0,240,0,6,184,2,0,2,0,0,0,0,184,242,0,8
524,R,114,H R 3495,29-Sep-2015,4:27 PM,On Passage,Women’s Public Health and Safety Act,Passed,234,9,0,3,2,184,0,2,0,0,0,0,236,193,0,5
525,R,114,H RES 448,30-Sep-2015,3:00 PM,On Agreeing to the Resolution,"Providing for consideration of H. Con. Res. 79, directing the Clerk of the House of Representatives to make corrections in the enrollment of H.R. 719; and providing for consideration of the Senate amendment to the House amendment to the Senate amendment to H.R. 719, TSA Office of Inspection Accountability Act of 2015",Passed,239,3,0,4,0,184,0,4,0,0,0,0,239,187,0,8
526,R,114,S 2082,30-Sep-2015,3:07 PM,On Motion to Suspend the Rules and Pass,"To amend title 38, United States Code, to extend certain expiring provisions of law administered by the Secretary of Veterans Affairs, and for other purposes.",Passed,240,0,0,6,183,0,0,5,0,0,0,0,423,0,0,11
527,R,114,H CON RES 79,30-Sep-2015,4:47 PM,On Agreeing to the Resolution,Directing the Clerk of the House of Representatives to make corrections in the enrollment of H.R. 719,Passed,238,3,1,4,3,182,0,3,0,0,0,0,241,185,1,7
528,R,114,H R 719,30-Sep-2015,4:57 PM,On Concurring in the Senate Adt to the House Adt to the Senate Adt,TSA Office of Inspection Accountability Act of 2015,Passed,91,151,0,4,186,0,0,2,0,0,0,0,277,151,0,6
529,R,114,H RES 449,1-Oct-2015,10:39 AM,On Ordering the Previous Question,Providing for consideration of the bill (H.R. 3457) the Justice for Victims of Iranian Terrorism Act and consideration of the conference report to accompany the bill (H.R. 1735) the National Defense Authorization Act for Fiscal Year 2016.,Passed,237,0,0,9,0,180,0,8,0,0,0,0,237,180,0,17
530,R,114,H RES 449,1-Oct-2015,10:49 AM,On Agreeing to the Resolution,Providing for consideration of the bill (H.R. 3457) the Justice for Victims of Iranian Terrorism Act and consideration of the conference report to accompany the bill (H.R. 1735) the National Defense Authorization Act for Fiscal Year 2016.,Passed,238,1,0,7,3,180,0,5,0,0,0,0,241,181,0,12
531,R,114,H R 1735,1-Oct-2015,1:26 PM,On Motion to Recommit Conference Report with Instructions,"To authorize appropriations for fiscal year 2016 for military activites of the Department of Defense and for military construction, to prescribe military personnel strengths for such fiscal year, and for other purposes",Failed,2,241,0,3,184,0,0,4,0,0,0,0,186,241,0,7
532,R,114,H R 1735,1-Oct-2015,1:33 PM,On Agreeing to the Conference Report,"To authorize appropriations for fiscal year 2016 for military activites of the Department of Defense and for military construction, to prescribe military personnel strengths for such fiscal year, and for other purposes",Passed,233,10,0,3,37,146,0,5,0,0,0,0,270,156,0,8
533,R,114,H R 3457,1-Oct-2015,1:41 PM,On Passage,Justice for Victims of Iranian Terrorism Act,Passed,241,0,0,5,10,173,0,5,0,0,0,0,251,173,0,10
534,R,114,H R 1553,6-Oct-2015,6:57 PM,On Motion to Suspend the Rules and Pass,Small Bank Exam Cycle Reform Act,Passed,233,0,0,13,178,0,0,10,0,0,0,0,411,0,0,23
535,R,114,H R 1839,6-Oct-2015,7:09 PM,"On Motion to Suspend the Rules and Pass, as Amended",Reforming Access for Investments in Startup Enterprises Act or the RAISE Act,Passed,231,0,0,15,173,0,0,15,0,0,0,0,404,0,0,30
536,R,114,MOTION,7-Oct-2015,2:13 PM,Table Appeal of the Ruling of the Chair,None,Passed,240,0,0,6,0,183,0,5,0,0,0,0,240,183,0,11
537,R,114,H RES 462,7-Oct-2015,2:21 PM,On Agreeing to the Resolution,"Providing for consideration of H.R. 3192, the Homebuyers Assistance Act and providing for proceedings during the period from October 12, 2015, through October 19, 2015",Passed,238,0,0,8,0,181,0,7,0,0,0,0,238,181,0,15
538,R,114,H RES 461,7-Oct-2015,5:35 PM,"On Agreeing to the Resolution, As Amended",Establishing a Select Investigative Panel of the Committee on Energy and Commerce,Passed,240,1,0,5,2,183,0,3,0,0,0,0,242,184,0,8
539,R,114,H R 3192,7-Oct-2015,5:45 PM,On Motion to Recommit with Instructions,Homebuyers Assistance Act,Failed,2,238,0,6,183,2,0,3,0,0,0,0,185,240,0,9
540,R,114,H R 3192,7-Oct-2015,5:52 PM,On Passage,Homebuyers Assistance Act,Passed,239,0,0,7,64,121,0,3,0,0,0,0,303,121,0,10
541,R,114,H RES 466,8-Oct-2015,2:42 PM,On Ordering the Previous Question,Providing for consideration of the bill (H.R. 538) the “Native American Energy Act” and providing for consideration of the bill (H.R. 702) to adapt to changing crude oil market conditions.,Passed,244,0,0,2,0,183,0,5,0,0,0,0,244,183,0,7
542,R,114,H RES 466,8-Oct-2015,2:56 PM,On Agreeing to the Resolution,Providing for consideration of the bill (H.R. 538) the “Native American Energy Act” and providing for consideration of the bill (H.R. 702) to adapt to changing crude oil market conditions.,Passed,244,0,0,2,0,185,0,3,0,0,0,0,244,185,0,5
543,R,114,H R 538,8-Oct-2015,4:21 PM,On Motion to Recommit with Instructions,Native American Energy Act,Failed,1,239,0,6,183,0,0,5,0,0,0,0,184,239,0,11
544,R,114,H R 538,8-Oct-2015,4:30 PM,On Passage,Native American Energy Act,Passed,243,1,0,2,11,172,0,5,0,0,0,0,254,173,0,7
545,R,114,H R 702,9-Oct-2015,12:51 PM,On Agreeing to the Amendment,None,Failed,107,133,0,6,2,173,0,13,0,0,0,0,109,306,0,19
546,R,114,H R 702,9-Oct-2015,12:57 PM,On Agreeing to the Amendment,None,Agreed to,237,0,0,9,177,1,0,10,0,0,0,0,414,1,0,19
547,R,114,H R 702,9-Oct-2015,1:01 PM,On Agreeing to the Amendment,None,Agreed to,240,0,0,6,179,0,0,9,0,0,0,0,419,0,0,15
548,R,114,H R 702,9-Oct-2015,1:17 PM,On Motion to Recommit with Instructions,To adapt to changing crude oil market conditions,Failed,1,240,0,5,178,2,0,8,0,0,0,0,179,242,0,13
549,R,114,H R 702,9-Oct-2015,1:24 PM,On Passage,To adapt to changing crude oil market conditions,Passed,235,6,0,5,26,153,0,9,0,0,0,0,261,159,0,14
550,R,114,H R 3493,20-Oct-2015,6:57 PM,"On Motion to Suspend the Rules and Pass, as Amended",Securing the Cities Act of 2015,Passed,234,4,0,8,177,0,0,11,0,0,0,0,411,4,0,19
551,R,114,H R 3350,20-Oct-2015,7:06 PM,On Motion to Suspend the Rules and Pass,Know the CBRN Terrorism Threats to Transportation Act,Passed,237,0,0,9,179,0,0,9,0,0,0,0,416,0,0,18
552,R,114,H RES 348,20-Oct-2015,7:14 PM,"On Motion to Suspend the Rules and Agree, as Amended",Supporting the right of the people of Ukraine to freely elect their government and determine their future,Passed,232,4,0,10,181,0,0,7,0,0,0,0,413,4,0,17
553,R,114,H RES 480,21-Oct-2015,2:22 PM,On Ordering the Previous Question,"Providing for consideration of the bill (H.R. 10) to reauthorize the Scholarships for Opportunity and Results Act, and for other purposes, and providing for consideration of the bill (H.R. 692) to ensure the payment of interest and principal of the debt of the United States",Passed,241,0,0,5,0,181,0,7,0,0,0,0,241,181,0,12
554,R,114,H RES 480,21-Oct-2015,2:30 PM,On Agreeing to the Resolution,"Providing for consideration of the bill (H.R. 10) to reauthorize the Scholarships for Opportunity and Results Act, and for other purposes, and providing for consideration of the bill (H.R. 692) to ensure the payment of interest and principal of the debt of the United States",Passed,245,0,0,1,0,182,0,6,0,0,0,0,245,182,0,7
555,R,114,H RES 481,21-Oct-2015,2:37 PM,On Ordering the Previous Question,Providing for consideration of the bill (H.R. 1937) to require the Secretary of the Interior and the Secretary of Agriculture to more efficiently develop domestic sources of the minerals and mineral materials of strategic and critical importance to US economic and national security and manufacturing competitiveness,Passed,243,0,0,3,0,184,0,4,0,0,0,0,243,184,0,7
556,R,114,H RES 481,21-Oct-2015,2:45 PM,On Agreeing to the Resolution,Providing for consideration of the bill (H.R. 1937) to require the Secretary of the Interior and the Secretary of Agriculture to more efficiently develop domestic sources of the minerals and mineral materials of strategic and critical importance to US economic and national security and manufacturing competitiveness,Passed,244,0,0,2,0,185,0,3,0,0,0,0,244,185,0,5
557,R,114,H R 692,21-Oct-2015,5:51 PM,On Passage,Default Prevention Act,Passed,235,9,0,2,0,185,0,3,0,0,0,0,235,194,0,5
558,R,114,H R 10,21-Oct-2015,5:59 PM,On Motion to Recommit with Instructions,Scholarships for Opportunity and Results Reauthorization Act,Failed,0,242,0,4,185,0,0,3,0,0,0,0,185,242,0,7
559,R,114,H R 10,21-Oct-2015,6:07 PM,On Passage,Scholarships for Opportunity and Results Reauthorization Act,Passed,238,8,0,0,2,183,0,3,0,0,0,0,240,191,0,3
560,R,114,H R 1937,22-Oct-2015,4:06 PM,On Agreeing to the Amendment,None,Failed,0,245,0,1,176,8,0,4,0,0,0,0,176,253,0,5
561,R,114,H R 1937,22-Oct-2015,4:10 PM,On Agreeing to the Amendment,None,Failed,1,243,0,2,180,5,0,3,0,0,0,0,181,248,0,5
562,R,114,H R 1937,22-Oct-2015,4:15 PM,On Agreeing to the Amendment,None,Failed,1,243,0,2,183,2,0,3,0,0,0,0,184,245,0,5
563,R,114,H R 1937,22-Oct-2015,4:20 PM,On Agreeing to the Amendment,None,Failed,3,241,0,2,180,5,0,3,0,0,0,0,183,246,0,5
564,R,114,H R 1937,22-Oct-2015,4:36 PM,On Motion to Recommit with Instructions,National Strategic and Critical Minerals Production Act of 2015,Failed,0,245,0,1,184,1,0,3,0,0,0,0,184,246,0,4
565,R,114,H R 1937,22-Oct-2015,4:42 PM,On Passage,National Strategic and Critical Minerals Production Act of 2015,Passed,246,0,0,0,8,177,0,3,0,0,0,0,254,177,0,3
566,R,114,H RES 483,22-Oct-2015,4:49 PM,On Ordering the Previous Question,Providing for consideration of the bill (H.R. 3762) Restoring Americans’ Healthcare Freedom Act of 2015; waiving a requirement of clause 6(a) of rule XIII with respect to consideration of certain resolutions reported from the Committee on Rules; and providing for consideration of motions to suspend the rules.,Passed,244,0,0,2,0,185,0,3,0,0,0,0,244,185,0,5
567,R,114,H RES 483,22-Oct-2015,4:56 PM,On Agreeing to the Resolution,Providing for consideration of the bill (H.R. 3762) Restoring Americans’ Healthcare Freedom Act of 2015; waiving a requirement of clause 6(a) of rule XIII with respect to consideration of certain resolutions reported from the Committee on Rules; and providing for consideration of motions to suspend the rules.,Passed,240,3,0,3,0,184,0,4,0,0,0,0,240,187,0,7
568,R,114,H R 3762,23-Oct-2015,11:57 AM,On Passage,Restoring Americans’ Healthcare Freedom Reconciliation Act of 2015,Passed,239,7,0,0,1,182,0,5,0,0,0,0,240,189,0,5
569,R,114,H RES 450,26-Oct-2015,7:24 PM,On Motion To Discharge,"Providing for the consideration of the bill (H.R. 597) to reauthorize the Export-Import Bank of the United States, and for other purposes.",Passed,62,177,0,7,184,0,0,4,0,0,0,0,246,177,0,11
570,R,114,H RES 491,27-Oct-2015,2:17 PM,On Ordering the Previous Question,"Providing for consideration of H.R. 1090, Retail Investor Protection Act",Passed,242,0,0,4,0,185,0,3,0,0,0,0,242,185,0,7
571,R,114,H RES 491,27-Oct-2015,2:25 PM,On Agreeing to the Resolution,"Providing for consideration of H.R. 1090, Retail Investor Protection Act",Passed,244,0,0,2,0,186,0,2,0,0,0,0,244,186,0,4
572,R,114,H RES 450,27-Oct-2015,2:32 PM,On Ordering the Previous Question,"Providing for the consideration of the bill (H.R. 597) to reauthorize the Export-Import Bank of the United States, and for other purposes.",Passed,87,156,0,3,184,2,0,2,0,0,0,0,271,158,0,5
573,R,114,H RES 450,27-Oct-2015,2:40 PM,On Agreeing to the Resolution,"Providing for the consideration of the bill (H.R. 597) to reauthorize the Export-Import Bank of the United States, and for other purposes.",Passed,91,152,0,3,184,2,0,2,0,0,0,0,275,154,0,5
574,R,114,H R 1090,27-Oct-2015,6:17 PM,On Agreeing to the Amendment,None,Failed,1,243,0,2,183,3,0,2,0,0,0,0,184,246,0,4
575,R,114,H R 1090,27-Oct-2015,6:25 PM,On Passage,"To amend the Securities Exchange Act of 1934 to provide protections for retail customers, and for other purposes.",Passed,242,2,0,2,3,184,0,1,0,0,0,0,245,186,0,3
576,R,114,H R 597,27-Oct-2015,6:32 PM,On Passage,Reform Exports and Expand the American Economy Act,Passed,127,117,0,2,186,1,0,1,0,0,0,0,313,118,0,3
577,R,114,H RES 495,28-Oct-2015,3:24 PM,On Ordering the Previous Question,"Providing for consideration of the Senate amendment to H.R. 1314, Bipartisan Budget Act of 2015",Passed,244,0,0,2,81,103,0,4,0,0,0,0,325,103,0,6
578,R,114,H RES 495,28-Oct-2015,3:33 PM,On Agreeing to the Resolution,"Providing for consideration of the Senate amendment to H.R. 1314, Bipartisan Budget Act of 2015",Passed,216,29,0,1,176,8,0,4,0,0,0,0,392,37,0,5
579,R,114,H R 1314,28-Oct-2015,5:21 PM,On Motion that the House Concur in the Senate Amendment with an Amendment,To amend the Internal Revenue Code of 1986 to provide for a right to an administrative appeal relating to adverse determinations of tax-exempt status of certain organizations,Passed,79,167,0,1,187,0,0,1,0,0,0,0,266,167,0,2
580,R,114,QUORUM,29-Oct-2015,9:34 AM,Call of the House,None,Passed,0,0,244,3,0,0,177,11,0,0,0,0,0,0,421,14
581
582,R,114,H R 1853,2-Nov-2015,6:56 PM,On Motion to Suspend the Rules and Pass,"To direct the President to develop a strategy to obtain observer status for Taiwan in the International Criminal Police Organization, and for other purposes.",Passed,230,0,0,15,162,0,0,26,0,0,0,0,392,0,0,41
583,R,114,H RES 507,3-Nov-2015,2:10 PM,On Ordering the Previous Question,"Providing for consideration of the Senate amendments to H.R. 22, the Hire More Heroes Act of 2015; providing for proceedings during the period from November 6, 2015, through November 13, 2015; and providing for consideration of motions to suspend the rules",Passed,241,0,0,4,0,178,0,10,0,0,0,0,241,178,0,14
584,R,114,H RES 507,3-Nov-2015,2:19 PM,"On Agreeing to the Resolution, as Amended","Providing for consideration of the Senate amendments to H.R. 22, the Hire More Heroes Act of 2015; providing for proceedings during the period from November 6, 2015, through November 13, 2015; and providing for consideration of motions to suspend the rules",Passed,240,0,0,5,8,171,0,9,0,0,0,0,248,171,0,14
585,R,114,H RES 354,3-Nov-2015,2:27 PM,"On Motion to Suspend the Rules and Agree, as Amended",Expressing the sense of the House of Representatives regarding the safety and security of Jewish communities in Europe.,Passed,239,0,0,6,179,0,0,9,0,0,0,0,418,0,0,15
586,R,114,H R 22,3-Nov-2015,6:55 PM,On Agreeing to the Amendment,None,Failed,28,212,0,5,153,25,0,10,0,0,0,0,181,237,0,15
587,R,114,H R 22,3-Nov-2015,7:01 PM,On Agreeing to the Amendment,None,Failed,195,45,0,5,1,180,0,7,0,0,0,0,196,225,0,12
588,R,114,H R 22,3-Nov-2015,7:05 PM,On Agreeing to the Amendment,None,Failed,168,74,0,3,19,162,0,7,0,0,0,0,187,236,0,10
589,R,114,H R 22,3-Nov-2015,7:09 PM,On Agreeing to the Amendment,None,Agreed to,39,203,0,3,177,4,0,7,0,0,0,0,216,207,0,10
590,R,114,H R 22,3-Nov-2015,7:13 PM,On Agreeing to the Amendment,None,Failed,7,235,0,3,153,28,0,7,0,0,0,0,160,263,0,10
591,R,114,H R 22,3-Nov-2015,7:16 PM,On Agreeing to the Amendment,None,Failed,14,227,0,4,160,21,0,7,0,0,0,0,174,248,0,11
592,R,114,H R 22,3-Nov-2015,7:21 PM,On Agreeing to the Amendment,None,Failed,11,231,0,3,149,32,0,7,0,0,0,0,160,263,0,10
593,R,114,H R 22,3-Nov-2015,7:25 PM,On Agreeing to the Amendment,None,Failed,69,173,0,3,44,137,0,7,0,0,0,0,113,310,0,10
594,R,114,H R 22,4-Nov-2015,2:26 PM,On Agreeing to the Amendment,None,Failed,172,71,0,2,0,184,0,4,0,0,0,0,172,255,0,6
595,R,114,H R 22,4-Nov-2015,2:31 PM,On Agreeing to the Amendment,None,Failed,170,72,0,3,15,168,0,5,0,0,0,0,185,240,0,8
596,R,114,H R 22,4-Nov-2015,2:36 PM,On Agreeing to the Amendment,None,Failed,17,226,0,2,152,31,0,5,0,0,0,0,169,257,0,7
597,R,114,H RES 512,4-Nov-2015,2:44 PM,On Ordering the Previous Question,"Providing for further consideration of the Senate amendments to the bill (H.R. 22), the Hire More Heroes Act of 2015.",Passed,241,0,0,4,0,183,0,5,0,0,0,0,241,183,0,9
598,R,114,H RES 512,4-Nov-2015,2:51 PM,On Agreeing to the Resolution,"Providing for further consideration of the Senate amendments to the bill (H.R. 22), the Hire More Heroes Act of 2015.",Passed,240,1,0,4,3,182,0,3,0,0,0,0,243,183,0,7
599,R,114,H R 22,4-Nov-2015,7:12 PM,On Agreeing to the Amendment,None,Failed,7,234,0,4,164,18,0,6,0,0,0,0,171,252,0,10
600,R,114,H R 22,4-Nov-2015,7:18 PM,On Agreeing to the Amendment,None,Failed,121,121,0,3,52,134,0,2,0,0,0,0,173,255,0,5
601,R,114,H R 22,4-Nov-2015,7:22 PM,On Agreeing to the Amendment,None,Agreed to,225,17,0,3,23,163,0,2,0,0,0,0,248,180,0,5
602,R,114,H R 22,4-Nov-2015,7:25 PM,On Agreeing to the Amendment,None,Failed,188,54,0,3,0,184,0,4,0,0,0,0,188,238,0,7
603,R,114,H R 22,4-Nov-2015,7:28 PM,On Agreeing to the Amendment,None,Failed,113,130,0,2,3,183,0,2,0,0,0,0,116,313,0,4
604,R,114,H R 22,4-Nov-2015,7:31 PM,On Agreeing to the Amendment,None,Failed,13,230,0,2,168,18,0,2,0,0,0,0,181,248,0,4
605,R,114,H R 22,4-Nov-2015,7:35 PM,On Agreeing to the Amendment,None,Failed,193,49,0,3,7,179,0,2,0,0,0,0,200,228,0,5
606,R,114,H R 22,4-Nov-2015,7:38 PM,On Agreeing to the Amendment,None,Failed,118,124,0,3,0,186,0,2,0,0,0,0,118,310,0,5
607,R,114,H R 22,4-Nov-2015,10:45 PM,On Agreeing to the Amendment,None,Failed,121,121,0,3,0,182,0,6,0,0,0,0,121,303,0,9
608,R,114,H R 22,4-Nov-2015,10:49 PM,On Agreeing to the Amendment,None,Failed,116,127,0,2,1,182,0,5,0,0,0,0,117,309,0,7
609,R,114,H R 22,4-Nov-2015,10:53 PM,On Agreeing to the Amendment,None,Failed,123,120,0,2,1,182,0,5,0,0,0,0,124,302,0,7
610,R,114,H R 22,4-Nov-2015,10:56 PM,On Agreeing to the Amendment,None,Failed,115,126,0,4,1,182,0,5,0,0,0,0,116,308,0,9
611,R,114,H R 22,4-Nov-2015,11:00 PM,On Agreeing to the Amendment,None,Failed,116,127,0,2,1,181,0,6,0,0,0,0,117,308,0,8
612,R,114,H R 22,4-Nov-2015,11:03 PM,On Agreeing to the Amendment,None,Failed,114,129,0,2,0,185,0,3,0,0,0,0,114,314,0,5
613,R,114,H R 22,4-Nov-2015,11:07 PM,On Agreeing to the Amendment,None,Failed,114,129,0,2,1,184,0,3,0,0,0,0,115,313,0,5
614,R,114,H R 22,4-Nov-2015,11:10 PM,On Agreeing to the Amendment,None,Failed,179,63,0,3,4,181,0,3,0,0,0,0,183,244,0,6
615,R,114,H R 22,4-Nov-2015,11:14 PM,On Agreeing to the Amendment,None,Failed,133,110,0,2,0,185,0,3,0,0,0,0,133,295,0,5
616,R,114,H R 22,4-Nov-2015,11:18 PM,On Agreeing to the Amendment,None,Failed,128,114,0,3,1,184,0,3,0,0,0,0,129,298,0,6
617,R,114,H R 22,4-Nov-2015,11:21 PM,On Agreeing to the Amendment,None,Agreed to,232,11,0,2,4,181,0,3,0,0,0,0,236,192,0,5
618,R,114,S 1356,5-Nov-2015,10:37 AM,"On Motion to Suspend the Rules and Pass, as Amended",To clarify that certain provisions of the Border Patrol Agent Pay Reform Act of 2014 will not take effect until after the Director of the Office of Personnel Management promulgates and makes effective regulations relating to such provisions,Passed,235,9,0,1,135,49,0,4,0,0,0,0,370,58,0,5
619,R,114,H R 22,5-Nov-2015,10:43 AM,On Agreeing to the Amendment,None,Failed,2,242,0,1,174,9,0,5,0,0,0,0,176,251,0,6
620,R,114,H R 22,5-Nov-2015,10:47 AM,On Agreeing to the Amendment,None,Agreed to,234,7,0,4,12,171,0,5,0,0,0,0,246,178,0,9
621,R,114,H R 22,5-Nov-2015,10:50 AM,On Agreeing to the Amendment,None,Agreed to,229,15,0,1,6,177,0,5,0,0,0,0,235,192,0,6
622,R,114,H R 22,5-Nov-2015,10:54 AM,On Agreeing to the Amendment,None,Agreed to,241,2,0,2,113,70,0,5,0,0,0,0,354,72,0,7
623,R,114,H R 22,5-Nov-2015,11:04 AM,On Agreeing to the Amendments En gros,Hire More Heroes Act,Passed,186,58,0,1,177,6,0,5,0,0,0,0,363,64,0,6
624,R,114,H R 22,5-Nov-2015,11:22 AM,On Motion to go to Conference,Hire More Heroes Act,Passed,191,52,0,2,180,2,0,6,0,0,0,0,371,54,0,8
625,R,114,H R 22,5-Nov-2015,12:07 PM,On Motion to Instruct Conferees,Developing a Reliable and Innovative Vision for the Economy Act or the DRIVE Act,Failed,0,239,0,6,179,0,0,9,0,0,0,0,179,239,0,15
626,R,114,H R 308,16-Nov-2015,7:01 PM,On Motion to Suspend the Rules and Pass,Keep the Promise Act of 2015,Failed,231,8,0,6,32,138,0,18,0,0,0,0,263,146,0,24
627,R,114,H R 1338,16-Nov-2015,7:09 PM,"On Motion to Suspend the Rules and Pass, as Amended",Dignified Interment of Our Veterans Act of 2015,Passed,237,0,0,8,172,0,0,16,0,0,0,0,409,0,0,24
628,R,114,H R 1384,16-Nov-2015,7:17 PM,On Motion to Suspend the Rules and Pass,Honor America’s Guard-Reserve Retirees Act,Passed,237,0,0,8,170,0,0,18,0,0,0,0,407,0,0,26
629,R,114,H RES 526,17-Nov-2015,1:29 PM,On Ordering the Previous Question,"Providing for consideration of H.R. 1737, the Reforming CFPB Indirect Auto Financing Guidance Act; providing for consideration of H.R. 511, the Tribal Labor Sovereignty Act of 2015; and for other purposes",Passed,243,0,0,2,2,178,0,8,0,0,0,0,245,178,0,10
630,R,114,H RES 526,17-Nov-2015,1:37 PM,On Agreeing to the Resolution,"Providing for consideration of H.R. 1737, the Reforming CFPB Indirect Auto Financing Guidance Act; providing for consideration of H.R. 511, the Tribal Labor Sovereignty Act of 2015; and for other purposes",Passed,243,1,0,1,0,180,0,8,0,0,0,0,243,181,0,9
631,R,114,H R 1694,17-Nov-2015,1:43 PM,On Motion to Suspend the Rules and Pass,Fairness to Veterans for infrastructure Investment Act of 2015,Passed,239,2,0,4,46,136,0,6,0,0,0,0,285,138,0,10
632,R,114,H R 3114,17-Nov-2015,1:51 PM,"On Motion to Suspend the Rules and Pass, as Amended","To provide funds to the Army Corps of Engineers to hire veterans and members of the Armed Forces to assist the Corps with curation and historic preservation activities, and for other purposes",Passed,241,3,0,1,181,0,0,7,0,0,0,0,422,3,0,8
633,R,114,H R 511,17-Nov-2015,3:34 PM,On Passage,Tribal Labor Sovereignty Act of 2015,Passed,225,18,0,2,24,159,0,5,0,0,0,0,249,177,0,7
634,R,114,H RES 529,18-Nov-2015,1:41 PM,On Agreeing to the Resolution,"Providing for consideration of the bill (H.R. 1210) Portfolio Lending and Mortgage Access Act; providing for consideration of the bill (H.R. 3189) Fed Oversight Reform and Modernization Act; and providing for proceedings during the period from November 20,2015, through November 27, 2015",Passed,243,0,0,2,0,184,0,4,0,0,0,0,243,184,0,6
635,R,114,H R 1210,18-Nov-2015,5:07 PM,On Motion to Recommit with Instructions,Portfolio Lending and Mortgage Access Act,Failed,2,241,0,2,182,1,0,5,0,0,0,0,184,242,0,7
636,R,114,H R 1210,18-Nov-2015,5:14 PM,On Passage,Portfolio Lending and Mortgage Access Act,Passed,243,1,0,1,12,173,0,3,0,0,0,0,255,174,0,4
637,R,114,H R 1737,18-Nov-2015,5:26 PM,On Passage,Reforming CFPB Indirect Auto Financing Guidance Act,Passed,244,0,0,1,88,96,0,4,0,0,0,0,332,96,0,5
638,R,114,H RES 531,19-Nov-2015,11:03 AM,On Ordering the Previous Question,"Providing for consideration of H.R. 4038, the American Security Against Foreign Enemies (American SAFE) Act of 2015",Passed,243,0,0,2,0,182,0,6,0,0,0,0,243,182,0,8
639,R,114,H RES 531,19-Nov-2015,11:11 AM,On Agreeing to the Resolution,"Providing for consideration of H.R. 4038, the American Security Against Foreign Enemies (American SAFE) Act of 2015",Passed,242,2,0,1,0,181,0,7,0,0,0,0,242,183,0,8
640,R,114,H R 3189,19-Nov-2015,11:28 AM,On Motion to Recommit with Instructions,Fed Oversight Reform and Modernization (FORM) Act of 2015,Failed,1,241,0,3,181,1,0,6,0,0,0,0,182,242,0,9
641,R,114,H R 3189,19-Nov-2015,11:35 AM,On Passage,Fed Oversight Reform and Modernization (FORM) Act of 2015,Passed,239,5,0,1,2,180,0,6,0,0,0,0,241,185,0,7
642,R,114,H R 4038,19-Nov-2015,1:45 PM,On Motion to Recommit with Instructions,American Security Against Foreign Enemies Act,Failed,0,243,0,2,180,1,0,7,0,0,0,0,180,244,0,9
643,R,114,H R 4038,19-Nov-2015,1:55 PM,On Passage,American Security Against Foreign Enemies Act,Passed,242,2,0,2,47,135,0,6,0,0,0,0,289,137,0,8
644,R,114,H R 2288,30-Nov-2015,6:56 PM,"On Motion to Suspend the Rules and Pass, as Amended","To remove the use restrictions on certain land transferred to Rockingham County, Virginia, and for other purposes",Passed,234,0,0,11,173,0,0,15,0,0,0,0,407,0,0,26
645,R,114,H R 2270,30-Nov-2015,7:04 PM,"On Motion to Suspend the Rules and Pass, as Amended",Billy Frank Jr. Tell Your Story Act,Passed,236,2,0,7,177,0,0,11,0,0,0,0,413,2,0,18
646,R,114,H RES 539,1-Dec-2015,1:48 PM,On Ordering the Previous Question,"Providing for consideration of the bill (H.R. 8), the “North American Energy Security and Infrastructure Act of 2015”; the joint resolutions (S.J. Res.23) and (S.J. Res. 24) providing for congressional disapproval of certain EPA rules regarding Greenhouse Gas Emissions and Carbon Pollution Emission Guidelines.",Passed,242,0,0,3,0,179,0,9,0,0,0,0,242,179,0,12
647,R,114,H RES 539,1-Dec-2015,1:59 PM,On Agreeing to the Resolution,"Providing for consideration of the bill (H.R. 8), the “North American Energy Security and Infrastructure Act of 2015”; the joint resolutions (S.J. Res.23) and (S.J. Res. 24) providing for congressional disapproval of certain EPA rules regarding Greenhouse Gas Emissions and Carbon Pollution Emission Guidelines.",Passed,243,0,0,2,0,181,0,7,0,0,0,0,243,181,0,9
648,R,114,S 1170,1-Dec-2015,2:10 PM,On Motion to Suspend the Rules and Pass,Breast Cancer Research Stamp Reauthorization Act,Passed,241,1,0,3,181,0,0,7,0,0,0,0,422,1,0,10
649,R,114,H R 4127,1-Dec-2015,2:33 PM,On Motion to Suspend the Rules and Pass,Intelligence Authorization Act for Fiscal Year 2016,Passed,220,22,0,3,144,36,0,8,0,0,0,0,364,58,0,11
650,R,114,S J RES 24,1-Dec-2015,5:16 PM,On Passage,"Providing for congressional disapproval under chapter 8 of title 5, United States Code, of a rule submitted by the Environmental Protection Agency relating to “Carbon Pollution Emission Guidelines for Existing Stationary Sources: Electric Utility Generating Units”.",Passed,238,2,0,5,4,178,0,6,0,0,0,0,242,180,0,11
651,R,114,S J RES 23,1-Dec-2015,5:24 PM,On Passage,"Providing for congressional disapproval under chapter 8 of title 5, United States Code, of a rule submitted by the Environmental Protection Agency relating to “Standards of Performance for Greenhouse Gas Emissions from New, Modified, and Reconstructed Stationary Sources: Electric Utility Generating Units”.",Passed,231,10,0,4,4,178,0,6,0,0,0,0,235,188,0,10
652,R,114,H R 644,1-Dec-2015,5:48 PM,On Motion To Go To Conference,Trade Facilitation and Trade Enforcement Act of 2015,Passed,234,6,0,5,18,164,0,6,0,0,0,0,252,170,0,11
653,R,114,H RES 542,2-Dec-2015,2:10 PM,On Ordering the Previous Question,"Providing for further consideration of H.R. 8, the North American Energy Security and Infrastructure Act of 2015; providing for consideration of the conference report to accompany S. 1177, to reauthorize the Elementary and Secondary Education Act of 1965 to ensure that every child achieves",Passed,242,0,0,3,1,177,0,10,0,0,0,0,243,177,0,13
654,R,114,H RES 542,2-Dec-2015,2:20 PM,On Agreeing to the Resolution,"Providing for further consideration of H.R. 8, the North American Energy Security and Infrastructure Act of 2015; providing for consideration of the conference report to accompany S. 1177, to reauthorize the Elementary and Secondary Education Act of 1965 to ensure that every child achieves",Passed,239,1,0,5,1,180,0,7,0,0,0,0,240,181,0,12
655,R,114,H R 644,2-Dec-2015,2:30 PM,On Motion to Instruct Conferees,Trade Facilitation and Trade Enforcement Act of 2015,Failed,17,226,0,2,176,6,0,6,0,0,0,0,193,232,0,8
656,R,114,H R 8,2-Dec-2015,6:38 PM,On Agreeing to the Amendment,None,Agreed to,241,1,0,3,5,176,0,7,0,0,0,0,246,177,0,10
657,R,114,H R 8,2-Dec-2015,6:43 PM,On Agreeing to the Amendment,None,Failed,9,233,0,3,170,11,0,7,0,0,0,0,179,244,0,10
658,R,114,H R 8,2-Dec-2015,6:48 PM,On Agreeing to the Amendment,None,Agreed to,236,4,0,5,27,154,0,7,0,0,0,0,263,158,0,12
659,R,114,H R 8,2-Dec-2015,6:51 PM,On Agreeing to the Amendment,None,Failed,7,235,0,3,165,11,0,12,0,0,0,0,172,246,0,15
660,R,114,H R 8,2-Dec-2015,6:54 PM,On Agreeing to the Amendment,None,Failed,12,229,0,4,171,10,0,7,0,0,0,0,183,239,0,11
661,R,114,H R 8,2-Dec-2015,6:58 PM,On Agreeing to the Amendment,None,Failed,18,224,0,3,180,0,0,8,0,0,0,0,198,224,0,11
662,R,114,H R 8,2-Dec-2015,7:01 PM,On Agreeing to the Amendment,None,Failed,2,241,0,2,173,6,0,9,0,0,0,0,175,247,0,11
663,R,114,H R 8,2-Dec-2015,7:05 PM,On Agreeing to the Amendment,None,Failed,25,216,0,4,181,0,0,7,0,0,0,0,206,216,0,11
664,R,114,H R 8,2-Dec-2015,7:10 PM,On Agreeing to the Amendment,None,Agreed to,235,7,0,3,20,161,0,7,0,0,0,0,255,168,0,10
665,R,114,S 1177,2-Dec-2015,7:18 PM,On Agreeing to the Conference Report,To reauthorize the Elementary and Secondary Education Act of 1965 to ensure that every child achieves,Passed,178,64,0,3,181,0,0,7,0,0,0,0,359,64,0,10
666,R,114,H RES 546,3-Dec-2015,10:42 AM,On Ordering the Previous Question,"Providing for consideration of the conference report to accompany H.R. 22, to authorize funds for Federal-aid highways, highway safety programs, and transit programs, and for other purposes",Passed,242,0,0,3,1,179,0,8,0,0,0,0,243,179,0,11
667,R,114,H RES 546,3-Dec-2015,10:51 AM,On Agreeing to the Resolution,"Providing for consideration of the conference report to accompany H.R. 22, to authorize funds for Federal-aid highways, highway safety programs, and transit programs, and for other purposes",Passed,243,0,0,2,141,40,0,7,0,0,0,0,384,40,0,9
668,R,114,H R 8,3-Dec-2015,10:58 AM,On Agreeing to the Amendment,None,Agreed to,238,4,0,3,14,166,0,8,0,0,0,0,252,170,0,11
669,R,114,H R 8,3-Dec-2015,11:03 AM,On Agreeing to the Amendment,None,Agreed to,243,0,0,2,4,177,0,7,0,0,0,0,247,177,0,9
670,R,114,H R 8,3-Dec-2015,11:06 AM,On Agreeing to the Amendment,None,Failed,4,239,0,2,177,4,0,7,0,0,0,0,181,243,0,9
671,R,114,H R 8,3-Dec-2015,11:24 AM,On Motion to Recommit with Instructions,North American Energy Security and Infrastructure Act,Failed,0,243,0,2,180,0,0,8,0,0,0,0,180,243,0,10
672,R,114,H R 8,3-Dec-2015,11:31 AM,On Passage,North American Energy Security and Infrastructure Act,Passed,240,3,0,2,9,171,0,8,0,0,0,0,249,174,0,10
673,R,114,H R 22,3-Dec-2015,1:25 PM,On Agreeing to the Conference Report,"To authorize funds for Federal-aid highways, highway safety programs, and transit programs, and for other purposes",Passed,178,65,0,2,181,0,0,7,0,0,0,0,359,65,0,9
674,R,114,ADJOURN,8-Dec-2015,1:10 PM,On Motion to Adjourn,None,Failed,0,230,0,15,0,169,0,19,0,0,0,0,0,399,0,34
675,R,114,ADJOURN,8-Dec-2015,1:51 PM,On Motion to Adjourn,None,Failed,0,229,1,15,0,176,1,11,0,0,0,0,0,405,2,26
676,R,114,ADJOURN,8-Dec-2015,2:21 PM,On Motion to Adjourn,None,Failed,0,229,1,15,3,170,1,14,0,0,0,0,3,399,2,29
677,R,114,ADJOURN,8-Dec-2015,2:52 PM,On Motion to Adjourn,None,Failed,1,231,0,13,3,163,2,20,0,0,0,0,4,394,2,33
678,R,114,ADJOURN,8-Dec-2015,3:35 PM,On Motion to Adjourn,None,Failed,3,229,1,12,4,169,3,12,0,0,0,0,7,398,4,24
679,R,114,H R 158,8-Dec-2015,5:18 PM,"On Motion to Suspend the Rules and Pass, as Amended",Visa Waiver Program Improvement and Terrorist Travel Prevention Act of 2015,Passed,242,0,0,3,165,19,0,4,0,0,0,0,407,19,0,7
680,R,114,H R 3842,8-Dec-2015,5:29 PM,"On Motion to Suspend the Rules and Pass, as Amended",Federal Law Enforcement Training Centers Reform and Improvement Act of 2015,Passed,240,2,0,3,180,0,0,8,0,0,0,0,420,2,0,11
681,R,114,H RES 556,9-Dec-2015,1:25 PM,On Consideration of the Resolution,"Providing for consideration of H.R. 2130, Red River Private Property Protection Act",Passed,240,0,0,5,1,174,0,13,0,0,0,0,241,174,0,18
682,R,114,H RES 556,9-Dec-2015,2:58 PM,On Ordering the Previous Question,"Providing for consideration of H.R. 2130, Red River Private Property Protection Act",Passed,241,0,0,4,1,178,0,9,0,0,0,0,242,178,0,13
683,R,114,H RES 556,9-Dec-2015,3:06 PM,On Agreeing to the Resolution,"Providing for consideration of H.R. 2130, Red River Private Property Protection Act",Passed,241,0,0,4,0,183,0,5,0,0,0,0,241,183,0,9
684,R,114,H R 2130,9-Dec-2015,4:40 PM,On Agreeing to the Amendment,None,Agreed to,66,178,0,1,180,5,0,3,0,0,0,0,246,183,0,4
685,R,114,H R 2130,9-Dec-2015,5:06 PM,Table Appeal of the Ruling of the Chair,Red River Private Property Protection Act,Passed,244,0,0,1,2,182,0,4,0,0,0,0,246,182,0,5
686,R,114,H R 2130,9-Dec-2015,5:31 PM,On Passage,Red River Private Property Protection Act,Passed,240,4,0,1,13,173,0,2,0,0,0,0,253,177,0,3
687,R,114,H R 3578,10-Dec-2015,4:52 PM,"On Motion to Suspend the Rules and Pass, as Amended",DHS Science and Technology Reform and Improvement Act of 2015,Passed,241,0,0,4,175,0,0,13,0,0,0,0,416,0,0,17
688,R,114,MOTION,10-Dec-2015,5:15 PM,Table Appeal of the Ruling of the Chair,None,Passed,241,0,0,4,1,173,0,14,0,0,0,0,242,173,0,18
689,R,114,H R 2795,10-Dec-2015,5:24 PM,"On Motion to Suspend the Rules and Pass, as Amended",First Responder Identification of Emergency Needs in Disaster Situations or “FRIENDS” Act,Passed,225,12,0,8,171,0,0,17,0,0,0,0,396,12,0,25
690,R,114,H RES 560,11-Dec-2015,10:51 AM,On Ordering the Previous Question,"Providing for consideration of the conference report to accompany H.R. 644, the Trade Facilitation and Trade Enforcement Act of 2015 and providing for consideration of the Senate amendments to H.R. 2250, Making appropriations for the Legislative Branch for the fiscal year ending September 30, 2016",Passed,235,0,0,10,1,177,0,10,0,0,0,0,236,177,0,20
691,R,114,H RES 560,11-Dec-2015,10:59 AM,On Agreeing to the Resolution,"Providing for consideration of the conference report to accompany H.R. 644, the Trade Facilitation and Trade Enforcement Act of 2015 and providing for consideration of the Senate amendments to H.R. 2250, Making appropriations for the Legislative Branch for the fiscal year ending September 30, 2016",Passed,233,0,0,12,3,174,0,11,0,0,0,0,236,174,0,23
692,R,114,H R 644,11-Dec-2015,12:57 PM,On Motion to Recommit Conference Report with Instructions,Trade Facilitation and Trade Enforcement Act of 2015,Failed,1,232,0,12,171,7,0,10,0,0,0,0,172,239,0,22
693,R,114,H R 644,11-Dec-2015,1:04 PM,On Agreeing to the Conference Report,Trade Facilitation and Trade Enforcement Act of 2015,Passed,232,3,0,10,24,155,0,9,0,0,0,0,256,158,0,19
694,R,114,H RES 536,15-Dec-2015,7:02 PM,"On Motion to Suspend the Rules and Agree, as Amended","Supporting freedom of the press in Latin America and the Caribbean and condemning violations of press freedom and violence against journalists, bloggers, and individuals exercising their right to freedom of speech",Passed,224,2,0,19,175,0,0,13,0,0,0,0,399,2,0,32
695,R,114,H R 2820,16-Dec-2015,10:30 AM,On Motion to Suspend the Rules and concur in the Senate Amendment,"An Act to reauthorize the Stem Cell Therapeutic and Research Act of 2005, and for other purposes.",Passed,240,0,0,5,181,0,0,7,0,0,0,0,421,0,0,12
696,R,114,H R 4246,16-Dec-2015,10:42 AM,On Motion to Suspend the Rules and Pass,National Guard and Reservist Debt Relief Extension Act of 2015,Passed,239,1,0,5,180,0,0,8,0,0,0,0,419,1,0,13
697,R,114,S 1090,16-Dec-2015,10:53 AM,On Motion to Suspend the Rules and Pass,Emergency Information Improvement Act of 2015,Passed,239,1,0,5,181,0,0,7,0,0,0,0,420,1,0,12
698,R,114,H R 2297,16-Dec-2015,2:30 PM,On Motion to Suspend the Rules and Concur in the Senate Amendments,Hezbollah International Financing Prevention Act of 2015,Passed,241,0,0,4,184,0,0,4,0,0,0,0,425,0,0,8
699,R,114,H R 3750,16-Dec-2015,2:39 PM,"On Motion to Suspend the Rules and Pass, as Amended",First Responders Passport Act of 2015,Passed,238,2,0,5,183,0,0,5,0,0,0,0,421,2,0,10
700,R,114,H R 4239,16-Dec-2015,2:48 PM,"On Motion to Suspend the Rules and Pass, as Amended",Tracking Foreign Fighters in Terrorist Safe Havens Act,Passed,240,0,0,5,183,0,0,5,0,0,0,0,423,0,0,10
701,R,114,H RES 566,17-Dec-2015,10:57 AM,On Ordering the Previous Question,"Providing for consideration of the Senate amendment to H.R. 2029, making appropriations for Mil-Con, Dept of VA, and related agencies for the fiscal year ending September 30, 2016, and for other purposes; providing for proceedings during the period from December 19, 2015, through January 4, 2016; and for other purposes",Passed,240,0,0,5,4,177,0,7,0,0,0,0,244,177,0,12
702,R,114,H RES 566,17-Dec-2015,11:05 AM,On Agreeing to the Resolution,"Providing for consideration of the Senate amendment to H.R. 2029, making appropriations for Mil-Con, Dept of VA, and related agencies for the fiscal year ending September 30, 2016, and for other purposes; providing for proceedings during the period from December 19, 2015, through January 4, 2016; and for other purposes",Passed,240,2,0,3,0,183,0,5,0,0,0,0,240,185,0,8
703,R,114,H R 2029,17-Dec-2015,1:00 PM,On Concurring in Senate Amdt with Amdt Specified in Section 3(b) of H.Res. 566,"Making appropriations for military construction, the Department of Veterans Affairs, and related agencies for the fiscal year ending September 30, 2016, and for other purposes",Passed,241,3,0,1,77,106,0,5,0,0,0,0,318,109,0,6
704,R,114,JOURNAL,17-Dec-2015,1:20 PM,On Approving the Journal,None,Passed,139,84,0,22,95,71,2,20,0,0,0,0,234,155,2,42
705,R,114,H R 2029,18-Dec-2015,9:49 AM,On Concurring in Senate Amdt with Amdt Specified in Section 3(a) of H.Res. 566,"Making appropriations for military construction, the Department of Veterans Affairs, and related agencies for the fiscal year ending September 30, 2016, and for other purposes",Passed,150,95,0,1,166,18,0,4,0,0,0,0,316,113,0,5
